bill_id,roll_call_id,date,chamber,description,yea,nay,nv,absent,total
1138043,869072,2019-05-21,Senate,"Senate Health Committee Vote",15,0,0,0,15
1138045,808803,2019-02-05,Senate,"Senate Cultural Affairs, Tourism, Parks and Recreation Committee Vote",7,0,0,0,7
1138045,808804,2019-02-26,Senate,"Senate Floor Vote - Final Passage",61,0,0,2,63
1138045,934980,2020-02-25,Senate,"Senate Cultural Affairs, Tourism, Parks and Recreation Committee Vote",7,0,0,0,7
1138045,973117,2020-07-21,Senate,"Senate Floor Vote - Final Passage",59,1,0,0,60
1138047,876611,2019-06-03,Senate,"Senate Floor Vote - Final Passage",43,19,0,0,62
1138047,877305,2019-06-03,Senate,"Senate Rules Committee Vote",15,4,0,0,19
1138048,787570,2019-01-28,Assembly,"Assembly Judiciary Committee: Favorable refer to committee Codes",21,0,0,0,21
1138048,796530,2019-02-11,Assembly,"Assembly Codes Committee: Favorable refer to committee Judiciary",22,0,0,0,22
1138048,809604,2019-02-26,Assembly,"Assembly Floor Vote - Final Passage",136,0,0,14,150
1138055,881518,2019-05-06,Senate,"Senate Agriculture Committee Vote",9,0,0,0,9
1138055,881759,2019-06-13,Senate,"Senate Floor Vote - Final Passage",62,0,0,0,62
1138055,904895,2020-01-23,Senate,"Senate Agriculture Committee Vote",9,0,0,0,9
1138055,941949,2020-03-02,Senate,"Senate Floor Vote - Final Passage",61,0,0,1,62
1138062,875582,2019-05-30,Senate,"Senate Transportation Committee Vote",14,1,0,0,15
1138072,787314,2019-01-28,Senate,"Senate Commerce, Economic Development and Small Business Committee Vote",9,0,0,0,9
1138072,819960,2019-03-12,Senate,"Senate Finance Committee Vote",22,0,0,1,23
1138072,827839,2019-03-25,Senate,"Senate Floor Vote - Final Passage",62,0,0,0,62
1138072,883232,2019-06-17,Assembly,"Assembly Floor Vote - Final Passage",145,0,0,5,150
1138074,782431,2019-01-15,Assembly,"Assembly Health Committee: Favorable",25,0,0,1,26
1138074,785837,2019-01-23,Assembly,"Assembly Floor Vote - Final Passage",145,0,0,5,150
1138074,859586,2019-05-06,Senate,"Senate Floor Vote - Final Passage",61,0,0,1,62
1138075,855541,2019-04-30,Senate,"Senate Investigations and Government Operations Committee Vote",7,0,0,0,7
1138089,881973,2019-06-12,Senate,"Senate Floor Vote - Final Passage",62,0,0,0,62
1138089,881974,2019-06-12,Senate,"Senate Rules Committee Vote",19,0,0,0,19
1138089,885113,2019-06-18,Senate,"Senate Floor Vote - Final Passage",62,0,0,0,62
1138089,885114,2019-06-19,Assembly,"Assembly Floor Vote - Final Passage",149,0,0,1,150
1138095,857255,2019-04-30,Assembly,"Assembly Codes Committee: Favorable",14,6,0,2,22
1138095,884357,2019-06-18,Assembly,"Assembly Floor Vote - Final Passage",106,42,0,2,150
1138103,857018,2019-05-01,Assembly,"Assembly Education Committee: Favorable refer to committee Ways and Means",28,0,0,3,31
1138103,869030,2019-05-21,Assembly,"Assembly Ways And Means Committee: Favorable",32,0,0,3,35
1138117,885385,2019-06-18,Senate,"Senate Floor Vote - Final Passage",42,20,0,0,62
1138117,886606,2019-06-18,Senate,"Senate Rules Committee Vote",19,0,0,0,19
1138117,950207,2020-03-10,Senate,"Senate Energy and Telecommunications Committee Vote",6,3,0,0,9
1138123,883471,2019-05-07,Senate,"Senate Ethics And Internal Governance Committee Vote",6,0,1,0,7
1138123,885235,2019-06-18,Senate,"Senate Floor Vote - Final Passage",53,9,0,0,62
1138130,859558,2019-05-06,Senate,"Senate Codes Committee Vote",9,4,0,0,13
1138137,782532,2019-01-15,Assembly,"Assembly Health Committee: Favorable refer to committee Ways and Means",25,0,0,1,26
1138138,811115,2019-02-27,Assembly,"Assembly Real Property Taxation Committee: Favorable refer to committee Ways and Means",9,0,0,1,10
1138138,875611,2019-05-30,Assembly,"Assembly Ways And Means Committee: Favorable",26,5,0,4,35
1138142,784288,2019-01-22,Senate,"Senate Health Committee Vote",10,5,0,0,15
1138142,784546,2019-01-22,Senate,"Senate Floor Vote - Final Passage",38,24,0,1,63
1138142,784667,2019-01-22,Senate,"Senate Health Committee Vote",10,5,0,0,15
1138142,784668,2019-01-22,Assembly,"Assembly Floor Vote - Final Passage",95,49,0,6,150
1138143,867711,2019-05-07,Senate,"Senate Finance Committee Vote",23,0,0,0,23
1138143,867712,2019-05-20,Senate,"Senate Floor Vote - Final Passage",60,0,0,2,62
1138143,882097,2019-06-14,Senate,"Senate Floor Vote - Final Passage",62,0,0,0,62
1138143,886178,2019-06-21,Assembly,"Assembly Floor Vote - Final Passage",142,1,0,7,150
1138146,877394,2019-04-09,Senate,"Senate Domestic Animal Welfare Committee Vote",7,0,0,0,7
1138146,877395,2019-06-04,Senate,"Senate Floor Vote - Final Passage",62,0,0,0,62
1138146,902943,2020-01-15,Senate,"Senate Domestic Animal Welfare Committee Vote",7,0,0,0,7
1138171,902795,2020-01-14,Assembly,"Assembly Insurance Committee: Favorable",15,6,0,1,22
1138184,820775,2019-03-12,Assembly,"Assembly Election Law Committee: Favorable",15,0,0,1,16
1138184,834018,2019-03-28,Assembly,"Assembly Floor Vote - Final Passage",143,0,0,7,150
1138190,884280,2019-06-18,Senate,"Senate Rules Committee Vote",19,0,0,0,19
1138190,885368,2019-06-18,Senate,"Senate Floor Vote - Final Passage",62,0,0,0,62
1138190,973601,2020-07-22,Senate,"Senate Floor Vote - Final Passage",60,0,0,0,60
1138190,973939,2020-07-20,Senate,"Senate Transportation Committee Vote",14,1,0,0,15
1138190,973940,2020-07-21,Senate,"Senate Rules Committee Vote",19,0,0,0,19
1138195,877059,2019-06-03,Assembly,"Assembly Consumer Affairs And Protection Committee: Favorable refer to committee Rules",11,4,0,1,16
1138198,859936,2019-01-28,Senate,"Senate Judiciary Committee Vote",12,3,0,0,15
1138198,860379,2019-05-07,Senate,"Senate Floor Vote - Final Passage",36,25,0,1,62
1138204,875560,2019-05-30,Senate,"Senate Housing, Construction and Community Development Committee Vote",8,2,0,1,11
1138205,859617,2019-05-06,Assembly,"Assembly Insurance Committee: Favorable refer to committee Codes",15,7,0,2,24
1138205,868712,2019-05-21,Assembly,"Assembly Codes Committee: Favorable",15,6,0,1,22
1138228,811363,2019-02-27,Assembly,"Assembly Election Law Committee: Favorable",13,0,0,3,16
1138228,864035,2019-05-14,Senate,"Senate Floor Vote - Final Passage",59,0,0,3,62
1138228,864036,2019-05-14,Assembly,"Assembly Floor Vote - Final Passage",141,0,0,9,150
1138236,881851,2019-06-13,Senate,"Senate Floor Vote - Final Passage",62,0,0,0,62
1138236,881852,2019-06-13,Senate,"Senate Rules Committee Vote",19,0,0,0,19
1138236,884040,2019-06-18,Assembly,"Assembly Floor Vote - Final Passage",125,21,0,4,150
1138239,950024,2019-02-12,Senate,"Senate Transportation Committee Vote",15,0,0,0,15
1138239,950025,2020-02-04,Senate,"Senate Transportation Committee Vote",15,0,0,0,15
1138239,950026,2020-03-10,Senate,"Senate Floor Vote - Final Passage",59,0,0,3,62
1138244,868875,2019-05-21,Assembly,"Assembly Codes Committee: Favorable",15,6,0,1,22
1138250,793195,2019-01-28,Senate,"Senate Judiciary Committee Vote",15,0,0,0,15
1138250,793196,2019-02-05,Senate,"Senate Floor Vote - Final Passage",61,0,0,2,63
1138250,826169,2019-03-20,Assembly,"Assembly Floor Vote - Final Passage",121,23,0,6,150
1138252,859835,2019-05-07,Assembly,"Assembly Banks Committee: Favorable refer to committee Codes",26,0,0,5,31
1138252,868546,2019-05-21,Assembly,"Assembly Codes Committee: Favorable",21,0,0,1,22
1138252,875074,2019-05-29,Assembly,"Assembly Floor Vote - Final Passage",142,0,0,8,150
1138252,886570,2019-06-20,Senate,"Senate Floor Vote - Final Passage",62,0,0,0,62
1138254,815165,2019-02-04,Senate,"Senate Local Government Committee Vote",7,0,0,0,7
1138254,815166,2019-03-06,Senate,"Senate Floor Vote - Final Passage",62,0,0,1,63
1138257,819067,2019-03-11,Senate,"Senate Children and Families Committee Vote",7,0,0,0,7
1138257,876618,2019-06-03,Senate,"Senate Floor Vote - Final Passage",62,0,0,0,62
1138257,877163,2019-06-03,Senate,"Senate Rules Committee Vote",19,0,0,0,19
1138258,855841,2019-03-19,Senate,"Senate Environmental Conservation Committee Vote",11,0,0,0,11
1138258,855842,2019-04-30,Senate,"Senate Floor Vote - Final Passage",45,17,0,0,62
1138258,880119,2019-06-11,Senate,"Senate Floor Vote - Final Passage",43,18,0,1,62
1138258,884140,2019-06-18,Assembly,"Assembly Floor Vote - Final Passage",124,24,0,2,150
1138267,864718,2019-05-14,Assembly,"Assembly Consumer Affairs And Protection Committee: Favorable refer to committee Codes",15,0,0,1,16
1138267,880208,2019-06-11,Assembly,"Assembly Codes Committee: Favorable refer to committee Rules",20,2,0,0,22
1138267,882400,2019-06-17,Assembly,"Assembly Rules Committee: Favorable",25,1,0,5,31
1138273,883045,2019-06-17,Senate,"Senate Floor Vote - Final Passage",44,18,0,0,62
1138273,883046,2019-06-17,Senate,"Senate Rules Committee Vote",15,4,0,0,19
1138279,868892,2019-05-21,Assembly,"Assembly Economic Development Committee: Favorable refer to committee Codes",23,1,0,2,26
1138279,874995,2019-05-30,Assembly,"Assembly Codes Committee: Favorable",18,1,0,3,22
1138279,877303,2019-06-03,Assembly,"Assembly Floor Vote - Final Passage",123,19,0,8,150
1138279,882816,2019-06-17,Senate,"Senate Floor Vote - Final Passage",51,11,0,0,62
1138290,882093,2019-05-29,Senate,"Senate Local Government Committee Vote",7,0,0,0,7
1138290,882094,2019-06-14,Senate,"Senate Floor Vote - Final Passage",62,0,0,0,62
1138291,797704,2019-02-12,Assembly,"Assembly Corporations, Authorities And Commissions Committee: Favorable refer to committee Codes",24,0,0,2,26
1138291,813628,2019-03-05,Assembly,"Assembly Codes Committee: Favorable",22,0,0,0,22
1138291,819037,2019-03-11,Assembly,"Assembly Floor Vote - Final Passage",140,0,0,10,150
1138293,862935,2019-05-13,Senate,"Senate Racing, Gaming and Wagering Committee Vote",7,0,0,0,7
1138293,882959,2019-06-17,Senate,"Senate Floor Vote - Final Passage",57,5,0,0,62
1138293,882960,2019-06-17,Senate,"Senate Rules Committee Vote",16,3,0,0,19
1138293,901941,2020-01-13,Senate,"Senate Racing, Gaming and Wagering Committee Vote",7,0,0,0,7
1138296,829792,2019-03-26,Assembly,"Assembly Economic Development Committee: Favorable refer to committee Codes",14,10,0,2,26
1138296,839069,2019-04-09,Assembly,"Assembly Codes Committee: Favorable refer to committee Ways and Means",17,5,0,0,22
1138296,864838,2019-05-14,Assembly,"Assembly Ways And Means Committee: Favorable",23,9,0,3,35
1138311,792568,2019-02-05,Assembly,"Assembly Consumer Affairs And Protection Committee: Favorable refer to committee Codes",15,0,0,1,16
1138311,796520,2019-02-11,Assembly,"Assembly Codes Committee: Favorable",21,1,0,0,22
1138322,878676,2019-04-08,Senate,"Senate Elections Committee Vote",7,0,0,0,7
1138322,879142,2019-06-06,Senate,"Senate Floor Vote - Final Passage",61,0,0,1,62
1138322,884157,2019-06-18,Assembly,"Assembly Floor Vote - Final Passage",148,0,0,2,150
1138323,902614,2019-02-27,Senate,"Senate Health Committee Vote",12,2,0,1,15
1138323,902615,2020-01-14,Senate,"Senate Health Committee Vote",12,2,0,0,14
1138327,878837,2019-06-06,Assembly,"Assembly Corporations, Authorities And Commissions Committee: Favorable refer to committee Ways and Means",23,2,0,1,26
1138328,855141,2019-04-09,Senate,"Senate Environmental Conservation Committee Vote",9,2,0,0,11
1138328,855142,2019-04-30,Senate,"Senate Floor Vote - Final Passage",53,9,0,0,62
1138328,857172,2019-04-30,Assembly,"Assembly Floor Vote - Final Passage",119,25,0,6,150
1138342,878720,2019-06-06,Assembly,"Assembly Environmental Conservation Committee: Favorable refer to committee Codes",25,3,0,2,30
1138342,880217,2019-06-11,Assembly,"Assembly Codes Committee: Favorable refer to committee Rules",19,3,0,0,22
1138342,934409,2020-02-25,Assembly,"Assembly Codes Committee: Favorable",17,4,0,1,22
1138347,884278,2019-06-18,Senate,"Senate Rules Committee Vote",19,0,0,0,19
1138347,885362,2019-06-18,Senate,"Senate Floor Vote - Final Passage",62,0,0,0,62
1138367,972620,2020-07-20,Senate,"Senate Children And Families Committee Vote",7,0,0,0,7
1138367,973366,2020-07-22,Senate,"Senate Rules Committee Vote",18,1,0,0,19
1138367,973738,2020-07-23,Senate,"Senate Floor Vote - Final Passage",54,6,0,0,60
1138375,878730,2019-06-06,Assembly,"Assembly Environmental Conservation Committee: Favorable refer to committee Codes",21,7,0,2,30
1138394,868073,2019-05-21,Assembly,"Assembly Insurance Committee: Favorable refer to committee Codes",22,1,0,1,24
1138394,877893,2019-06-05,Assembly,"Assembly Rules Committee: Favorable",23,4,0,4,31
1138394,877894,2019-06-05,Assembly,"Assembly Codes Committee: Favorable refer to committee Rules",19,3,0,0,22
1138394,878607,2019-06-05,Assembly,"Assembly Floor Vote - Final Passage",90,49,0,11,150
1138394,885274,2019-06-18,Senate,"Senate Floor Vote - Final Passage",62,0,0,0,62
1138397,857070,2019-04-30,Assembly,"Assembly Children And Families Committee: Favorable refer to committee Codes",14,0,0,2,16
1138397,859825,2019-05-07,Assembly,"Assembly Codes Committee: Favorable",20,0,0,2,22
1138397,863520,2019-05-13,Assembly,"Assembly Floor Vote - Final Passage",143,0,0,7,150
1138397,869592,2019-05-22,Senate,"Senate Floor Vote - Final Passage",49,12,0,1,62
1138401,949110,2020-03-10,Senate,"Senate Ethics and Internal Governance Committee Vote",6,1,0,0,7
1138408,787135,2019-01-28,Assembly,"Assembly Election Law Committee: Favorable",15,0,0,1,16
1138408,792456,2019-02-04,Assembly,"Assembly Floor Vote - Final Passage",143,1,0,6,150
1138408,881942,2019-06-13,Senate,"Senate Floor Vote - Final Passage",62,0,0,0,62
1138411,825952,2019-03-04,Senate,"Senate Local Government Committee Vote",7,0,0,0,7
1138411,825953,2019-03-20,Senate,"Senate Floor Vote - Final Passage",58,4,0,0,62
1138412,786909,2019-01-28,Assembly,"Assembly Rules Committee: Favorable",28,1,0,2,31
1138412,786910,2019-01-28,Assembly,"Assembly Ways And Means Committee: Favorable refer to committee Rules",28,4,0,3,35
1138413,791970,2019-02-04,Senate,"Senate Corporations, Authorities and Commissions Committee Vote",7,0,0,0,7
1138413,887575,2019-06-20,Senate,"Senate Floor Vote - Final Passage",62,0,0,0,62
1138413,887576,2019-06-20,Senate,"Senate Rules Committee Vote",19,0,0,0,19
1138414,868495,2019-05-21,Senate,"Senate Children and Families Committee Vote",7,0,0,0,7
1138414,875211,2019-05-30,Senate,"Senate Floor Vote - Final Passage",54,4,0,4,62
1138414,875212,2019-05-30,Senate,"Senate Rules Committee Vote",17,1,0,1,19
1138414,904755,2020-01-21,Senate,"Senate Children and Families Committee Vote",7,0,0,0,7
1138414,972691,2020-07-21,Senate,"Senate Finance Committee Vote",23,0,0,0,23
1138414,974018,2020-07-22,Senate,"Senate Floor Vote - Final Passage",60,0,0,0,60
1138414,974019,2020-07-22,Senate,"Senate Rules Committee Vote",19,0,0,0,19
1138432,822556,2019-02-05,Senate,"Senate Investigations and Government Operations Committee Vote",7,0,0,0,7
1138432,822557,2019-03-14,Senate,"Senate Floor Vote - Final Passage",61,0,0,1,62
1138432,902620,2020-01-14,Senate,"Senate Investigations and Government Operations Committee Vote",7,0,0,0,7
1138432,904761,2020-01-22,Senate,"Senate Finance Committee Vote",23,0,0,0,23
1138432,933189,2020-02-24,Senate,"Senate Floor Vote - Final Passage",59,0,0,3,62
1138434,899546,2019-02-05,Senate,"Senate Investigations and Government Operations Committee Vote",7,0,0,0,7
1138437,877532,2019-06-04,Assembly,"Assembly Children And Families Committee: Favorable refer to committee Codes",16,0,0,0,16
1138437,880088,2019-06-11,Assembly,"Assembly Codes Committee: Favorable refer to committee Rules",22,0,0,0,22
1138437,881345,2019-06-13,Assembly,"Assembly Rules Committee: Favorable",26,0,0,5,31
1138437,950156,2020-03-10,Assembly,"Assembly Floor Vote - Final Passage",134,4,0,9,147
1138446,787315,2019-01-28,Senate,"Senate Commerce, Economic Development and Small Business Committee Vote",7,2,0,0,9
1138453,840767,2019-04-09,Assembly,"Assembly Transportation Committee: Favorable refer to committee Codes",16,7,0,2,25
1138453,857513,2019-04-30,Assembly,"Assembly Codes Committee: Favorable",18,2,0,2,22
1138469,859488,2019-03-12,Senate,"Senate Energy and Telecommunications Committee Vote",9,0,0,0,9
1138469,859489,2019-05-06,Senate,"Senate Floor Vote - Final Passage",60,1,0,1,62
1138469,904513,2020-01-22,Senate,"Senate Energy and Telecommunications Committee Vote",9,0,0,0,9
1138469,907375,2020-01-28,Senate,"Senate Floor Vote - Final Passage",62,0,0,0,62
1138470,824771,2019-03-19,Senate,"Senate Environmental Conservation Committee Vote",11,0,0,0,11
1138485,809314,2019-02-26,Assembly,"Assembly Social Services Committee: Favorable refer to committee Codes",15,0,0,3,18
1138492,884405,2019-06-18,Senate,"Senate Rules Committee Vote",17,2,0,0,19
1138492,885469,2019-06-18,Senate,"Senate Floor Vote - Final Passage",49,13,0,0,62
1138513,970945,2020-07-13,Assembly,"Assembly Consumer Affairs And Protection Committee: Favorable refer to committee Codes",12,3,0,1,16
1138513,971866,2020-07-17,Assembly,"Assembly Codes Committee: Favorable refer to committee Rules",15,6,0,1,22
1138513,973026,2020-07-22,Assembly,"Assembly Rules Committee: Favorable",19,6,0,5,30
1138516,828549,2019-03-26,Assembly,"Assembly Correction Committee: Favorable refer to committee Ways and Means",10,3,0,0,13
1138522,786925,2019-01-28,Assembly,"Assembly Rules Committee: Favorable",28,1,0,2,31
1138522,786926,2019-01-28,Assembly,"Assembly Ways And Means Committee: Favorable refer to committee Rules",28,4,0,3,35
1138527,810262,2019-02-27,Senate,"Senate Commerce, Economic Development and Small Business Committee Vote",9,0,0,0,9
1138528,818182,2019-01-28,Senate,"Senate Racing, Gaming and Wagering Committee Vote",7,0,0,0,7
1138528,818183,2019-03-11,Senate,"Senate Floor Vote - Final Passage",61,1,0,0,62
1138528,902043,2020-01-13,Senate,"Senate Racing, Gaming and Wagering Committee Vote",7,0,0,0,7
1138528,906619,2020-01-27,Senate,"Senate Floor Vote - Final Passage",59,2,0,1,62
1138529,880321,2019-05-30,Senate,"Senate Veterans, Homeland Security And Military Affairs Committee Vote",9,0,0,0,9
1138529,880322,2019-06-11,Senate,"Senate Floor Vote - Final Passage",61,0,0,1,62
1138529,884039,2019-06-18,Assembly,"Assembly Floor Vote - Final Passage",146,0,0,4,150
1138532,973866,2020-07-21,Senate,"Senate Rules Committee Vote",19,0,0,0,19
1138532,973867,2020-07-22,Senate,"Senate Floor Vote - Final Passage",57,3,0,0,60
1138533,884416,2019-06-18,Senate,"Senate Rules Committee Vote",18,1,0,0,19
1138533,885479,2019-06-18,Senate,"Senate Floor Vote - Final Passage",58,4,0,0,62
1138536,880009,2019-06-11,Senate,"Senate Rules Committee Vote",19,0,0,0,19
1138536,880504,2019-06-11,Senate,"Senate Floor Vote - Final Passage",61,0,0,1,62
1138536,964097,2020-06-09,Senate,"Senate Floor Vote - Final Passage",62,0,0,0,62
1138536,966318,2020-05-28,Senate,"Senate Rules Committee Vote",19,0,0,0,19
1138536,966319,2020-06-08,Senate,"Senate Transportation Committee Vote",15,0,0,0,15
1138549,882967,2019-06-17,Senate,"Senate Floor Vote - Final Passage",62,0,0,0,62
1138549,882968,2019-06-17,Senate,"Senate Rules Committee Vote",19,0,0,0,19
1138551,881909,2019-06-13,Senate,"Senate Floor Vote - Final Passage",59,3,0,0,62
1138551,881910,2019-06-13,Senate,"Senate Rules Committee Vote",19,0,0,0,19
1138551,886318,2019-06-20,Assembly,"Assembly Floor Vote - Final Passage",148,0,0,2,150
1138553,809944,2019-02-27,Assembly,"Assembly Agriculture Committee: Favorable refer to committee Codes",20,0,0,1,21
1138553,814016,2019-03-05,Assembly,"Assembly Codes Committee: Favorable",22,0,0,0,22
1138553,819027,2019-03-11,Assembly,"Assembly Floor Vote - Final Passage",139,1,0,10,150
1138553,877390,2019-06-04,Senate,"Senate Floor Vote - Final Passage",61,1,0,0,62
1138555,791608,2019-01-22,Senate,"Senate Higher Education Committee Vote",11,0,0,0,11
1138555,792307,2019-02-04,Senate,"Senate Floor Vote - Final Passage",62,0,0,1,63
1138555,902618,2020-01-14,Senate,"Senate Higher Education Committee Vote",10,0,0,1,11
1138555,913299,2020-02-03,Senate,"Senate Floor Vote - Final Passage",59,0,0,3,62
1138558,855619,2019-04-30,Senate,"Senate Civil Service and Pensions Committee Vote",7,0,0,0,7
1138558,868711,2019-05-21,Senate,"Senate Finance Committee Vote",23,0,0,0,23
1138558,881757,2019-06-12,Senate,"Senate Floor Vote - Final Passage",61,1,0,0,62
1138558,972689,2020-07-20,Senate,"Senate Civil Service and Pensions Committee Vote",7,0,0,0,7
1138558,972690,2020-07-21,Senate,"Senate Finance Committee Vote",22,1,0,0,23
1138558,973336,2020-07-22,Senate,"Senate Rules Committee Vote",18,1,0,0,19
1138558,973502,2020-07-22,Senate,"Senate Floor Vote - Final Passage",58,2,0,0,60
1138561,786936,2019-01-28,Assembly,"Assembly Rules Committee: Favorable",28,1,0,2,31
1138561,786937,2019-01-28,Assembly,"Assembly Ways And Means Committee: Favorable refer to committee Rules",28,4,0,3,35
1138563,886539,2019-06-20,Senate,"Senate Floor Vote - Final Passage",62,0,0,0,62
1138563,887353,2019-06-20,Senate,"Senate Rules Committee Vote",19,0,0,0,19
1138563,919525,2020-02-10,Senate,"Senate Education Committee Vote",15,0,0,0,15
1138563,932122,2020-02-24,Senate,"Senate Floor Vote - Final Passage",59,0,0,3,62
1138564,814510,2019-03-05,Assembly,"Assembly Judiciary Committee: Favorable refer to committee Ways and Means",19,0,0,2,21
1138564,882324,2019-06-14,Assembly,"Assembly Ways And Means Committee: Favorable refer to committee Rules",30,0,0,5,35
1138564,882518,2019-06-17,Assembly,"Assembly Rules Committee: Favorable",26,0,0,5,31
1138569,810857,2019-02-04,Senate,"Senate Elections Committee Vote",6,1,0,0,7
1138569,810858,2019-02-27,Senate,"Senate Floor Vote - Final Passage",45,17,0,1,63
1138574,883917,2019-06-18,Senate,"Senate Floor Vote - Final Passage",61,1,0,0,62
1138574,884407,2019-06-18,Senate,"Senate Rules Committee Vote",19,0,0,0,19
1138575,857236,2019-04-30,Assembly,"Assembly Ways And Means Committee: Favorable",33,0,0,2,35
1138575,859668,2019-05-06,Assembly,"Assembly Floor Vote - Final Passage",141,0,0,9,150
1138576,782597,2019-01-15,Assembly,"Assembly Codes Committee: Favorable",15,6,0,1,22
1138576,782598,2019-01-15,Assembly,"Assembly Health Committee: Favorable refer to committee Codes",18,7,0,1,26
1138589,786912,2019-01-28,Assembly,"Assembly Rules Committee: Favorable",28,1,0,2,31
1138589,786913,2019-01-28,Assembly,"Assembly Ways And Means Committee: Favorable refer to committee Rules",28,4,0,3,35
1138596,914655,2019-02-04,Senate,"Senate Agriculture Committee Vote",9,0,0,0,9
1138596,914656,2020-02-03,Senate,"Senate Agriculture Committee Vote",9,0,0,0,9
1138599,877858,2019-06-05,Assembly,"Assembly Insurance Committee: Favorable refer to committee Codes",24,0,0,0,24
1138599,880414,2019-06-11,Assembly,"Assembly Codes Committee: Favorable refer to committee Rules",22,0,0,0,22
1138599,881359,2019-06-13,Assembly,"Assembly Rules Committee: Favorable",26,0,0,5,31
1138600,886696,2019-05-07,Senate,"Senate Elections Committee Vote",6,0,0,1,7
1138600,886697,2019-06-20,Senate,"Senate Floor Vote - Final Passage",62,0,0,0,62
1138629,878469,2019-06-04,Assembly,"Assembly Governmental Operations Committee: Favorable refer to committee Rules",12,0,0,2,14
1138629,880678,2019-06-12,Assembly,"Assembly Rules Committee: Favorable",27,0,0,4,31
1138631,832194,2019-03-26,Senate,"Senate Rules Committee Vote",19,0,0,0,19
1138631,832195,2019-03-29,Senate,"Senate Floor Vote - Final Passage",55,5,0,2,62
1138631,840462,2019-04-09,Assembly,"Assembly Floor Vote - Final Passage",146,0,0,4,150
1138635,973625,2020-07-22,Senate,"Senate Floor Vote - Final Passage",42,18,0,0,60
1138635,973974,2020-07-21,Senate,"Senate Rules Committee Vote",13,6,0,0,19
1138661,875224,2019-05-30,Senate,"Senate Floor Vote - Final Passage",57,1,0,4,62
1138661,875225,2019-05-30,Senate,"Senate Rules Committee Vote",18,0,0,1,19
1138662,824797,2019-03-12,Senate,"Senate Investigations and Government Operations Committee Vote",7,0,0,0,7
1138662,824798,2019-03-19,Senate,"Senate Floor Vote - Final Passage",51,10,0,1,62
1138662,875692,2019-05-30,Assembly,"Assembly Floor Vote - Final Passage",142,0,0,8,150
1138664,787545,2019-01-28,Senate,"Senate Rules Committee Vote",14,5,0,0,19
1138664,787546,2019-01-29,Senate,"Senate Codes Committee Vote",10,3,0,0,13
1138664,787811,2019-01-29,Senate,"Senate Floor Vote - Final Passage",41,22,0,0,63
1138664,788449,2019-01-29,Assembly,"Assembly Floor Vote - Final Passage",104,40,0,6,150
1138672,868426,2019-05-20,Senate,"Senate Rules Committee Vote",17,1,0,1,19
1138672,868427,2019-05-21,Senate,"Senate Floor Vote - Final Passage",47,14,0,1,62
1138672,903392,2020-01-15,Senate,"Senate Banks Committee Vote",7,3,0,0,10
1138672,972369,2020-07-21,Senate,"Senate Floor Vote - Final Passage",48,12,0,0,60
1138674,856195,2019-04-30,Senate,"Senate Health Committee Vote",15,0,0,0,15
1138674,868062,2019-05-21,Senate,"Senate Finance Committee Vote",23,0,0,0,23
1138674,869061,2019-05-21,Senate,"Senate Finance Committee Vote",23,0,0,0,23
1138674,869062,2019-05-22,Senate,"Senate Floor Vote - Final Passage",61,0,0,1,62
1138674,883405,2019-06-17,Assembly,"Assembly Floor Vote - Final Passage",148,0,0,2,150
1138683,787323,2019-01-28,Assembly,"Assembly Election Law Committee: Favorable",15,0,0,1,16
1138683,792451,2019-02-04,Assembly,"Assembly Floor Vote - Final Passage",144,0,0,6,150
1138683,814407,2019-03-05,Senate,"Senate Floor Vote - Final Passage",55,5,0,3,63
1138697,863916,2019-05-07,Senate,"Senate Elections Committee Vote",6,0,0,1,7
1138697,863917,2019-05-14,Senate,"Senate Floor Vote - Final Passage",59,0,0,3,62
1138697,919417,2020-02-10,Senate,"Senate Elections Committee Vote",7,0,0,0,7
1138697,972980,2020-07-21,Senate,"Senate Floor Vote - Final Passage",60,0,0,0,60
1138707,782422,2019-01-15,Assembly,"Assembly Health Committee: Favorable refer to committee Codes",25,0,0,1,26
1138707,868905,2019-05-21,Assembly,"Assembly Codes Committee: Favorable",21,0,0,1,22
1138707,874843,2019-05-29,Assembly,"Assembly Floor Vote - Final Passage",140,0,0,10,150
1138707,882130,2019-06-12,Senate,"Senate Floor Vote - Final Passage",62,0,0,0,62
1138708,810907,2019-02-28,Assembly,"Assembly Health Committee: Favorable refer to committee Codes",16,9,0,1,26
1138710,876617,2019-06-03,Senate,"Senate Floor Vote - Final Passage",62,0,0,0,62
1138710,877142,2019-06-03,Senate,"Senate Rules Committee Vote",19,0,0,0,19
1138716,810822,2019-02-27,Senate,"Senate Health Committee Vote",10,4,0,1,15
1138721,857104,2019-04-30,Assembly,"Assembly Housing Committee: Favorable refer to committee Codes",25,0,0,3,28
1138721,859857,2019-05-07,Assembly,"Assembly Codes Committee: Favorable",19,1,0,2,22
1138721,863628,2019-05-13,Assembly,"Assembly Floor Vote - Final Passage",137,6,0,7,150
1138721,869686,2019-05-22,Senate,"Senate Floor Vote - Final Passage",61,0,0,1,62
1138728,813465,2019-02-04,Senate,"Senate Consumer Protection Committee Vote",7,0,0,0,7
1138728,813466,2019-03-04,Senate,"Senate Floor Vote - Final Passage",59,0,0,4,63
1138728,902986,2020-01-15,Senate,"Senate Consumer Protection Committee Vote",5,2,0,0,7
1138728,972517,2020-07-21,Senate,"Senate Floor Vote - Final Passage",44,16,0,0,60
1138734,797697,2019-02-12,Assembly,"Assembly Corporations, Authorities And Commissions Committee: Favorable refer to committee Codes",24,0,0,2,26
1138734,819180,2019-03-12,Assembly,"Assembly Codes Committee: Favorable",21,0,0,1,22
1138734,824046,2019-03-18,Assembly,"Assembly Floor Vote - Final Passage",143,0,0,7,150
1138734,841283,2019-04-10,Senate,"Senate Floor Vote - Final Passage",59,0,0,3,62
1138748,815322,2019-02-27,Senate,"Senate Energy and Telecommunications Committee Vote",9,0,0,0,9
1138748,815323,2019-03-06,Senate,"Senate Floor Vote - Final Passage",62,0,0,1,63
1138748,886269,2019-06-21,Assembly,"Assembly Floor Vote - Final Passage",130,11,0,9,150
1138755,878340,2019-06-05,Assembly,"Assembly Election Law Committee: Favorable refer to committee Rules",15,0,0,1,16
1138755,882478,2019-06-17,Assembly,"Assembly Rules Committee: Favorable",26,0,0,5,31
1138755,884267,2019-06-18,Assembly,"Assembly Floor Vote - Final Passage",145,1,0,4,150
1138755,885338,2019-06-18,Senate,"Senate Floor Vote - Final Passage",42,20,0,0,62
1138762,870079,2019-05-21,Assembly,"Assembly Governmental Operations Committee: Favorable",14,0,0,0,14
1138762,874902,2019-05-29,Assembly,"Assembly Floor Vote - Final Passage",140,0,0,10,150
1138766,855567,2019-04-30,Senate,"Senate Investigations and Government Operations Committee Vote",7,0,0,0,7
1138774,882397,2019-04-30,Senate,"Senate Civil Service And Pensions Committee Vote",7,0,0,0,7
1138774,882938,2019-06-17,Senate,"Senate Floor Vote - Final Passage",50,12,0,0,62
1138774,883383,2019-06-17,Assembly,"Assembly Floor Vote - Final Passage",142,4,0,4,150
1138777,877002,2019-04-30,Senate,"Senate Transportation Committee Vote",15,0,0,0,15
1138777,877003,2019-06-03,Senate,"Senate Floor Vote - Final Passage",62,0,0,0,62
1138786,857004,2019-05-01,Assembly,"Assembly Election Law Committee: Favorable",16,0,0,0,16
1138786,875005,2019-05-29,Assembly,"Assembly Floor Vote - Final Passage",138,3,0,9,150
1138786,876754,2019-06-03,Senate,"Senate Floor Vote - Final Passage",41,21,0,0,62
1138792,882633,2019-06-17,Assembly,"Assembly Rules Committee: Favorable",25,0,0,6,31
1138792,882634,2019-06-17,Assembly,"Assembly Ways And Means Committee: Favorable refer to committee Rules",24,9,0,2,35
1138792,882635,2019-06-17,Assembly,"Assembly Local Governments Committee: Favorable refer to committee Ways and Means",18,0,0,1,19
1138804,860462,2019-04-29,Senate,"Senate Insurance Committee Vote",9,2,0,0,11
1138804,860463,2019-05-07,Senate,"Senate Floor Vote - Final Passage",40,21,0,1,62
1138804,883095,2019-06-17,Assembly,"Assembly Floor Vote - Final Passage",102,43,0,5,150
1138808,877056,2019-06-03,Assembly,"Assembly Consumer Affairs And Protection Committee: Favorable refer to committee Codes",15,0,0,1,16
1138808,882665,2019-06-17,Assembly,"Assembly Rules Committee: Favorable",25,0,0,6,31
1138808,882666,2019-06-17,Assembly,"Assembly Codes Committee: Favorable refer to committee Rules",20,0,0,2,22
1138808,885136,2019-06-19,Assembly,"Assembly Floor Vote - Final Passage",148,0,0,2,150
1138808,886786,2019-06-20,Senate,"Senate Floor Vote - Final Passage",62,0,0,0,62
1138810,782564,2019-01-15,Assembly,"Assembly Health Committee: Favorable",18,7,0,1,26
1138906,791600,2019-01-22,Senate,"Senate Transportation Committee Vote",15,0,0,0,15
1138906,792310,2019-02-04,Senate,"Senate Floor Vote - Final Passage",62,0,0,1,63
1138906,875830,2019-05-30,Assembly,"Assembly Floor Vote - Final Passage",140,0,0,10,150
1138966,810236,2019-02-04,Senate,"Senate Elections Committee Vote",7,0,0,0,7
1138966,810237,2019-02-27,Senate,"Senate Floor Vote - Final Passage",62,0,0,1,63
1139151,877644,2019-03-12,Senate,"Senate Investigations and Government Operations Committee Vote",7,0,0,0,7
1139151,877645,2019-06-03,Senate,"Senate Floor Vote - Final Passage",62,0,0,0,62
1139151,884047,2019-06-18,Assembly,"Assembly Floor Vote - Final Passage",145,1,0,4,150
1139166,870191,2019-05-22,Assembly,"Assembly Election Law Committee: Favorable",14,0,0,2,16
1139167,878204,2019-06-05,Assembly,"Assembly Health Committee: Favorable refer to committee Codes",25,0,0,1,26
1139167,880195,2019-06-11,Assembly,"Assembly Codes Committee: Favorable refer to committee Ways and Means",22,0,0,0,22
1139167,882044,2019-06-14,Assembly,"Assembly Ways And Means Committee: Favorable refer to committee Rules",30,0,0,5,35
1139167,882459,2019-06-17,Assembly,"Assembly Rules Committee: Favorable",26,0,0,5,31
1139167,883923,2019-06-18,Senate,"Senate Floor Vote - Final Passage",62,0,0,0,62
1139167,884246,2019-06-18,Assembly,"Assembly Floor Vote - Final Passage",144,2,0,4,150
1139169,857446,2019-04-30,Assembly,"Assembly Children And Families Committee: Favorable refer to committee Ways and Means",14,0,0,2,16
1139169,875622,2019-05-30,Assembly,"Assembly Ways And Means Committee: Favorable",30,1,0,4,35
1139170,868059,2019-05-21,Assembly,"Assembly Governmental Operations Committee: Favorable refer to committee Codes",14,0,0,0,14
1139170,875161,2019-05-30,Assembly,"Assembly Codes Committee: Favorable",19,0,0,3,22
1139172,883623,2019-06-18,Assembly,"Assembly Local Governments Committee: Favorable refer to committee Rules",13,4,0,2,19
1139172,920461,2020-02-11,Assembly,"Assembly Local Governments Committee: Favorable",13,5,0,0,18
1139184,782545,2019-01-15,Assembly,"Assembly Health Committee: Favorable",25,0,0,1,26
1139184,785549,2019-01-23,Assembly,"Assembly Floor Vote - Final Passage",145,0,0,5,150
1139189,879094,2019-06-06,Senate,"Senate Floor Vote - Final Passage",42,19,0,1,62
1139189,879095,2019-06-06,Senate,"Senate Rules Committee Vote",15,4,0,0,19
1139189,906152,2020-01-27,Senate,"Senate Codes Committee Vote",9,3,0,0,12
1139189,972525,2020-07-21,Senate,"Senate Floor Vote - Final Passage",41,19,0,0,60
1139193,782162,2019-01-14,Assembly,"Assembly Rules Committee: Favorable",28,0,0,2,30
1139193,782163,2019-01-14,Assembly,"Assembly Codes Committee: Favorable refer to committee Rules",19,2,0,1,22
1139193,782300,2019-01-14,Assembly,"Assembly Higher Education Committee: Favorable refer to committee Codes",24,1,0,1,26
1139193,782476,2019-01-15,Senate,"Senate Floor Vote - Final Passage",57,4,0,2,63
1139193,782673,2019-01-15,Assembly,"Assembly Floor Vote - Final Passage",141,7,0,2,150
1139213,797752,2019-02-12,Assembly,"Assembly Children And Families Committee: Favorable refer to committee Codes",14,0,0,2,16
1139213,813888,2019-03-05,Assembly,"Assembly Rules Committee: Favorable",27,0,0,4,31
1139213,813889,2019-03-05,Assembly,"Assembly Codes Committee: Favorable refer to committee Ways and Means",22,0,0,0,22
1139213,815551,2019-03-06,Assembly,"Assembly Floor Vote - Final Passage",146,0,0,4,150
1139213,820342,2019-03-05,Assembly,"Assembly Rules Committee: Favorable",27,0,0,4,31
1139226,825340,2019-03-19,Assembly,"Assembly Judiciary Committee: Favorable refer to committee Codes",14,6,0,1,21
1139226,868514,2019-05-21,Assembly,"Assembly Codes Committee: Favorable",13,8,0,1,22
1139241,782535,2019-01-15,Assembly,"Assembly Health Committee: Favorable refer to committee Ways and Means",25,0,0,1,26
1139242,877061,2019-06-03,Assembly,"Assembly Consumer Affairs And Protection Committee: Favorable refer to committee Ways and Means",15,0,0,1,16
1139242,882030,2019-06-14,Assembly,"Assembly Ways And Means Committee: Favorable refer to committee Rules",26,4,0,5,35
1139242,882495,2019-06-17,Assembly,"Assembly Rules Committee: Favorable",25,1,0,5,31
1139242,884404,2019-06-18,Assembly,"Assembly Floor Vote - Final Passage",142,4,0,4,150
1139248,876050,2019-05-30,Assembly,"Assembly Governmental Operations Committee: Favorable",12,0,0,2,14
1139285,920040,2020-02-11,Assembly,"Assembly Social Services Committee: Favorable refer to committee Ways and Means",13,4,0,0,17
1139293,784865,2019-01-23,Assembly,"Assembly Health Committee: Favorable refer to committee Ways and Means",24,0,0,2,26
1139293,864851,2019-05-14,Assembly,"Assembly Ways And Means Committee: Favorable",29,3,0,3,35
1139293,867889,2019-05-20,Assembly,"Assembly Floor Vote - Final Passage",142,1,0,7,150
1139293,882192,2019-06-14,Senate,"Senate Floor Vote - Final Passage",62,0,0,0,62
1139296,881092,2019-04-09,Senate,"Senate Environmental Conservation Committee Vote",11,0,0,0,11
1139296,881093,2019-06-11,Senate,"Senate Floor Vote - Final Passage",47,14,0,1,62
1139328,814470,2019-03-05,Assembly,"Assembly Children And Families Committee: Favorable",15,0,0,1,16
1139329,797673,2019-02-12,Assembly,"Assembly Corporations, Authorities And Commissions Committee: Favorable",24,0,0,2,26
1139329,809585,2019-02-26,Assembly,"Assembly Floor Vote - Final Passage",136,0,0,14,150
1139329,874560,2019-05-29,Senate,"Senate Floor Vote - Final Passage",60,0,0,2,62
1139331,868906,2019-05-21,Assembly,"Assembly Children And Families Committee: Favorable",15,0,0,1,16
1139331,903568,2020-01-13,Assembly,"Assembly Floor Vote - Final Passage",139,2,0,7,148
1139334,857461,2019-04-30,Assembly,"Assembly Judiciary Committee: Favorable",17,2,0,2,21
1139340,797699,2019-02-12,Assembly,"Assembly Corporations, Authorities And Commissions Committee: Favorable refer to committee Codes",18,6,0,2,26
1139340,813630,2019-03-05,Assembly,"Assembly Codes Committee: Favorable",16,6,0,0,22
1139340,819034,2019-03-11,Assembly,"Assembly Floor Vote - Final Passage",133,6,0,11,150
1139340,856951,2019-05-01,Senate,"Senate Floor Vote - Final Passage",61,1,0,0,62
1139341,879260,2019-06-06,Assembly,"Assembly Ways And Means Committee: Favorable refer to committee Rules",28,3,0,4,35
1139341,881414,2019-06-13,Assembly,"Assembly Codes Committee: Favorable refer to committee Rules",19,1,0,2,22
1139341,883664,2019-06-18,Assembly,"Assembly Rules Committee: Favorable",25,0,0,6,31
1139347,810791,2019-02-27,Assembly,"Assembly Election Law Committee: Favorable refer to committee Ways and Means",12,1,0,3,16
1139348,882680,2019-06-17,Assembly,"Assembly Rules Committee: Favorable",25,0,0,6,31
1139348,882681,2019-06-17,Assembly,"Assembly Codes Committee: Favorable refer to committee Rules",20,0,0,2,22
1139397,855954,2019-02-05,Senate,"Senate Investigations and Government Operations Committee Vote",7,0,0,0,7
1139397,855955,2019-04-29,Senate,"Senate Floor Vote - Final Passage",61,0,0,1,62
1139397,884899,2019-06-18,Assembly,"Assembly Floor Vote - Final Passage",146,0,0,4,150
1139402,824870,2019-03-19,Assembly,"Assembly Governmental Operations Committee: Favorable refer to committee Ways and Means",13,0,0,1,14
1139402,857230,2019-04-30,Assembly,"Assembly Ways And Means Committee: Favorable",25,8,0,2,35
1139415,787747,2019-01-28,Assembly,"Assembly Judiciary Committee: Favorable refer to committee Codes",15,6,0,0,21
1139415,814422,2019-03-05,Assembly,"Assembly Codes Committee: Favorable",16,6,0,0,22
1139440,830055,2019-03-26,Assembly,"Assembly Housing Committee: Favorable refer to committee Codes",19,8,0,1,28
1139440,878342,2019-06-04,Assembly,"Assembly Codes Committee: Favorable refer to committee Rules",16,6,0,0,22
1139441,857030,2019-04-30,Assembly,"Assembly Health Committee: Favorable refer to committee Ways and Means",25,0,0,1,26
1139441,863704,2019-05-14,Assembly,"Assembly Ways And Means Committee: Favorable",32,0,0,3,35
1139441,867870,2019-05-20,Assembly,"Assembly Floor Vote - Final Passage",143,0,0,7,150
1139441,882795,2019-06-17,Senate,"Senate Floor Vote - Final Passage",62,0,0,0,62
1139460,857099,2019-04-30,Assembly,"Assembly Health Committee: Favorable refer to committee Codes",19,6,0,1,26
1139499,787313,2019-01-28,Senate,"Senate Veterans, Homeland Security and Military Affairs Committee Vote",9,0,0,0,9
1139510,782647,2019-01-15,Assembly,"Assembly Health Committee: Favorable refer to committee Ways and Means",24,1,0,1,26
1139510,875615,2019-05-30,Assembly,"Assembly Ways And Means Committee: Favorable",28,3,0,4,35
1139510,877101,2019-06-03,Assembly,"Assembly Floor Vote - Final Passage",105,37,0,8,150
1139585,877646,2019-05-13,Senate,"Senate Codes Committee Vote",12,0,0,1,13
1139585,877647,2019-06-04,Senate,"Senate Floor Vote - Final Passage",61,1,0,0,62
1139590,785146,2019-01-23,Assembly,"Assembly Alcoholism And Drug Abuse Committee: Favorable refer to committee Ways and Means",13,0,0,1,14
1139597,882157,2019-06-14,Assembly,"Assembly Governmental Operations Committee: Favorable refer to committee Codes",12,0,0,2,14
1139597,883772,2019-06-18,Assembly,"Assembly Codes Committee: Favorable refer to committee Rules",22,0,0,0,22
1139597,884843,2019-06-19,Assembly,"Assembly Rules Committee: Favorable",27,0,0,4,31
1139597,886206,2019-06-21,Assembly,"Assembly Floor Vote - Final Passage",143,1,0,6,150
1139602,878481,2019-06-04,Assembly,"Assembly Labor Committee: Held for Consideration",26,2,0,1,29
1139617,782503,2019-01-15,Assembly,"Assembly Health Committee: Favorable refer to committee Codes",25,0,0,1,26
1139617,857421,2019-04-30,Assembly,"Assembly Codes Committee: Favorable",19,1,0,2,22
1139622,792714,2019-02-05,Assembly,"Assembly Consumer Affairs And Protection Committee: Favorable refer to committee Codes",15,0,0,1,16
1139622,796830,2019-02-11,Assembly,"Assembly Codes Committee: Favorable",19,3,0,0,22
1139622,826112,2019-03-20,Assembly,"Assembly Floor Vote - Final Passage",127,17,0,6,150
1139633,879985,2019-04-08,Senate,"Senate Housing, Construction and Community Development Committee Vote",11,0,0,0,11
1139633,880439,2019-06-11,Senate,"Senate Floor Vote - Final Passage",61,0,0,1,62
1139633,920365,2020-02-11,Senate,"Senate Housing, Construction and Community Development Committee Vote",11,0,0,0,11
1139633,932332,2020-02-24,Senate,"Senate Floor Vote - Final Passage",59,0,0,3,62
1139637,878608,2019-06-05,Assembly,"Assembly Codes Committee: Favorable refer to committee Ways and Means",22,0,0,0,22
1139637,878609,2019-06-05,Assembly,"Assembly Election Law Committee: Favorable refer to committee Codes",15,0,0,1,16
1139637,882034,2019-06-14,Assembly,"Assembly Ways And Means Committee: Favorable refer to committee Rules",30,0,0,5,35
1139637,882524,2019-06-17,Assembly,"Assembly Rules Committee: Favorable",26,0,0,5,31
1139637,883943,2019-06-18,Assembly,"Assembly Floor Vote - Final Passage",145,1,0,4,150
1139671,797680,2019-02-12,Assembly,"Assembly Corporations, Authorities And Commissions Committee: Favorable refer to committee Codes",24,0,0,2,26
1139671,813636,2019-03-05,Assembly,"Assembly Codes Committee: Favorable",22,0,0,0,22
1139671,819032,2019-03-11,Assembly,"Assembly Floor Vote - Final Passage",140,0,0,10,150
1139671,838490,2019-04-08,Senate,"Senate Floor Vote - Final Passage",50,9,0,3,62
1139673,797668,2019-02-12,Assembly,"Assembly Corporations, Authorities And Commissions Committee: Favorable",24,0,0,2,26
1139673,809898,2019-02-26,Assembly,"Assembly Floor Vote - Final Passage",136,0,0,14,150
1139673,877684,2019-06-04,Senate,"Senate Floor Vote - Final Passage",61,1,0,0,62
1139683,782414,2019-01-15,Assembly,"Assembly Health Committee: Favorable",24,1,0,1,26
1139683,810507,2019-02-27,Senate,"Senate Floor Vote - Final Passage",62,0,0,1,63
1139683,810937,2019-02-27,Assembly,"Assembly Floor Vote - Final Passage",132,9,0,9,150
1139717,868900,2019-05-21,Assembly,"Assembly Correction Committee: Favorable refer to committee Ways and Means",9,1,0,3,13
1139717,874765,2019-05-30,Assembly,"Assembly Ways And Means Committee: Favorable",25,6,0,4,35
1139732,942063,2020-03-03,Assembly,"Assembly Children And Families Committee: Favorable refer to committee Ways and Means",11,4,0,1,16
1139747,878331,2019-06-04,Assembly,"Assembly Judiciary Committee: Favorable refer to committee Codes",15,6,0,0,21
1139747,882859,2019-06-17,Assembly,"Assembly Codes Committee: Favorable refer to committee Rules",14,6,0,2,22
1139747,885242,2019-06-20,Assembly,"Assembly Rules Committee: Favorable",22,5,0,4,31
1139747,972292,2020-07-20,Assembly,"Assembly Floor Vote - Final Passage",106,36,0,3,145
1139757,885614,2019-06-18,Senate,"Senate Floor Vote - Final Passage",62,0,0,0,62
1139757,886266,2019-06-18,Senate,"Senate Rules Committee Vote",19,0,0,0,19
1139757,886267,2019-06-21,Assembly,"Assembly Floor Vote - Final Passage",144,0,0,6,150
1139760,856987,2019-04-30,Assembly,"Assembly Children And Families Committee: Favorable refer to committee Ways and Means",12,2,0,2,16
1139760,868640,2019-05-21,Assembly,"Assembly Ways And Means Committee: Favorable",32,0,0,3,35
1139760,874691,2019-05-29,Assembly,"Assembly Floor Vote - Final Passage",134,7,0,9,150
1139760,876877,2019-06-03,Senate,"Senate Floor Vote - Final Passage",62,0,0,0,62
1139764,820774,2019-03-12,Assembly,"Assembly Labor Committee: Favorable refer to committee Ways and Means",23,5,0,1,29
1139764,863981,2019-05-14,Assembly,"Assembly Ways And Means Committee: Favorable",32,0,0,3,35
1139764,880613,2019-06-11,Assembly,"Assembly Floor Vote - Final Passage",118,23,0,9,150
1139769,811364,2019-02-28,Assembly,"Assembly Health Committee: Favorable refer to committee Codes",21,4,0,1,26
1139769,814279,2019-03-05,Assembly,"Assembly Rules Committee: Favorable",25,2,0,4,31
1139769,814280,2019-03-05,Assembly,"Assembly Codes Committee: Favorable refer to committee Rules",14,8,0,0,22
1139769,815591,2019-03-06,Assembly,"Assembly Floor Vote - Final Passage",120,26,0,4,150
1139769,832717,2019-04-01,Senate,"Senate Floor Vote - Final Passage",52,9,0,1,62
1139770,823705,2019-03-18,Assembly,"Assembly Codes Committee: Favorable",15,6,0,1,22
1139770,840893,2019-04-09,Assembly,"Assembly Floor Vote - Final Passage",115,31,0,4,150
1139776,881146,2019-06-13,Assembly,"Assembly Health Committee: Favorable refer to committee Rules",26,0,0,0,26
1139776,882422,2019-06-17,Assembly,"Assembly Rules Committee: Favorable",26,0,0,5,31
1139776,884352,2019-06-18,Assembly,"Assembly Floor Vote - Final Passage",146,0,0,4,150
1139776,885058,2019-06-18,Senate,"Senate Floor Vote - Final Passage",62,0,0,0,62
1139789,785141,2019-01-23,Assembly,"Assembly Health Committee: Favorable refer to committee Ways and Means",24,0,0,2,26
1139802,857025,2019-05-01,Assembly,"Assembly Education Committee: Favorable refer to committee Ways and Means",28,0,0,3,31
1139802,863673,2019-05-14,Assembly,"Assembly Ways And Means Committee: Favorable",32,0,0,3,35
1139802,867876,2019-05-20,Assembly,"Assembly Floor Vote - Final Passage",142,1,0,7,150
1139802,878872,2019-06-06,Senate,"Senate Floor Vote - Final Passage",60,1,0,1,62
1139811,902718,2020-01-14,Assembly,"Assembly Insurance Committee: Favorable",15,6,0,1,22
1139837,878006,2019-06-04,Assembly,"Assembly Labor Committee: Favorable refer to committee Rules",28,0,0,1,29
1139837,878007,2019-06-05,Assembly,"Assembly Rules Committee: Favorable",27,0,0,4,31
1139837,879320,2019-06-06,Assembly,"Assembly Floor Vote - Final Passage",137,0,0,13,150
1139837,881821,2019-06-12,Senate,"Senate Floor Vote - Final Passage",62,0,0,0,62
1139840,787567,2019-01-28,Assembly,"Assembly Judiciary Committee: Favorable",20,1,0,0,21
1139840,792455,2019-02-04,Assembly,"Assembly Floor Vote - Final Passage",144,0,0,6,150
1139840,831940,2019-03-28,Senate,"Senate Floor Vote - Final Passage",61,0,0,1,62
1139842,860749,2019-05-06,Senate,"Senate Corporations, Authorities and Commissions Committee Vote",7,0,0,0,7
1139842,868681,2019-05-21,Senate,"Senate Finance Committee Vote",22,1,0,0,23
1139842,876725,2019-06-03,Senate,"Senate Floor Vote - Final Passage",50,12,0,0,62
1139842,921401,2020-02-12,Senate,"Senate Corporations, Authorities and Commissions Committee Vote",6,0,0,1,7
1139842,973063,2020-07-21,Senate,"Senate Finance Committee Vote",23,0,0,0,23
1139842,973332,2020-07-22,Senate,"Senate Rules Committee Vote",18,1,0,0,19
1139842,973489,2020-07-22,Senate,"Senate Floor Vote - Final Passage",53,7,0,0,60
1139845,857017,2019-04-30,Assembly,"Assembly Children And Families Committee: Favorable refer to committee Codes",10,4,0,2,16
1139852,782526,2019-01-15,Assembly,"Assembly Health Committee: Favorable refer to committee Ways and Means",25,0,0,1,26
1139854,797696,2019-02-12,Assembly,"Assembly Corporations, Authorities And Commissions Committee: Favorable refer to committee Codes",24,0,0,2,26
1139854,813637,2019-03-05,Assembly,"Assembly Codes Committee: Favorable",22,0,0,0,22
1139854,819035,2019-03-11,Assembly,"Assembly Floor Vote - Final Passage",138,0,0,12,150
1139854,863166,2019-05-13,Senate,"Senate Floor Vote - Final Passage",60,0,0,2,62
1139880,878456,2019-06-04,Assembly,"Assembly Governmental Operations Committee: Favorable refer to committee Ways and Means",9,3,0,2,14
1139880,882042,2019-06-14,Assembly,"Assembly Ways And Means Committee: Favorable refer to committee Rules",21,9,0,5,35
1139880,882441,2019-06-17,Assembly,"Assembly Rules Committee: Favorable",24,2,0,5,31
1139898,782574,2019-01-15,Assembly,"Assembly Health Committee: Favorable",25,0,0,1,26
1139898,785394,2019-01-23,Assembly,"Assembly Floor Vote - Final Passage",145,0,0,5,150
1139898,876021,2019-05-30,Senate,"Senate Floor Vote - Final Passage",58,0,0,4,62
1139912,870072,2019-05-21,Assembly,"Assembly Governmental Operations Committee: Favorable",14,0,0,0,14
1139912,874888,2019-05-29,Assembly,"Assembly Floor Vote - Final Passage",141,0,0,9,150
1139912,886681,2019-06-19,Senate,"Senate Floor Vote - Final Passage",61,1,0,0,62
1139913,796757,2019-01-21,Senate,"Senate Insurance Committee Vote",11,0,0,0,11
1139913,796758,2019-02-11,Senate,"Senate Floor Vote - Final Passage",61,0,0,2,63
1139913,809586,2019-02-26,Assembly,"Assembly Floor Vote - Final Passage",136,0,0,14,150
1139923,823781,2019-02-11,Senate,"Senate Children and Families Committee Vote",7,0,0,0,7
1139923,823782,2019-03-18,Senate,"Senate Floor Vote - Final Passage",49,13,0,0,62
1139928,877928,2019-06-05,Assembly,"Assembly Local Governments Committee: Favorable refer to committee Ways and Means",13,5,0,1,19
1139928,879309,2019-06-06,Assembly,"Assembly Ways And Means Committee: Favorable refer to committee Rules",21,10,0,4,35
1139928,883597,2019-06-18,Assembly,"Assembly Rules Committee: Favorable",25,0,0,6,31
1139933,828814,2019-03-26,Assembly,"Assembly Housing Committee: Favorable",19,8,0,1,28
1139933,834504,2019-04-02,Assembly,"Assembly Floor Vote - Final Passage",125,17,0,8,150
1141412,784314,2019-01-21,Senate,"Senate Insurance Committee Vote",9,2,0,0,11
1141412,784315,2019-01-22,Senate,"Senate Floor Vote - Final Passage",51,11,0,1,63
1141412,784699,2019-01-22,Senate,"Senate Rules Committee Vote",17,1,0,1,19
1141412,784700,2019-01-22,Assembly,"Assembly Floor Vote - Final Passage",100,39,0,11,150
1141439,797107,2019-02-11,Senate,"Senate Health Committee Vote",14,0,0,1,15
1141439,908842,2020-01-28,Senate,"Senate Health Committee Vote",15,0,0,0,15
1141445,875980,2019-04-29,Senate,"Senate Insurance Committee Vote",11,0,0,0,11
1141445,875981,2019-05-30,Senate,"Senate Floor Vote - Final Passage",58,0,0,4,62
1141445,906664,2020-01-27,Senate,"Senate Insurance Committee Vote",11,0,0,0,11
1141445,951220,2020-03-11,Senate,"Senate Floor Vote - Final Passage",58,0,0,4,62
1141448,832850,2019-01-28,Senate,"Senate Commerce, Economic Development And Small Business Committee Vote",8,1,0,0,9
1141448,832851,2019-04-01,Senate,"Senate Floor Vote - Final Passage",50,11,0,1,62
1141448,902764,2020-01-14,Senate,"Senate Commerce, Economic Development and Small Business Committee Vote",8,1,0,0,9
1141450,798353,2019-02-12,Senate,"Senate Labor Committee Vote",13,0,0,0,13
1141454,881422,2019-02-27,Senate,"Senate Banks Committee Vote",7,4,0,0,11
1141454,881773,2019-06-13,Senate,"Senate Floor Vote - Final Passage",51,11,0,0,62
1141454,883992,2019-06-18,Assembly,"Assembly Floor Vote - Final Passage",123,25,0,2,150
1141464,787838,2019-01-28,Senate,"Senate Rules Committee Vote",19,0,0,0,19
1141464,787839,2019-01-29,Senate,"Senate Floor Vote - Final Passage",52,11,0,0,63
1141464,788361,2019-01-29,Assembly,"Assembly Floor Vote - Final Passage",110,20,0,20,150
1141467,881930,2019-06-06,Senate,"Senate Rules Committee Vote",17,2,0,0,19
1141467,881931,2019-06-14,Senate,"Senate Floor Vote - Final Passage",60,2,0,0,62
1141467,883730,2019-06-17,Assembly,"Assembly Floor Vote - Final Passage",130,15,0,5,150
1141473,787832,2019-01-28,Senate,"Senate Rules Committee Vote",19,0,0,0,19
1141473,787833,2019-01-29,Senate,"Senate Floor Vote - Final Passage",52,11,0,0,63
1141473,788647,2019-01-29,Assembly,"Assembly Floor Vote - Final Passage",108,22,0,20,150
1141474,972308,2020-07-20,Senate,"Senate Local Government Committee Vote",7,0,0,0,7
1141474,973453,2020-07-22,Senate,"Senate Floor Vote - Final Passage",59,1,0,0,60
1141474,973795,2020-07-21,Senate,"Senate Rules Committee Vote",19,0,0,0,19
1141500,810566,2019-02-11,Senate,"Senate Women's Issues Committee Vote",7,0,0,0,7
1141500,810567,2019-02-27,Senate,"Senate Floor Vote - Final Passage",62,0,0,1,63
1141500,877851,2019-06-04,Assembly,"Assembly Floor Vote - Final Passage",146,1,0,3,150
1141503,860973,2019-05-07,Senate,"Senate Social Services Committee Vote",7,0,0,0,7
1141517,787817,2019-01-28,Senate,"Senate Rules Committee Vote",19,0,0,0,19
1141517,787818,2019-01-29,Senate,"Senate Floor Vote - Final Passage",52,11,0,0,63
1141517,788350,2019-01-29,Assembly,"Assembly Floor Vote - Final Passage",112,18,0,20,150
1141529,819958,2019-03-11,Senate,"Senate Crime Victims, Crime and Correction Committee Vote",6,1,0,0,7
1141529,855568,2019-04-30,Senate,"Senate Finance Committee Vote",21,2,0,0,23
1141529,904564,2020-01-21,Senate,"Senate Crime Victims, Crime and Correction Committee Vote",6,1,0,0,7
1141529,972475,2020-07-21,Senate,"Senate Floor Vote - Final Passage",49,11,0,0,60
1141542,832025,2019-03-26,Senate,"Senate Rules Committee Vote",19,0,0,0,19
1141542,832026,2019-03-29,Senate,"Senate Floor Vote - Final Passage",43,17,0,2,62
1141542,972683,2020-07-21,Senate,"Senate Finance Committee Vote",21,2,0,0,23
1141542,973334,2020-07-22,Senate,"Senate Rules Committee Vote",16,3,0,0,19
1141542,973495,2020-07-22,Senate,"Senate Floor Vote - Final Passage",45,15,0,0,60
1141545,816117,2019-01-22,Senate,"Senate Local Government Committee Vote",7,0,0,0,7
1141545,816118,2019-03-06,Senate,"Senate Floor Vote - Final Passage",62,0,0,1,63
1141545,906450,2020-01-27,Senate,"Senate Local Government Committee Vote",7,0,0,0,7
1141545,920123,2020-02-11,Senate,"Senate Floor Vote - Final Passage",62,0,0,0,62
1141555,856137,2019-04-30,Senate,"Senate Health Committee Vote",15,0,0,0,15
1141560,875558,2019-05-29,Senate,"Senate Investigations and Government Operations Committee Vote",7,0,0,0,7
1141572,867655,2019-05-13,Senate,"Senate Insurance Committee Vote",11,0,0,0,11
1141572,867656,2019-05-20,Senate,"Senate Floor Vote - Final Passage",60,0,0,2,62
1141572,902112,2020-01-13,Senate,"Senate Insurance Committee Vote",11,0,0,0,11
1141572,903866,2020-01-21,Senate,"Senate Floor Vote - Final Passage",61,0,0,1,62
1141580,854967,2019-02-05,Senate,"Senate Investigations and Government Operations Committee Vote",7,0,0,0,7
1141580,855179,2019-04-30,Senate,"Senate Floor Vote - Final Passage",61,1,0,0,62
1141580,855180,2019-04-30,Senate,"Senate Finance Committee Vote",23,0,0,0,23
1141580,856382,2019-04-30,Senate,"Senate Finance Committee Vote",23,0,0,0,23
1141583,886521,2019-06-20,Senate,"Senate Floor Vote - Final Passage",62,0,0,0,62
1141583,887344,2019-06-20,Senate,"Senate Rules Committee Vote",19,0,0,0,19
1141587,784320,2019-01-22,Senate,"Senate Floor Vote - Final Passage",56,6,0,1,63
1141587,784321,2019-01-22,Senate,"Senate Labor Committee Vote",10,3,0,0,13
1141587,784695,2019-01-22,Senate,"Senate Labor Committee Vote",10,3,0,0,13
1141587,784696,2019-01-22,Assembly,"Assembly Floor Vote - Final Passage",105,33,0,12,150
1141597,868061,2019-05-21,Senate,"Senate Children and Families Committee Vote",7,0,0,0,7
1141597,869230,2019-05-21,Senate,"Senate Children and Families Committee Vote",7,0,0,0,7
1141597,869231,2019-05-22,Senate,"Senate Floor Vote - Final Passage",61,0,0,1,62
1141597,904699,2020-01-21,Senate,"Senate Children and Families Committee Vote",7,0,0,0,7
1141600,782518,2019-01-15,Assembly,"Assembly Labor Committee: Favorable refer to committee Codes",19,8,0,2,29
1141600,782519,2019-01-15,Assembly,"Assembly Codes Committee: Favorable",15,6,0,1,22
1141607,797428,2019-02-11,Senate,"Senate Children and Families Committee Vote",7,0,0,0,7
1141613,782168,2019-01-14,Assembly,"Assembly Insurance Committee: Favorable refer to committee Codes",17,7,0,1,25
1141613,782416,2019-01-15,Assembly,"Assembly Codes Committee: Favorable",15,6,0,1,22
1141618,819704,2019-03-11,Senate,"Senate Crime Victims, Crime and Correction Committee Vote",5,2,0,0,7
1141618,860971,2019-05-07,Senate,"Senate Finance Committee Vote",19,4,0,0,23
1141622,972319,2020-07-20,Senate,"Senate Local Government Committee Vote",7,0,0,0,7
1141622,973896,2020-07-21,Senate,"Senate Rules Committee Vote",19,0,0,0,19
1141622,973897,2020-07-22,Senate,"Senate Floor Vote - Final Passage",59,1,0,0,60
1141623,875908,2019-05-30,Senate,"Senate New York City Education Committee Vote",7,0,0,0,7
1141623,880028,2019-06-11,Senate,"Senate Rules Committee Vote",18,1,0,0,19
1141623,880515,2019-06-11,Senate,"Senate Floor Vote - Final Passage",61,0,0,1,62
1142163,868332,2019-05-21,Assembly,"Assembly Transportation Committee: Favorable",25,0,0,0,25
1142189,869080,2019-05-21,Senate,"Senate Health Committee Vote",15,0,0,0,15
1142244,857001,2019-05-01,Assembly,"Assembly Election Law Committee: Favorable refer to committee Codes",16,0,0,0,16
1142244,859855,2019-05-07,Assembly,"Assembly Codes Committee: Favorable refer to committee Ways and Means",20,0,0,2,22
1142244,874762,2019-05-30,Assembly,"Assembly Ways And Means Committee: Favorable",31,0,0,4,35
1142246,857377,2019-04-30,Assembly,"Assembly Corporations, Authorities And Commissions Committee: Favorable",19,6,0,1,26
1142246,972244,2020-07-20,Assembly,"Assembly Floor Vote - Final Passage",110,32,0,3,145
1142252,784531,2019-01-22,Senate,"Senate Labor Committee Vote",13,0,0,0,13
1142252,786914,2019-01-28,Senate,"Senate Floor Vote - Final Passage",63,0,0,0,63
1142252,787816,2019-01-28,Senate,"Senate Rules Committee Vote",18,1,0,0,19
1142252,903319,2020-01-14,Senate,"Senate Labor Committee Vote",13,0,0,0,13
1142252,904684,2020-01-22,Senate,"Senate Finance Committee Vote",23,0,0,0,23
1142252,907244,2020-01-28,Senate,"Senate Floor Vote - Final Passage",62,0,0,0,62
1142262,785148,2019-01-23,Assembly,"Assembly Alcoholism And Drug Abuse Committee: Favorable refer to committee Ways and Means",13,0,0,1,14
1142262,885460,2019-06-19,Assembly,"Assembly Rules Committee: Favorable",28,0,0,3,31
1142262,885461,2019-06-19,Assembly,"Assembly Ways And Means Committee: Favorable refer to committee Rules",31,2,0,2,35
1142262,886156,2019-06-21,Assembly,"Assembly Floor Vote - Final Passage",141,3,0,6,150
1142269,875168,2019-05-21,Senate,"Senate Finance Committee Vote",23,0,0,0,23
1142269,875169,2019-05-30,Senate,"Senate Floor Vote - Final Passage",58,0,0,4,62
1142269,904641,2020-01-22,Senate,"Senate Finance Committee Vote",23,0,0,0,23
1142269,920178,2020-02-11,Senate,"Senate Floor Vote - Final Passage",62,0,0,0,62
1142281,971426,2020-07-16,Assembly,"Assembly Housing Committee: Favorable refer to committee Ways and Means",26,0,0,2,28
1142281,971840,2020-07-17,Assembly,"Assembly Ways And Means Committee: Favorable refer to committee Rules",32,0,0,2,34
1142281,972229,2020-07-20,Assembly,"Assembly Rules Committee: Favorable",27,0,0,3,30
1142281,972285,2020-07-20,Assembly,"Assembly Floor Vote - Final Passage",141,0,0,4,145
1142294,970875,2020-07-13,Assembly,"Assembly Alcoholism And Drug Abuse Committee: Favorable refer to committee Codes",13,0,0,1,14
1142294,971718,2020-07-17,Assembly,"Assembly Codes Committee: Favorable refer to committee Ways and Means",20,1,0,1,22
1142314,861512,2019-05-07,Assembly,"Assembly Health Committee: Favorable refer to committee Ways and Means",19,3,0,4,26
1142352,875243,2019-05-30,Assembly,"Assembly Consumer Affairs And Protection Committee: Favorable refer to committee Codes",15,0,0,1,16
1142352,907578,2020-01-28,Assembly,"Assembly Codes Committee: Favorable",21,0,0,1,22
1142368,857116,2019-04-30,Assembly,"Assembly Health Committee: Favorable refer to committee Codes",25,0,0,1,26
1142368,859834,2019-05-07,Assembly,"Assembly Codes Committee: Favorable refer to committee Ways and Means",20,0,0,2,22
1142444,785144,2019-01-23,Assembly,"Assembly Alcoholism And Drug Abuse Committee: Favorable refer to committee Ways and Means",13,0,0,1,14
1142444,882320,2019-06-14,Assembly,"Assembly Ways And Means Committee: Favorable refer to committee Rules",26,4,0,5,35
1142444,882503,2019-06-17,Assembly,"Assembly Rules Committee: Favorable",26,0,0,5,31
1142444,883956,2019-06-18,Assembly,"Assembly Floor Vote - Final Passage",133,13,0,4,150
1142444,885592,2019-06-18,Senate,"Senate Floor Vote - Final Passage",48,14,0,0,62
1142456,840803,2019-04-09,Assembly,"Assembly Transportation Committee: Favorable",23,0,0,2,25
1142456,902552,2020-01-13,Assembly,"Assembly Floor Vote - Final Passage",141,0,0,7,148
1142470,902630,2020-01-14,Assembly,"Assembly Judiciary Committee: Favorable",15,6,0,0,21
1142470,914969,2020-01-14,Assembly,"Assembly Judiciary Committee: Favorable",15,6,0,0,21
1142479,881887,2019-06-12,Senate,"Senate Floor Vote - Final Passage",62,0,0,0,62
1142479,881888,2019-06-12,Senate,"Senate Rules Committee Vote",19,0,0,0,19
1142501,819370,2019-02-27,Senate,"Senate Judiciary Committee Vote",13,2,0,0,15
1142501,820128,2019-03-12,Senate,"Senate Floor Vote - Final Passage",50,11,0,1,62
1142501,902980,2020-01-14,Senate,"Senate Judiciary Committee Vote",12,3,0,0,15
1142501,931904,2020-02-24,Senate,"Senate Floor Vote - Final Passage",47,12,0,3,62
1142562,948146,2020-03-02,Senate,"Senate Corporations, Authorities and Commissions Committee Vote",6,0,0,1,7
1142562,948147,2020-03-10,Senate,"Senate Floor Vote - Final Passage",59,0,0,3,62
1142564,792986,2019-02-04,Senate,"Senate Civil Service and Pensions Committee Vote",7,0,0,0,7
1142564,819952,2019-03-12,Senate,"Senate Finance Committee Vote",20,2,0,1,23
1142576,813586,2019-03-05,Assembly,"Assembly Codes Committee: Favorable",16,6,0,0,22
1142615,857515,2019-04-30,Assembly,"Assembly Consumer Affairs And Protection Committee: Favorable refer to committee Codes",16,0,0,0,16
1142615,859847,2019-05-07,Assembly,"Assembly Codes Committee: Favorable",20,0,0,2,22
1142615,880626,2019-06-11,Assembly,"Assembly Floor Vote - Final Passage",131,10,0,9,150
1142627,785150,2019-01-23,Assembly,"Assembly Health Committee: Favorable refer to committee Ways and Means",24,0,0,2,26
1142627,879215,2019-06-05,Assembly,"Assembly Ways And Means Committee: Favorable refer to committee Rules",27,4,0,4,35
1142627,880473,2019-06-11,Assembly,"Assembly Rules Committee: Favorable",25,0,0,6,31
1143049,881740,2019-05-14,Senate,"Senate Health Committee Vote",15,0,0,0,15
1143049,881741,2019-06-13,Senate,"Senate Floor Vote - Final Passage",49,13,0,0,62
1143049,884270,2019-06-18,Assembly,"Assembly Floor Vote - Final Passage",122,25,0,3,150
1143061,920264,2020-02-11,Assembly,"Assembly Higher Education Committee: Favorable refer to committee Ways and Means",23,0,0,1,24
1143078,857552,2019-04-30,Assembly,"Assembly Judiciary Committee: Favorable",19,0,0,2,21
1143086,792548,2019-02-05,Assembly,"Assembly Governmental Operations Committee: Favorable refer to committee Codes",11,2,0,1,14
1143086,796466,2019-02-11,Assembly,"Assembly Codes Committee: Favorable",22,0,0,0,22
1143086,877192,2019-06-03,Assembly,"Assembly Floor Vote - Final Passage",115,27,0,8,150
1143086,880402,2019-06-11,Senate,"Senate Floor Vote - Final Passage",47,14,0,1,62
1143089,797677,2019-02-12,Assembly,"Assembly Corporations, Authorities And Commissions Committee: Favorable refer to committee Codes",19,5,0,2,26
1143089,819185,2019-03-12,Assembly,"Assembly Codes Committee: Favorable",15,6,0,1,22
1143089,842171,2019-04-10,Assembly,"Assembly Floor Vote - Final Passage",108,33,0,9,150
1143096,878559,2019-06-04,Assembly,"Assembly Housing Committee: Favorable refer to committee Codes",18,8,0,2,28
1143096,880205,2019-06-11,Assembly,"Assembly Codes Committee: Favorable refer to committee Rules",16,6,0,0,22
1143126,860730,2019-05-07,Assembly,"Assembly Alcoholism And Drug Abuse Committee: Favorable refer to committee Ways and Means",14,0,0,0,14
1143142,902601,2020-01-14,Assembly,"Assembly Rules Committee: Favorable",25,0,0,5,30
1143142,902602,2020-01-14,Assembly,"Assembly Codes Committee: Favorable refer to committee Rules",20,0,0,1,21
1143142,902603,2020-01-14,Assembly,"Assembly Transportation Committee: Favorable refer to committee Codes",24,0,0,1,25
1143142,902876,2020-01-14,Senate,"Senate Floor Vote - Final Passage",60,0,0,2,62
1143142,902936,2020-01-14,Assembly,"Assembly Floor Vote - Final Passage",140,0,0,8,148
1143160,785272,2019-01-23,Assembly,"Assembly Health Committee: Favorable refer to committee Codes",24,0,0,2,26
1143160,787411,2019-01-28,Assembly,"Assembly Codes Committee: Favorable refer to committee Ways and Means",22,0,0,0,22
1143160,879547,2019-06-06,Assembly,"Assembly Ways And Means Committee: Favorable refer to committee Rules",31,0,0,4,35
1143160,881369,2019-06-13,Assembly,"Assembly Rules Committee: Favorable",26,0,0,5,31
1143160,973731,2020-07-23,Assembly,"Assembly Floor Vote - Final Passage",105,36,0,4,145
1143162,868861,2019-05-21,Senate,"Senate Higher Education Committee Vote",11,0,0,0,11
1143172,885173,2019-06-19,Senate,"Senate Rules Committee Vote",19,0,0,0,19
1143172,886482,2019-06-19,Senate,"Senate Floor Vote - Final Passage",62,0,0,0,62
1143180,859759,2019-05-06,Assembly,"Assembly Insurance Committee: Favorable refer to committee Codes",14,8,0,2,24
1143180,874956,2019-05-30,Assembly,"Assembly Codes Committee: Favorable refer to committee Ways and Means",15,4,0,3,22
1143180,882029,2019-06-14,Assembly,"Assembly Ways And Means Committee: Favorable refer to committee Rules",22,8,0,5,35
1143180,882440,2019-06-17,Assembly,"Assembly Rules Committee: Favorable",24,2,0,5,31
1143180,883981,2019-06-18,Assembly,"Assembly Floor Vote - Final Passage",128,20,0,2,150
1143180,886607,2019-06-19,Senate,"Senate Floor Vote - Final Passage",62,0,0,0,62
1143220,868697,2019-05-21,Assembly,"Assembly Governmental Operations Committee: Favorable refer to committee Codes",9,5,0,0,14
1143220,874914,2019-05-30,Assembly,"Assembly Codes Committee: Favorable",15,4,0,3,22
1143220,972259,2020-07-20,Assembly,"Assembly Floor Vote - Final Passage",103,39,0,3,145
1143244,878072,2019-06-05,Assembly,"Assembly Transportation Committee: Favorable refer to committee Codes",26,0,0,0,26
1143247,878842,2019-06-06,Assembly,"Assembly Environmental Conservation Committee: Favorable refer to committee Codes",18,10,0,2,30
1143250,784515,2019-01-22,Senate,"Senate Health Committee Vote",14,1,0,0,15
1143250,829834,2019-03-26,Senate,"Senate Rules Committee Vote",19,0,0,0,19
1143252,902545,2020-01-14,Assembly,"Assembly Insurance Committee: Favorable refer to committee Codes",16,5,0,1,22
1143252,907277,2020-01-28,Assembly,"Assembly Codes Committee: Favorable",17,4,0,1,22
1143255,813641,2019-03-05,Assembly,"Assembly Consumer Affairs And Protection Committee: Favorable refer to committee Codes",13,3,0,0,16
1143255,819737,2019-03-12,Assembly,"Assembly Codes Committee: Favorable",20,1,0,1,22
1143255,831040,2019-03-27,Assembly,"Assembly Floor Vote - Final Passage",121,27,0,2,150
1143259,860746,2019-05-07,Assembly,"Assembly Environmental Conservation Committee: Favorable refer to committee Codes",18,10,0,2,30
1143259,934414,2020-02-25,Assembly,"Assembly Codes Committee: Favorable",15,6,0,1,22
1143302,973144,2020-07-22,Senate,"Senate Floor Vote - Final Passage",44,16,0,0,60
1143302,973293,2020-07-22,Senate,"Senate Rules Committee Vote",14,5,0,0,19
1143306,825347,2019-03-19,Assembly,"Assembly Agriculture Committee: Favorable refer to committee Codes",19,1,0,1,21
1143327,787809,2019-01-28,Senate,"Senate Rules Committee Vote",19,0,0,0,19
1143327,787810,2019-01-29,Senate,"Senate Floor Vote - Final Passage",52,11,0,0,63
1143327,788394,2019-01-29,Assembly,"Assembly Floor Vote - Final Passage",110,20,0,20,150
1143328,876067,2019-05-30,Assembly,"Assembly Social Services Committee: Favorable refer to committee Ways and Means",15,1,0,2,18
1143334,791949,2019-02-04,Assembly,"Assembly Health Committee: Favorable",23,2,0,1,26
1143349,792231,2019-01-22,Senate,"Senate Transportation Committee Vote",15,0,0,0,15
1143349,792232,2019-02-04,Senate,"Senate Floor Vote - Final Passage",62,0,0,1,63
1143349,935688,2020-02-25,Senate,"Senate Transportation Committee Vote",15,0,0,0,15
1143371,878732,2019-06-06,Assembly,"Assembly Corporations, Authorities And Commissions Committee: Favorable refer to committee Rules",24,1,0,1,26
1143372,875062,2019-05-30,Assembly,"Assembly Consumer Affairs And Protection Committee: Favorable refer to committee Codes",12,3,0,1,16
1143372,877245,2019-06-04,Assembly,"Assembly Codes Committee: Favorable refer to committee Rules",14,8,0,0,22
1143386,820795,2019-03-12,Assembly,"Assembly Codes Committee: Favorable",15,6,0,1,22
1143413,878483,2019-06-04,Assembly,"Assembly Labor Committee: Favorable refer to committee Rules",27,1,0,1,29
1143423,878251,2019-06-05,Assembly,"Assembly Education Committee: Favorable refer to committee Rules",24,5,0,2,31
1143438,878980,2019-06-06,Assembly,"Assembly Environmental Conservation Committee: Favorable refer to committee Rules",21,7,0,2,30
1143438,971042,2020-07-14,Assembly,"Assembly Environmental Conservation Committee: Favorable refer to committee Rules",19,8,0,1,28
1143438,972555,2020-07-21,Assembly,"Assembly Rules Committee: Favorable",19,7,0,4,30
1144729,787749,2019-01-28,Assembly,"Assembly Codes Committee: Favorable",22,0,0,0,22
1144729,886203,2019-06-20,Assembly,"Assembly Floor Vote - Final Passage",124,22,0,4,150
1144751,811173,2019-02-27,Senate,"Senate Health Committee Vote",14,0,0,1,15
1144759,855589,2019-04-30,Senate,"Senate Transportation Committee Vote",14,1,0,0,15
1144781,972503,2020-01-14,Senate,"Senate Health Committee Vote",14,0,0,0,14
1144781,972504,2020-07-21,Senate,"Senate Floor Vote - Final Passage",59,1,0,0,60
1144823,787719,2019-01-28,Assembly,"Assembly Codes Committee: Favorable",22,0,0,0,22
1144823,792452,2019-02-04,Assembly,"Assembly Floor Vote - Final Passage",143,0,0,7,150
1144908,879992,2019-01-22,Senate,"Senate Transportation Committee Vote",15,0,0,0,15
1144908,880456,2019-06-11,Senate,"Senate Floor Vote - Final Passage",61,0,0,1,62
1145017,792278,2019-01-22,Senate,"Senate Local Government Committee Vote",7,0,0,0,7
1145017,792279,2019-02-04,Senate,"Senate Floor Vote - Final Passage",49,13,0,1,63
1145017,860963,2019-05-07,Assembly,"Assembly Floor Vote - Final Passage",134,0,0,16,150
1145070,839440,2019-04-09,Senate,"Senate Health Committee Vote",15,0,0,0,15
1145173,782081,2019-01-14,Senate,"Senate Investigations and Government Operations Committee Vote",6,0,0,1,7
1145173,782149,2019-01-14,Senate,"Senate Investigations and Government Operations Committee Vote",6,0,0,1,7
1145173,782583,2019-01-15,Senate,"Senate Floor Vote - Final Passage",42,19,0,2,63
1145173,782669,2019-01-15,Assembly,"Assembly Floor Vote - Final Passage",105,43,0,2,150
1145251,914764,2020-01-13,Senate,"Senate Alcoholism And Substance Abuse Committee Vote",6,1,0,0,7
1145251,914765,2020-02-04,Senate,"Senate Floor Vote - Final Passage",61,0,0,1,62
1145336,855322,2019-04-30,Senate,"Senate Children And Families Committee Vote",7,0,0,0,7
1145336,868447,2019-05-21,Senate,"Senate Finance Committee Vote",23,0,0,0,23
1145336,880144,2019-06-11,Senate,"Senate Floor Vote - Final Passage",60,1,0,1,62
1145336,916630,2020-02-04,Senate,"Senate Children and Families Committee Vote",7,0,0,0,7
1145498,876600,2019-06-03,Senate,"Senate Floor Vote - Final Passage",56,6,0,0,62
1145498,877308,2019-06-03,Senate,"Senate Rules Committee Vote",18,1,0,0,19
1145498,939465,2020-03-02,Senate,"Senate Agriculture Committee Vote",9,0,0,0,9
1145519,863535,2019-05-13,Senate,"Senate Investigations and Government Operations Committee Vote",7,0,0,0,7
1145519,863536,2019-05-14,Senate,"Senate Floor Vote - Final Passage",59,0,0,3,62
1145519,863537,2019-05-14,Senate,"Senate Rules Committee Vote",18,0,0,1,19
1145519,864266,2019-05-14,Assembly,"Assembly Floor Vote - Final Passage",140,1,0,9,150
1145667,782113,2019-01-14,Senate,"Senate Judiciary Committee Vote",11,4,0,0,15
1145667,782323,2019-01-14,Senate,"Senate Judiciary Committee Vote",11,4,0,0,15
1145667,782324,2019-01-15,Senate,"Senate Floor Vote - Final Passage",44,17,0,2,63
1145667,782386,2019-01-14,Assembly,"Assembly Floor Vote - Final Passage",104,42,0,4,150
1145667,782481,2019-01-15,Senate,"Senate Floor Vote - Final Passage",44,17,0,2,63
1145810,782116,2019-01-14,Senate,"Senate Judiciary Committee Vote",15,0,0,0,15
1145810,782326,2019-01-14,Senate,"Senate Judiciary Committee Vote",15,0,0,0,15
1145810,782327,2019-01-15,Senate,"Senate Floor Vote - Final Passage",56,5,0,2,63
1145810,782354,2019-01-14,Assembly,"Assembly Floor Vote - Final Passage",136,9,0,5,150
1145810,782482,2019-01-15,Senate,"Senate Floor Vote - Final Passage",56,5,0,2,63
1145894,971074,2020-07-14,Assembly,"Assembly Judiciary Committee: Held for Consideration",15,6,0,0,21
1145912,797120,2019-02-11,Senate,"Senate Health Committee Vote",12,2,0,1,15
1145976,815681,2019-02-27,Senate,"Senate Commerce, Economic Development and Small Business Committee Vote",8,1,0,0,9
1145976,816194,2019-03-07,Senate,"Senate Floor Vote - Final Passage",58,0,0,5,63
1145976,883476,2019-06-17,Assembly,"Assembly Floor Vote - Final Passage",145,0,0,5,150
1146017,809496,2019-01-22,Senate,"Senate Transportation Committee Vote",15,0,0,0,15
1146017,809497,2019-02-26,Senate,"Senate Floor Vote - Final Passage",61,0,0,2,63
1146087,815343,2019-03-05,Senate,"Senate Social Services Committee Vote",7,0,0,0,7
1146087,839426,2019-04-09,Senate,"Senate Finance Committee Vote",22,1,0,0,23
1146087,856621,2019-05-01,Senate,"Senate Floor Vote - Final Passage",45,17,0,0,62
1146087,886181,2019-06-20,Assembly,"Assembly Floor Vote - Final Passage",97,49,0,4,150
1146126,876844,2019-03-04,Senate,"Senate Codes Committee Vote",13,0,0,0,13
1146126,876845,2019-06-03,Senate,"Senate Floor Vote - Final Passage",60,2,0,0,62
1146126,902059,2020-01-13,Senate,"Senate Codes Committee Vote",13,0,0,0,13
1146126,919171,2020-02-10,Senate,"Senate Floor Vote - Final Passage",60,1,0,1,62
1146146,970822,2020-07-13,Assembly,"Assembly Consumer Affairs And Protection Committee: Favorable refer to committee Codes",15,0,0,1,16
1146146,971774,2020-07-17,Assembly,"Assembly Codes Committee: Favorable refer to committee Rules",21,0,0,1,22
1146165,863016,2019-04-09,Senate,"Senate Health Committee Vote",14,0,0,1,15
1146165,863017,2019-05-13,Senate,"Senate Floor Vote - Final Passage",60,0,0,2,62
1146165,882072,2019-06-14,Senate,"Senate Floor Vote - Final Passage",62,0,0,0,62
1146165,883968,2019-06-18,Assembly,"Assembly Floor Vote - Final Passage",146,0,0,4,150
1146266,867841,2019-05-07,Senate,"Senate Finance Committee Vote",23,0,0,0,23
1146266,867842,2019-05-20,Senate,"Senate Floor Vote - Final Passage",59,1,0,2,62
1146266,904861,2020-01-22,Senate,"Senate Finance Committee Vote",23,0,0,0,23
1146266,923013,2020-02-13,Senate,"Senate Floor Vote - Final Passage",56,1,0,5,62
1146266,972375,2020-07-20,Assembly,"Assembly Floor Vote - Final Passage",141,0,0,4,145
1146287,782248,2019-01-14,Assembly,"Assembly Rules Committee: Favorable",21,7,0,2,30
1146287,782249,2019-01-14,Assembly,"Assembly Codes Committee: Favorable refer to committee Rules",15,6,0,1,22
1146287,782250,2019-01-14,Assembly,"Assembly Governmental Operations Committee: Favorable refer to committee Codes",10,3,0,1,14
1146331,782115,2019-01-14,Senate,"Senate Higher Education Committee Vote",9,2,0,0,11
1146331,782325,2019-01-14,Senate,"Senate Higher Education Committee Vote",9,2,0,0,11
1146331,782649,2019-01-15,Senate,"Senate Floor Vote - Final Passage",57,4,0,2,63
1146435,786897,2019-01-28,Assembly,"Assembly Rules Committee: Favorable",28,1,0,2,31
1146435,786898,2019-01-28,Assembly,"Assembly Codes Committee: Favorable refer to committee Rules",22,0,0,0,22
1146464,787736,2019-01-28,Assembly,"Assembly Codes Committee: Favorable",22,0,0,0,22
1146464,792785,2019-02-04,Assembly,"Assembly Floor Vote - Final Passage",143,0,0,7,150
1146464,882132,2019-06-13,Senate,"Senate Floor Vote - Final Passage",62,0,0,0,62
1146648,797136,2019-02-11,Senate,"Senate Health Committee Vote",10,4,0,1,15
1146648,886251,2019-06-21,Assembly,"Assembly Floor Vote - Final Passage",141,0,0,9,150
1146648,886718,2019-06-19,Senate,"Senate Floor Vote - Final Passage",44,18,0,0,62
1146648,887160,2019-06-19,Senate,"Senate Rules Committee Vote",12,7,0,0,19
1146849,825373,2019-03-19,Assembly,"Assembly Governmental Employees Committee: Favorable refer to committee Ways and Means",11,3,0,0,14
1146873,829782,2019-03-26,Assembly,"Assembly Economic Development Committee: Favorable refer to committee Ways and Means",24,0,0,2,26
1146894,878736,2019-06-06,Assembly,"Assembly Environmental Conservation Committee: Held for Consideration",20,8,0,2,30
1147121,782186,2019-01-14,Assembly,"Assembly Election Law Committee: Favorable refer to committee Ways and Means",15,0,0,1,16
1147121,782187,2019-01-14,Assembly,"Assembly Rules Committee: Favorable",28,0,0,2,30
1147121,782189,2019-01-14,Assembly,"Assembly Ways And Means Committee: Favorable refer to committee Rules",25,7,0,3,35
1147121,782190,2019-01-15,Senate,"Senate Floor Vote - Final Passage",53,8,0,2,63
1147121,782418,2019-01-14,Assembly,"Assembly Floor Vote - Final Passage",42,102,0,6,150
1147121,782527,2019-01-15,Senate,"Senate Floor Vote - Final Passage",52,9,0,2,63
1147137,782135,2019-01-14,Assembly,"Assembly Election Law Committee: Favorable refer to committee Judiciary",15,0,0,1,16
1147137,782136,2019-01-14,Assembly,"Assembly Rules Committee: Favorable",28,0,0,2,30
1147137,782352,2019-01-14,Assembly,"Assembly Judiciary Committee: Favorable refer to committee Rules",20,1,0,0,21
1147152,782083,2019-01-14,Senate,"Senate Elections Committee Vote",5,2,0,0,7
1147152,782275,2019-01-14,Senate,"Senate Elections Committee Vote",5,2,0,0,7
1147152,782276,2019-01-15,Senate,"Senate Floor Vote - Final Passage",54,7,0,2,63
1147152,783836,2019-01-15,Senate,"Senate Floor Vote - Final Passage",55,6,0,2,63
1147169,811378,2019-02-27,Assembly,"Assembly Judiciary Committee: Favorable refer to committee Ways and Means",15,6,0,0,21
1147169,868954,2019-05-21,Assembly,"Assembly Ways And Means Committee: Favorable",22,10,0,3,35
1147169,880670,2019-06-11,Assembly,"Assembly Floor Vote - Final Passage",139,2,0,9,150
1147169,882020,2019-06-13,Senate,"Senate Floor Vote - Final Passage",56,6,0,0,62
1147184,782095,2019-01-14,Senate,"Senate Elections Committee Vote",7,0,0,0,7
1147184,782177,2019-01-14,Senate,"Senate Elections Committee Vote",7,0,0,0,7
1147184,783808,2019-01-14,Senate,"Senate Floor Vote - Final Passage",47,14,0,2,63
1147184,783809,2019-01-15,Senate,"Senate Floor Vote - Final Passage",47,14,0,2,63
1147216,782098,2019-01-14,Senate,"Senate Elections Committee Vote",6,1,0,0,7
1147216,782302,2019-01-14,Senate,"Senate Elections Committee Vote",6,1,0,0,7
1147216,782303,2019-01-15,Senate,"Senate Floor Vote - Final Passage",49,12,0,2,63
1147216,783839,2019-01-15,Senate,"Senate Floor Vote - Final Passage",49,12,0,2,63
1147282,782084,2019-01-14,Senate,"Senate Elections Committee Vote",6,1,0,0,7
1147282,782170,2019-01-14,Senate,"Senate Elections Committee Vote",6,1,0,0,7
1147282,782285,2019-01-15,Senate,"Senate Floor Vote - Final Passage",53,8,0,2,63
1147282,782502,2019-01-15,Senate,"Senate Floor Vote - Final Passage",52,9,0,2,63
1147297,782197,2019-01-14,Assembly,"Assembly Rules Committee: Favorable",27,1,0,2,30
1147297,782198,2019-01-14,Assembly,"Assembly Election Law Committee: Favorable refer to committee Rules",11,4,0,1,16
1147297,782199,2019-01-15,Senate,"Senate Floor Vote - Final Passage",49,12,0,2,63
1147297,782351,2019-01-14,Assembly,"Assembly Floor Vote - Final Passage",114,32,0,4,150
1147297,782528,2019-01-15,Senate,"Senate Floor Vote - Final Passage",49,12,0,2,63
1147311,782223,2019-01-14,Assembly,"Assembly Election Law Committee: Favorable refer to committee Ways and Means",11,4,0,1,16
1147311,782224,2019-01-14,Assembly,"Assembly Rules Committee: Favorable",26,2,0,2,30
1147311,782225,2019-01-14,Assembly,"Assembly Ways And Means Committee: Favorable refer to committee Rules",24,8,0,3,35
1147329,782243,2019-01-14,Assembly,"Assembly Election Law Committee: Favorable refer to committee Ways and Means",11,4,0,1,16
1147329,782244,2019-01-14,Assembly,"Assembly Rules Committee: Favorable",26,2,0,2,30
1147329,782245,2019-01-14,Assembly,"Assembly Ways And Means Committee: Favorable refer to committee Rules",23,9,0,3,35
1147329,782246,2019-01-15,Senate,"Senate Floor Vote - Final Passage",47,14,0,2,63
1147329,782356,2019-01-14,Assembly,"Assembly Floor Vote - Final Passage",107,39,0,4,150
1147329,782428,2019-01-15,Senate,"Senate Floor Vote - Final Passage",47,14,0,2,63
1147347,782151,2019-01-14,Assembly,"Assembly Election Law Committee: Favorable refer to committee Judiciary",11,4,0,1,16
1147347,782152,2019-01-14,Assembly,"Assembly Rules Committee: Favorable",27,1,0,2,30
1147347,783800,2019-01-14,Assembly,"Assembly Judiciary Committee: Favorable refer to committee Rules",15,6,0,0,21
1147379,782118,2019-01-14,Senate,"Senate Elections Committee Vote",6,1,0,0,7
1147379,782328,2019-01-14,Senate,"Senate Elections Committee Vote",6,1,0,0,7
1147379,782329,2019-01-15,Senate,"Senate Floor Vote - Final Passage",48,13,0,2,63
1147379,782355,2019-01-14,Assembly,"Assembly Floor Vote - Final Passage",89,55,0,6,150
1147379,782631,2019-01-15,Senate,"Senate Floor Vote - Final Passage",48,13,0,2,63
1147410,782313,2019-01-14,Assembly,"Assembly Election Law Committee: Favorable refer to committee Codes",15,0,0,1,16
1147410,782314,2019-01-14,Assembly,"Assembly Rules Committee: Favorable",28,0,0,2,30
1147410,782315,2019-01-14,Assembly,"Assembly Codes Committee: Favorable refer to committee Rules",21,0,0,1,22
1147410,782316,2019-01-15,Senate,"Senate Floor Vote - Final Passage",54,7,0,2,63
1147410,782424,2019-01-14,Assembly,"Assembly Floor Vote - Final Passage",133,13,0,4,150
1147410,782529,2019-01-15,Senate,"Senate Floor Vote - Final Passage",55,6,0,2,63
1147767,860916,2019-03-26,Senate,"Senate Commerce, Economic Development and Small Business Committee Vote",9,0,0,0,9
1147767,861408,2019-05-08,Senate,"Senate Floor Vote - Final Passage",61,0,0,1,62
1147849,839416,2019-04-09,Senate,"Senate Cultural Affairs, Tourism, Parks and Recreation Committee Vote",7,0,0,0,7
1147849,934875,2020-02-25,Senate,"Senate Cultural Affairs, Tourism, Parks and Recreation Committee Vote",7,0,0,0,7
1147989,870474,2019-05-21,Senate,"Senate Elections Committee Vote",5,2,0,0,7
1147989,880018,2019-06-11,Senate,"Senate Rules Committee Vote",15,4,0,0,19
1147989,880452,2019-06-11,Senate,"Senate Floor Vote - Final Passage",40,21,0,1,62
1147989,886187,2019-06-20,Assembly,"Assembly Floor Vote - Final Passage",114,33,0,3,150
1148006,882197,2019-06-13,Assembly,"Assembly Codes Committee: Favorable refer to committee Rules",14,6,0,2,22
1148012,782407,2019-01-14,Senate,"Senate Rules Committee Vote",18,0,0,1,19
1148012,782512,2019-01-15,Senate,"Senate Floor Vote - Final Passage",45,16,0,2,63
1148012,782827,2019-01-15,Assembly,"Assembly Floor Vote - Final Passage",99,48,0,3,150
1148028,972526,2020-02-11,Senate,"Senate Judiciary Committee Vote",10,5,0,0,15
1148028,972527,2020-07-21,Senate,"Senate Floor Vote - Final Passage",39,21,0,0,60
1148068,782402,2019-01-14,Senate,"Senate Rules Committee Vote",18,0,0,1,19
1148068,782509,2019-01-15,Senate,"Senate Floor Vote - Final Passage",61,0,0,2,63
1148068,828829,2019-03-25,Assembly,"Assembly Floor Vote - Final Passage",146,0,0,4,150
1148096,782395,2019-01-14,Senate,"Senate Rules Committee Vote",18,0,0,1,19
1148096,782513,2019-01-15,Senate,"Senate Floor Vote - Final Passage",61,0,0,2,63
1148096,863312,2019-05-13,Assembly,"Assembly Floor Vote - Final Passage",143,0,0,7,150
1148099,883002,2019-06-17,Senate,"Senate Floor Vote - Final Passage",62,0,0,0,62
1148099,883003,2019-06-17,Senate,"Senate Rules Committee Vote",19,0,0,0,19
1148149,819970,2019-03-12,Senate,"Senate Cities Committee Vote",6,1,0,0,7
1148162,782383,2019-01-14,Senate,"Senate Rules Committee Vote",18,0,0,1,19
1148162,782479,2019-01-15,Senate,"Senate Floor Vote - Final Passage",58,3,0,2,63
1148162,809606,2019-02-26,Assembly,"Assembly Floor Vote - Final Passage",113,23,0,14,150
1148179,868646,2019-01-28,Senate,"Senate Mental Health and Developmental Disabilities Committee Vote",7,0,0,0,7
1148179,868647,2019-05-20,Senate,"Senate Floor Vote - Final Passage",40,20,0,2,62
1148184,792993,2019-02-04,Senate,"Senate Civil Service and Pensions Committee Vote",7,0,0,0,7
1148187,782330,2019-01-14,Assembly,"Assembly Rules Committee: Favorable",21,7,0,2,30
1148187,782331,2019-01-14,Assembly,"Assembly Codes Committee: Favorable refer to committee Rules",16,5,0,1,22
1148187,782353,2019-01-14,Assembly,"Assembly Judiciary Committee: Favorable refer to committee Codes",15,6,0,0,21
1148211,784313,2019-01-22,Senate,"Senate Higher Education Committee Vote",7,4,0,0,11
1148211,784685,2019-01-22,Senate,"Senate Higher Education Committee Vote",7,4,0,0,11
1148211,784823,2019-01-23,Senate,"Senate Floor Vote - Final Passage",40,20,0,3,63
1148211,785389,2019-01-23,Assembly,"Assembly Floor Vote - Final Passage",97,42,0,11,150
1148229,798018,2019-02-04,Senate,"Senate Local Government Committee Vote",7,0,0,0,7
1148229,798019,2019-02-12,Senate,"Senate Floor Vote - Final Passage",46,14,0,3,63
1148229,902113,2020-01-13,Senate,"Senate Local Government Committee Vote",5,1,0,1,7
1148229,941041,2020-03-03,Senate,"Senate Floor Vote - Final Passage",46,16,0,0,62
1148237,883043,2019-06-17,Senate,"Senate Floor Vote - Final Passage",62,0,0,0,62
1148237,883044,2019-06-17,Senate,"Senate Rules Committee Vote",19,0,0,0,19
1148302,782409,2019-01-14,Senate,"Senate Rules Committee Vote",18,0,0,1,19
1148302,782507,2019-01-15,Senate,"Senate Floor Vote - Final Passage",61,0,0,2,63
1148302,810576,2019-02-26,Assembly,"Assembly Floor Vote - Final Passage",135,1,0,14,150
1148378,880010,2019-06-11,Senate,"Senate Rules Committee Vote",19,0,0,0,19
1148378,880479,2019-06-11,Senate,"Senate Floor Vote - Final Passage",61,0,0,1,62
1148378,883239,2019-06-17,Assembly,"Assembly Floor Vote - Final Passage",142,5,0,3,150
1148386,782397,2019-01-14,Senate,"Senate Rules Committee Vote",18,0,0,1,19
1148386,782514,2019-01-15,Senate,"Senate Floor Vote - Final Passage",61,0,0,2,63
1148386,868252,2019-05-20,Assembly,"Assembly Floor Vote - Final Passage",142,2,0,6,150
1148395,881402,2019-05-29,Senate,"Senate Investigations And Government Operations Committee Vote",7,0,0,0,7
1148395,881951,2019-06-13,Senate,"Senate Floor Vote - Final Passage",62,0,0,0,62
1148395,884139,2019-06-18,Assembly,"Assembly Floor Vote - Final Passage",144,2,0,4,150
1148413,824460,2019-01-28,Senate,"Senate Commerce, Economic Development And Small Business Committee Vote",9,0,0,0,9
1148413,824461,2019-03-19,Senate,"Senate Floor Vote - Final Passage",42,19,0,1,62
1148431,902746,2019-02-27,Senate,"Senate Health Committee Vote",11,3,0,1,15
1148431,902747,2020-01-14,Senate,"Senate Health Committee Vote",12,2,0,0,14
1148461,782201,2019-01-14,Assembly,"Assembly Ways And Means Committee: Favorable",23,9,0,3,35
1148461,782220,2019-01-14,Assembly,"Assembly Higher Education Committee: Favorable refer to committee Ways and Means",18,7,0,1,26
1148489,863558,2019-05-07,Senate,"Senate Crime Victims, Crime And Correction Committee Vote",6,1,0,0,7
1148489,863559,2019-05-14,Senate,"Senate Floor Vote - Final Passage",59,0,0,3,62
1148489,863560,2019-05-14,Senate,"Senate Rules Committee Vote",18,0,0,1,19
1148489,880362,2019-06-11,Senate,"Senate Floor Vote - Final Passage",61,0,0,1,62
1148512,914158,2020-02-04,Assembly,"Assembly Transportation Committee: Favorable refer to committee Codes",24,0,0,1,25
1148586,839049,2019-04-09,Assembly,"Assembly Rules Committee: Favorable",26,0,0,5,31
1148586,839050,2019-04-09,Assembly,"Assembly Codes Committee: Favorable refer to committee Rules",22,0,0,0,22
1148586,840161,2019-04-09,Assembly,"Assembly Floor Vote - Final Passage",141,5,0,4,150
1148614,782498,2019-01-15,Assembly,"Assembly Education Committee: Favorable",30,0,0,1,31
1148620,784322,2019-01-22,Senate,"Senate Education Committee Vote",15,0,0,0,15
1148620,784724,2019-01-22,Senate,"Senate Education Committee Vote",15,0,0,0,15
1148620,784953,2019-01-23,Senate,"Senate Floor Vote - Final Passage",60,0,0,3,63
1148620,785476,2019-01-23,Assembly,"Assembly Floor Vote - Final Passage",137,6,0,7,150
1148650,787715,2019-01-28,Assembly,"Assembly Judiciary Committee: Favorable",21,0,0,0,21
1148650,792453,2019-02-04,Assembly,"Assembly Floor Vote - Final Passage",142,0,0,8,150
1148650,860212,2019-05-06,Senate,"Senate Floor Vote - Final Passage",61,0,0,1,62
1148663,782398,2019-01-14,Senate,"Senate Rules Committee Vote",18,0,0,1,19
1148663,782610,2019-01-15,Senate,"Senate Floor Vote - Final Passage",61,0,0,2,63
1148663,813445,2019-03-04,Assembly,"Assembly Floor Vote - Final Passage",143,0,0,7,150
1148676,882114,2019-06-13,Senate,"Senate Floor Vote - Final Passage",62,0,0,0,62
1148676,882115,2019-06-13,Senate,"Senate Rules Committee Vote",19,0,0,0,19
1148719,972114,2020-07-17,Assembly,"Assembly Ways And Means Committee: Held for Consideration",22,10,0,2,34
1148743,816679,2019-01-28,Senate,"Senate Commerce, Economic Development and Small Business Committee Vote",9,0,0,0,9
1148743,816680,2019-03-07,Senate,"Senate Floor Vote - Final Passage",58,0,0,5,63
1148743,902730,2020-01-14,Senate,"Senate Commerce, Economic Development and Small Business Committee Vote",9,0,0,0,9
1148743,904819,2020-01-22,Senate,"Senate Floor Vote - Final Passage",61,0,0,1,62
1148748,878698,2019-06-06,Assembly,"Assembly Environmental Conservation Committee: Held for Consideration",20,8,0,2,30
1148774,798959,2019-02-12,Assembly,"Assembly Children And Families Committee: Favorable refer to committee Ways and Means",14,0,0,2,16
1148774,823789,2019-03-18,Assembly,"Assembly Ways And Means Committee: Favorable",31,0,0,4,35
1148794,868935,2019-05-22,Assembly,"Assembly Election Law Committee: Favorable",14,0,0,2,16
1148815,877107,2019-06-04,Assembly,"Assembly Veterans' Affairs Committee: Held for Consideration",10,8,0,1,19
1148843,876041,2019-05-30,Assembly,"Assembly Governmental Operations Committee: Favorable",12,0,0,2,14
1148843,877258,2019-06-03,Assembly,"Assembly Floor Vote - Final Passage",142,0,0,8,150
1148843,882090,2019-06-14,Senate,"Senate Floor Vote - Final Passage",62,0,0,0,62
1148900,972000,2020-07-17,Assembly,"Assembly Codes Committee: Held for Consideration",15,6,0,1,22
1148907,782399,2019-01-14,Senate,"Senate Rules Committee Vote",18,0,0,1,19
1148907,782506,2019-01-15,Senate,"Senate Floor Vote - Final Passage",61,0,0,2,63
1148907,831423,2019-03-27,Assembly,"Assembly Floor Vote - Final Passage",145,2,0,3,150
1148908,874910,2019-05-30,Assembly,"Assembly Judiciary Committee: Favorable refer to committee Codes",16,4,0,1,21
1148935,913983,2020-02-04,Assembly,"Assembly Judiciary Committee: Favorable refer to committee Codes",14,6,0,1,21
1148935,933419,2020-02-25,Assembly,"Assembly Codes Committee: Favorable refer to committee Ways and Means",15,6,0,1,22
1148951,782406,2019-01-14,Senate,"Senate Rules Committee Vote",18,0,0,1,19
1148951,782510,2019-01-15,Senate,"Senate Floor Vote - Final Passage",61,0,0,2,63
1148951,819036,2019-03-11,Assembly,"Assembly Floor Vote - Final Passage",96,43,0,11,150
1148972,829789,2019-03-26,Assembly,"Assembly Correction Committee: Favorable refer to committee Ways and Means",10,3,0,0,13
1148972,883488,2019-06-18,Assembly,"Assembly Rules Committee: Favorable",25,0,0,6,31
1148972,883489,2019-06-18,Assembly,"Assembly Ways And Means Committee: Favorable refer to committee Rules",26,7,0,2,35
1148984,971201,2020-07-14,Assembly,"Assembly Judiciary Committee: Favorable refer to committee Rules",21,0,0,0,21
1148994,857606,2019-04-30,Assembly,"Assembly Consumer Affairs And Protection Committee: Favorable refer to committee Codes",15,1,0,0,16
1148994,860516,2019-05-07,Assembly,"Assembly Codes Committee: Favorable",17,3,0,2,22
1149052,971241,2020-07-14,Assembly,"Assembly Education Committee: Held for Consideration",23,6,0,2,31
1149065,868897,2019-05-21,Assembly,"Assembly Judiciary Committee: Favorable",15,6,0,0,21
1149073,878677,2019-06-06,Assembly,"Assembly Environmental Conservation Committee: Held for Consideration",21,7,0,2,30
1149229,971137,2020-07-14,Assembly,"Assembly Correction Committee: Held for Consideration",10,2,0,1,13
1149275,857510,2019-04-30,Assembly,"Assembly Correction Committee: Favorable refer to committee Ways and Means",9,3,0,1,13
1149275,863738,2019-05-14,Assembly,"Assembly Ways And Means Committee: Favorable",28,4,0,3,35
1149275,867882,2019-05-20,Assembly,"Assembly Floor Vote - Final Passage",135,8,0,7,150
1149275,880147,2019-06-11,Senate,"Senate Floor Vote - Final Passage",61,0,0,1,62
1149333,879154,2019-06-05,Assembly,"Assembly Transportation Committee: Favorable refer to committee Ways and Means",26,0,0,0,26
1149333,880822,2019-06-12,Assembly,"Assembly Ways And Means Committee: Favorable refer to committee Rules",30,0,0,5,35
1149333,881326,2019-06-13,Assembly,"Assembly Rules Committee: Favorable",26,0,0,5,31
1149384,782600,2019-01-14,Senate,"Senate Rules Committee Vote",18,0,0,1,19
1149384,782601,2019-01-15,Senate,"Senate Floor Vote - Final Passage",55,6,0,2,63
1149387,970790,2020-07-13,Assembly,"Assembly Economic Development Committee: Held for Consideration",17,7,0,1,25
1149393,868839,2019-04-09,Senate,"Senate Energy and Telecommunications Committee Vote",6,3,0,0,9
1149393,868840,2019-05-21,Senate,"Senate Floor Vote - Final Passage",46,15,0,1,62
1149395,796661,2019-02-11,Assembly,"Assembly Codes Committee: Favorable",16,6,0,0,22
1149439,782252,2019-01-14,Assembly,"Assembly Rules Committee: Favorable",28,0,0,2,30
1149439,782253,2019-01-14,Assembly,"Assembly Ways And Means Committee: Favorable refer to committee Rules",32,0,0,3,35
1149439,782725,2019-01-15,Assembly,"Assembly Floor Vote - Final Passage",146,1,0,3,150
1149439,785231,2019-01-23,Senate,"Senate Floor Vote - Final Passage",60,0,0,3,63
1149472,820790,2019-03-12,Assembly,"Assembly Election Law Committee: Favorable refer to committee Judiciary",11,4,0,1,16
1149472,838550,2019-04-08,Assembly,"Assembly Judiciary Committee: Favorable",14,6,0,1,21
1149507,971461,2020-07-15,Assembly,"Assembly Labor Committee: Held for Consideration",18,7,0,3,28
1149518,782380,2019-01-14,Senate,"Senate Rules Committee Vote",18,0,0,1,19
1149518,782565,2019-01-15,Senate,"Senate Floor Vote - Final Passage",61,0,0,2,63
1149518,820041,2019-03-11,Assembly,"Assembly Floor Vote - Final Passage",138,1,0,11,150
1149525,876607,2019-06-03,Senate,"Senate Floor Vote - Final Passage",61,1,0,0,62
1149525,877329,2019-06-03,Senate,"Senate Rules Committee Vote",18,1,0,0,19
1149525,880183,2019-06-11,Senate,"Senate Floor Vote - Final Passage",61,0,0,1,62
1149527,879222,2019-06-06,Assembly,"Assembly Environmental Conservation Committee: Held for Consideration",21,7,0,2,30
1149560,971303,2020-07-15,Assembly,"Assembly Small Business Committee: Held for Consideration",10,3,0,3,16
1149562,860680,2019-01-22,Senate,"Senate Crime Victims, Crime and Correction Committee Vote",7,0,0,0,7
1149562,860681,2019-05-06,Senate,"Senate Floor Vote - Final Passage",48,13,0,1,62
1149562,867950,2019-05-20,Assembly,"Assembly Floor Vote - Final Passage",143,0,0,7,150
1149571,971776,2020-07-16,Assembly,"Assembly Governmental Employees Committee: Held for Consideration",9,5,0,0,14
1149579,971237,2020-07-14,Assembly,"Assembly Education Committee: Held for Consideration",23,6,0,2,31
1149581,971095,2020-07-14,Assembly,"Assembly Environmental Conservation Committee: Held for Consideration",19,8,0,1,28
1149590,971099,2020-07-14,Assembly,"Assembly Environmental Conservation Committee: Held for Consideration",19,8,0,1,28
1149618,971742,2020-07-17,Assembly,"Assembly Codes Committee: Held for Consideration",15,6,0,1,22
1149632,787525,2019-01-28,Assembly,"Assembly Correction Committee: Favorable refer to committee Ways and Means",11,0,0,2,13
1149632,864864,2019-05-14,Assembly,"Assembly Ways And Means Committee: Favorable",30,2,0,3,35
1149646,971411,2020-07-16,Assembly,"Assembly Governmental Operations Committee: Held for Consideration",10,4,0,0,14
1149648,787723,2019-01-29,Assembly,"Assembly Health Committee: Favorable refer to committee Codes",15,10,0,1,26
1149648,796653,2019-02-11,Assembly,"Assembly Codes Committee: Favorable",16,6,0,0,22
1149656,878068,2019-06-04,Assembly,"Assembly Labor Committee: Favorable refer to committee Ways and Means",23,5,0,1,29
1149658,787734,2019-01-29,Assembly,"Assembly Health Committee: Favorable refer to committee Ways and Means",19,6,0,1,26
1149661,792559,2019-02-04,Assembly,"Assembly Health Committee: Favorable refer to committee Codes",25,0,0,1,26
1149661,796562,2019-02-11,Assembly,"Assembly Codes Committee: Favorable",22,0,0,0,22
1149661,809863,2019-02-26,Assembly,"Assembly Floor Vote - Final Passage",135,1,0,14,150
1149661,861866,2019-05-08,Senate,"Senate Floor Vote - Final Passage",61,0,0,1,62
1149665,861463,2019-05-07,Assembly,"Assembly Health Committee: Favorable refer to committee Codes",22,0,0,4,26
1149667,864530,2019-05-14,Assembly,"Assembly Health Committee: Favorable refer to committee Ways and Means",24,0,0,2,26
1149674,971246,2020-07-14,Assembly,"Assembly Education Committee: Held for Consideration",23,6,0,2,31
1149681,971488,2020-07-15,Assembly,"Assembly Labor Committee: Held for Consideration",18,7,0,3,28
1149705,874891,2019-05-30,Assembly,"Assembly Insurance Committee: Favorable refer to committee Codes",24,0,0,0,24
1149705,877396,2019-06-04,Assembly,"Assembly Codes Committee: Favorable refer to committee Rules",22,0,0,0,22
1149705,880537,2019-06-11,Assembly,"Assembly Rules Committee: Favorable",25,0,0,6,31
1149705,881382,2019-06-12,Assembly,"Assembly Floor Vote - Final Passage",146,1,0,3,150
1149710,838382,2019-04-08,Assembly,"Assembly Judiciary Committee: Favorable refer to committee Codes",15,5,0,1,21
1149710,859766,2019-05-07,Assembly,"Assembly Codes Committee: Favorable",14,6,0,2,22
1149717,882193,2019-06-13,Assembly,"Assembly Codes Committee: Held for Consideration",14,6,0,2,22
1149721,971929,2020-07-17,Assembly,"Assembly Codes Committee: Held for Consideration",15,6,0,1,22
1149731,832035,2019-03-26,Senate,"Senate Rules Committee Vote",18,1,0,0,19
1149731,832036,2019-03-29,Senate,"Senate Floor Vote - Final Passage",40,20,0,2,62
1149731,903053,2020-01-15,Senate,"Senate Consumer Protection Committee Vote",4,3,0,0,7
1149732,971265,2020-07-14,Assembly,"Assembly Education Committee: Held for Consideration",23,6,0,2,31
1149750,786899,2019-01-28,Assembly,"Assembly Rules Committee: Favorable",29,0,0,2,31
1149750,786900,2019-01-28,Assembly,"Assembly Codes Committee: Favorable refer to committee Rules",22,0,0,0,22
1149750,787841,2019-01-29,Senate,"Senate Floor Vote - Final Passage",62,1,0,0,63
1149750,788338,2019-01-29,Assembly,"Assembly Floor Vote - Final Passage",145,1,0,4,150
1149755,878852,2019-06-06,Assembly,"Assembly Environmental Conservation Committee: Favorable refer to committee Ways and Means",21,7,0,2,30
1149763,870200,2019-05-21,Assembly,"Assembly Transportation Committee: Held for Consideration",18,7,0,0,25
1149764,882211,2019-06-13,Assembly,"Assembly Codes Committee: Held for Consideration",14,6,0,2,22
1149766,971457,2020-07-15,Assembly,"Assembly Labor Committee: Held for Consideration",18,7,0,3,28
1149772,971471,2020-07-15,Assembly,"Assembly Labor Committee: Held for Consideration",18,7,0,3,28
1149774,971652,2020-07-16,Assembly,"Assembly Governmental Operations Committee: Held for Consideration",10,4,0,0,14
1149780,973180,2020-01-28,Senate,"Senate Judiciary Committee Vote",13,2,0,0,15
1149780,973717,2020-07-23,Senate,"Senate Floor Vote - Final Passage",41,19,0,0,60
1149789,971977,2020-07-17,Assembly,"Assembly Ways And Means Committee: Held for Consideration",22,10,0,2,34
1149792,904874,2020-01-22,Assembly,"Assembly Health Committee: Favorable",24,1,0,1,26
1149794,787744,2019-01-29,Assembly,"Assembly Health Committee: Favorable refer to committee Ways and Means",25,0,0,1,26
1149794,882711,2019-06-17,Assembly,"Assembly Ways And Means Committee: Favorable refer to committee Rules",33,0,0,2,35
1149794,885264,2019-06-20,Assembly,"Assembly Rules Committee: Favorable",27,0,0,4,31
1149810,787549,2019-01-28,Senate,"Senate Rules Committee Vote",19,0,0,0,19
1149810,787550,2019-01-29,Senate,"Senate Codes Committee Vote",12,1,0,0,13
1149810,864222,2019-05-15,Senate,"Senate Floor Vote - Final Passage",53,5,0,4,62
1149810,867883,2019-05-20,Assembly,"Assembly Floor Vote - Final Passage",122,22,0,6,150
1149821,788225,2019-01-29,Assembly,"Assembly Health Committee: Favorable",25,0,0,1,26
1149821,792460,2019-02-04,Assembly,"Assembly Floor Vote - Final Passage",142,1,0,7,150
1149825,787720,2019-01-28,Assembly,"Assembly Judiciary Committee: Favorable",21,0,0,0,21
1149825,793993,2019-02-05,Assembly,"Assembly Floor Vote - Final Passage",145,0,0,5,150
1149825,864751,2019-05-15,Senate,"Senate Floor Vote - Final Passage",58,0,0,4,62
1149832,787730,2019-01-29,Assembly,"Assembly Health Committee: Favorable refer to committee Ways and Means",25,0,0,1,26
1149845,838355,2019-04-08,Assembly,"Assembly Judiciary Committee: Favorable refer to committee Codes",15,5,0,1,21
1149845,856999,2019-04-30,Assembly,"Assembly Codes Committee: Favorable",14,6,0,2,22
1149866,971783,2020-07-16,Assembly,"Assembly Governmental Employees Committee: Held for Consideration",9,5,0,0,14
1149872,970941,2020-07-13,Assembly,"Assembly Consumer Affairs And Protection Committee: Held for Consideration",12,3,0,1,16
1149882,787975,2019-01-29,Assembly,"Assembly Health Committee: Favorable refer to committee Codes",25,0,0,1,26
1149882,797637,2019-02-11,Assembly,"Assembly Codes Committee: Favorable refer to committee Ways and Means",22,0,0,0,22
1149882,880836,2019-06-12,Assembly,"Assembly Ways And Means Committee: Favorable refer to committee Rules",30,0,0,5,35
1149882,881372,2019-06-13,Assembly,"Assembly Rules Committee: Favorable",26,0,0,5,31
1149882,883380,2019-06-17,Assembly,"Assembly Floor Vote - Final Passage",144,1,0,5,150
1149882,885457,2019-06-18,Senate,"Senate Floor Vote - Final Passage",59,3,0,0,62
1149889,788311,2019-01-29,Assembly,"Assembly Health Committee: Favorable refer to committee Codes",20,5,0,1,26
1149889,814436,2019-03-05,Assembly,"Assembly Codes Committee: Favorable",16,6,0,0,22
1149892,787727,2019-01-28,Assembly,"Assembly Judiciary Committee: Favorable",21,0,0,0,21
1149892,797586,2019-02-11,Assembly,"Assembly Floor Vote - Final Passage",143,0,0,7,150
1149892,823936,2019-03-18,Senate,"Senate Floor Vote - Final Passage",62,0,0,0,62
1149903,881904,2019-06-12,Senate,"Senate Floor Vote - Final Passage",58,4,0,0,62
1149903,881905,2019-06-12,Senate,"Senate Rules Committee Vote",19,0,0,0,19
1149903,884128,2019-06-18,Assembly,"Assembly Floor Vote - Final Passage",145,1,0,4,150
1149914,857557,2019-04-30,Assembly,"Assembly Agriculture Committee: Favorable refer to committee Codes",15,6,0,0,21
1149918,861474,2019-05-07,Assembly,"Assembly Health Committee: Favorable refer to committee Ways and Means",22,0,0,4,26
1149921,787711,2019-01-29,Assembly,"Assembly Health Committee: Favorable",25,0,0,1,26
1149921,811782,2019-02-28,Assembly,"Assembly Floor Vote - Final Passage",137,1,0,12,150
1149921,823775,2019-03-18,Senate,"Senate Floor Vote - Final Passage",62,0,0,0,62
1149929,860708,2019-05-07,Assembly,"Assembly Alcoholism And Drug Abuse Committee: Favorable refer to committee Ways and Means",14,0,0,0,14
1149931,861476,2019-05-07,Assembly,"Assembly Health Committee: Favorable refer to committee Ways and Means",22,0,0,4,26
1149931,877150,2019-06-04,Assembly,"Assembly Ways And Means Committee: Favorable refer to committee Rules",32,1,0,2,35
1149931,880241,2019-06-11,Assembly,"Assembly Rules Committee: Favorable",25,0,0,6,31
1149931,881126,2019-06-12,Assembly,"Assembly Floor Vote - Final Passage",146,1,0,3,150
1149935,970764,2020-07-13,Assembly,"Assembly Health Committee: Held for Consideration",18,6,0,2,26
1149946,787702,2019-01-29,Assembly,"Assembly Health Committee: Favorable",25,0,0,1,26
1149946,792447,2019-02-04,Assembly,"Assembly Floor Vote - Final Passage",143,0,0,7,150
1149946,811725,2019-02-28,Senate,"Senate Floor Vote - Final Passage",62,0,0,1,63
1149955,878190,2019-06-05,Assembly,"Assembly Health Committee: Favorable refer to committee Codes",25,0,0,1,26
1149963,971616,2020-07-16,Assembly,"Assembly Governmental Operations Committee: Held for Consideration",10,4,0,0,14
1149972,971672,2020-07-16,Assembly,"Assembly Governmental Operations Committee: Held for Consideration",10,4,0,0,14
1149976,970812,2020-07-13,Assembly,"Assembly Health Committee: Held for Consideration",18,6,0,2,26
1149980,884427,2019-03-04,Senate,"Senate Codes Committee Vote",9,4,0,0,13
1149980,886554,2019-06-19,Senate,"Senate Floor Vote - Final Passage",59,3,0,0,62
1149980,902005,2020-01-13,Senate,"Senate Codes Committee Vote",12,1,0,0,13
1149982,972082,2020-07-17,Assembly,"Assembly Codes Committee: Held for Consideration",15,6,0,1,22
1149989,811147,2019-02-27,Assembly,"Assembly Real Property Taxation Committee: Favorable refer to committee Ways and Means",9,0,0,1,10
1149989,864850,2019-05-14,Assembly,"Assembly Ways And Means Committee: Favorable",32,0,0,3,35
1149989,867899,2019-05-20,Assembly,"Assembly Floor Vote - Final Passage",141,2,0,7,150
1149989,874905,2019-05-30,Senate,"Senate Floor Vote - Final Passage",55,3,0,4,62
1150011,971622,2020-07-16,Assembly,"Assembly Governmental Operations Committee: Held for Consideration",10,4,0,0,14
1150017,787710,2019-01-28,Assembly,"Assembly Judiciary Committee: Favorable",21,0,0,0,21
1150017,793535,2019-02-05,Assembly,"Assembly Floor Vote - Final Passage",145,0,0,5,150
1150017,810759,2019-02-27,Senate,"Senate Floor Vote - Final Passage",62,0,0,1,63
1150026,787691,2019-01-29,Assembly,"Assembly Health Committee: Favorable refer to committee Ways and Means",25,0,0,1,26
1150045,792561,2019-02-04,Assembly,"Assembly Health Committee: Favorable",18,7,0,1,26
1150046,797568,2019-02-12,Assembly,"Assembly Transportation Committee: Favorable refer to committee Codes",20,3,0,2,25
1150046,813635,2019-03-05,Assembly,"Assembly Codes Committee: Favorable refer to committee Ways and Means",16,6,0,0,22
1150046,823324,2019-03-18,Assembly,"Assembly Rules Committee: Favorable",20,4,0,7,31
1150046,823325,2019-03-18,Assembly,"Assembly Ways And Means Committee: Favorable refer to committee Rules",22,9,0,4,35
1150046,824648,2019-03-19,Senate,"Senate Floor Vote - Final Passage",46,15,0,1,62
1150046,825687,2019-03-19,Assembly,"Assembly Floor Vote - Final Passage",105,42,0,3,150
1150051,920084,2020-02-11,Assembly,"Assembly Higher Education Committee: Favorable refer to committee Ways and Means",23,0,0,1,24
1150052,787701,2019-01-29,Assembly,"Assembly Health Committee: Favorable",17,8,0,1,26
1150052,832034,2019-03-28,Assembly,"Assembly Floor Vote - Final Passage",94,48,0,8,150
1150104,876056,2019-05-30,Assembly,"Assembly Social Services Committee: Held for Consideration",11,5,0,2,18
1150107,800034,2019-02-12,Assembly,"Assembly Labor Committee: Favorable refer to committee Codes",20,5,0,4,29
1150107,814084,2019-03-05,Assembly,"Assembly Codes Committee: Favorable",18,4,0,0,22
1150117,787703,2019-01-29,Assembly,"Assembly Health Committee: Favorable refer to committee Codes",25,0,0,1,26
1150117,796825,2019-02-11,Assembly,"Assembly Codes Committee: Favorable",21,1,0,0,22
1150117,857458,2019-05-01,Assembly,"Assembly Floor Vote - Final Passage",129,10,0,11,150
1150154,861455,2019-05-07,Assembly,"Assembly Health Committee: Favorable refer to committee Codes",22,0,0,4,26
1150154,868615,2019-05-21,Assembly,"Assembly Codes Committee: Favorable",20,1,0,1,22
1150162,920186,2020-02-11,Assembly,"Assembly Higher Education Committee: Favorable refer to committee Ways and Means",23,0,0,1,24
1150164,784975,2019-01-23,Assembly,"Assembly Alcoholism And Drug Abuse Committee: Favorable refer to committee Ways and Means",13,0,0,1,14
1150164,857192,2019-04-30,Assembly,"Assembly Ways And Means Committee: Favorable",33,0,0,2,35
1150164,859664,2019-05-06,Assembly,"Assembly Floor Vote - Final Passage",141,0,0,9,150
1150164,875314,2019-05-30,Senate,"Senate Floor Vote - Final Passage",58,0,0,4,62
1150203,824493,2019-03-19,Senate,"Senate Aging Committee Vote",7,0,0,0,7
1150212,870272,2019-05-21,Assembly,"Assembly Insurance Committee: Favorable",23,0,0,1,24
1150212,874699,2019-05-29,Assembly,"Assembly Floor Vote - Final Passage",141,0,0,9,150
1150215,870084,2019-05-21,Assembly,"Assembly Governmental Operations Committee: Favorable refer to committee Ways and Means",14,0,0,0,14
1150215,879358,2019-06-06,Assembly,"Assembly Ways And Means Committee: Favorable refer to committee Rules",31,0,0,4,35
1150215,882529,2019-06-17,Assembly,"Assembly Rules Committee: Favorable",26,0,0,5,31
1150215,883932,2019-06-18,Senate,"Senate Floor Vote - Final Passage",62,0,0,0,62
1150215,884463,2019-06-18,Assembly,"Assembly Floor Vote - Final Passage",145,1,0,4,150
1150227,933502,2020-02-25,Assembly,"Assembly Labor Committee: Favorable",25,3,0,1,29
1150234,971387,2020-07-16,Assembly,"Assembly Governmental Operations Committee: Held for Consideration",10,4,0,0,14
1150237,814518,2019-03-05,Assembly,"Assembly Judiciary Committee: Favorable refer to committee Codes",19,0,0,2,21
1150237,840823,2019-04-09,Assembly,"Assembly Codes Committee: Favorable",20,2,0,0,22
1150247,860699,2019-05-07,Assembly,"Assembly Higher Education Committee: Favorable refer to committee Codes",23,0,0,3,26
1150247,868501,2019-05-21,Assembly,"Assembly Codes Committee: Favorable",21,0,0,1,22
1150247,874796,2019-05-29,Assembly,"Assembly Floor Vote - Final Passage",141,0,0,9,150
1150255,838335,2019-04-08,Assembly,"Assembly Judiciary Committee: Favorable refer to committee Codes",14,6,0,1,21
1150255,856994,2019-04-30,Assembly,"Assembly Codes Committee: Favorable",15,5,0,2,22
1150263,971087,2020-07-14,Assembly,"Assembly Higher Education Committee: Favorable refer to committee Codes",22,3,0,0,25
1150263,971887,2020-07-17,Assembly,"Assembly Ways And Means Committee: Favorable refer to committee Rules",29,3,0,2,34
1150263,971888,2020-07-17,Assembly,"Assembly Codes Committee: Favorable refer to committee Ways and Means",19,2,0,1,22
1150263,972234,2020-07-20,Assembly,"Assembly Rules Committee: Favorable",27,0,0,3,30
1150263,972768,2020-07-21,Assembly,"Assembly Floor Vote - Final Passage",126,16,0,3,145
1150266,857538,2019-04-30,Assembly,"Assembly Health Committee: Favorable",25,0,0,1,26
1150266,859640,2019-05-06,Assembly,"Assembly Floor Vote - Final Passage",141,0,0,9,150
1150266,882961,2019-06-17,Senate,"Senate Floor Vote - Final Passage",61,1,0,0,62
1150269,809826,2019-02-27,Assembly,"Assembly Judiciary Committee: Favorable refer to committee Codes",14,7,0,0,21
1150273,792543,2019-02-04,Assembly,"Assembly Health Committee: Favorable",25,0,0,1,26
1150273,798417,2019-02-12,Assembly,"Assembly Floor Vote - Final Passage",139,0,0,11,150
1150273,869621,2019-05-21,Senate,"Senate Floor Vote - Final Passage",61,0,0,1,62
1150274,971983,2020-07-17,Assembly,"Assembly Ways And Means Committee: Held for Consideration",22,10,0,2,34
1150290,876043,2019-05-30,Assembly,"Assembly Governmental Operations Committee: Favorable refer to committee Codes",12,0,0,2,14
1150290,881411,2019-06-13,Assembly,"Assembly Codes Committee: Favorable refer to committee Rules",20,0,0,2,22
1150290,882505,2019-06-17,Assembly,"Assembly Rules Committee: Favorable",26,0,0,5,31
1150294,825318,2019-03-19,Assembly,"Assembly Governmental Operations Committee: Favorable refer to committee Ways and Means",13,0,0,1,14
1150294,864861,2019-05-14,Assembly,"Assembly Ways And Means Committee: Favorable",30,2,0,3,35
1150294,874947,2019-05-29,Assembly,"Assembly Floor Vote - Final Passage",139,1,0,10,150
1150295,816242,2019-03-06,Assembly,"Assembly Health Committee: Favorable refer to committee Codes",20,5,0,1,26
1150295,878328,2019-06-04,Assembly,"Assembly Codes Committee: Favorable refer to committee Rules",15,7,0,0,22
1150295,881348,2019-06-13,Assembly,"Assembly Rules Committee: Favorable",24,2,0,5,31
1150302,883121,2019-06-17,Assembly,"Assembly Election Law Committee: Favorable refer to committee Rules",16,0,0,0,16
1150302,883531,2019-06-18,Assembly,"Assembly Rules Committee: Favorable",24,1,0,6,31
1150307,860747,2019-05-07,Assembly,"Assembly Higher Education Committee: Favorable refer to committee Codes",21,2,0,3,26
1150307,868437,2019-05-21,Assembly,"Assembly Codes Committee: Favorable",15,6,0,1,22
1150311,816477,2019-03-06,Assembly,"Assembly Health Committee: Favorable refer to committee Codes",17,8,0,1,26
1150311,819290,2019-03-12,Assembly,"Assembly Codes Committee: Favorable",15,6,0,1,22
1150317,971468,2020-07-15,Assembly,"Assembly Labor Committee: Held for Consideration",18,7,0,3,28
1150325,972013,2020-07-17,Assembly,"Assembly Ways And Means Committee: Held for Consideration",22,10,0,2,34
1150326,825363,2019-03-19,Assembly,"Assembly Governmental Employees Committee: Favorable refer to committee Codes",14,0,0,0,14
1150326,839004,2019-04-09,Assembly,"Assembly Codes Committee: Favorable",22,0,0,0,22
1150500,809329,2019-02-26,Assembly,"Assembly Social Services Committee: Favorable refer to committee Ways and Means",15,0,0,3,18
1150500,857048,2019-04-30,Assembly,"Assembly Ways And Means Committee: Favorable",33,0,0,2,35
1150500,859646,2019-05-06,Assembly,"Assembly Floor Vote - Final Passage",142,0,0,8,150
1150500,877086,2019-06-03,Senate,"Senate Floor Vote - Final Passage",62,0,0,0,62
1150512,874629,2019-05-29,Assembly,"Assembly Environmental Conservation Committee: Favorable refer to committee Codes",21,8,0,1,30
1150512,877436,2019-06-04,Assembly,"Assembly Codes Committee: Favorable refer to committee Rules",15,7,0,0,22
1150512,881333,2019-06-13,Assembly,"Assembly Rules Committee: Favorable",18,8,0,5,31
1150525,877194,2019-06-04,Assembly,"Assembly Housing Committee: Favorable refer to committee Rules",26,0,0,2,28
1150525,881349,2019-06-13,Assembly,"Assembly Rules Committee: Favorable",26,0,0,5,31
1150550,875137,2019-05-30,Assembly,"Assembly Consumer Affairs And Protection Committee: Favorable refer to committee Codes",15,0,0,1,16
1150550,877372,2019-06-04,Assembly,"Assembly Codes Committee: Favorable refer to committee Rules",18,4,0,0,22
1150550,880491,2019-06-11,Assembly,"Assembly Rules Committee: Favorable",25,0,0,6,31
1150697,874803,2019-05-30,Assembly,"Assembly Judiciary Committee: Favorable refer to committee Codes",14,6,0,1,21
1150697,880245,2019-06-11,Assembly,"Assembly Codes Committee: Favorable refer to committee Rules",18,4,0,0,22
1150697,940719,2020-03-03,Assembly,"Assembly Codes Committee: Favorable",15,6,0,1,22
1150783,874655,2019-05-29,Assembly,"Assembly Housing Committee: Favorable",19,8,0,1,28
1150846,857543,2019-04-30,Assembly,"Assembly Agriculture Committee: Favorable refer to committee Codes",14,7,0,0,21
1150846,874737,2019-05-30,Assembly,"Assembly Codes Committee: Favorable",18,1,0,3,22
1150956,877903,2019-06-05,Assembly,"Assembly Election Law Committee: Favorable refer to committee Rules",15,0,0,1,16
1150956,880538,2019-06-11,Assembly,"Assembly Rules Committee: Favorable",25,0,0,6,31
1150956,881176,2019-06-12,Assembly,"Assembly Floor Vote - Final Passage",143,4,0,3,150
1150956,881825,2019-06-13,Senate,"Senate Floor Vote - Final Passage",40,22,0,0,62
1150997,822317,2019-03-14,Assembly,"Assembly Transportation Committee: Favorable refer to committee Ways and Means",17,5,0,3,25
1151109,902585,2020-01-14,Assembly,"Assembly Rules Committee: Favorable",25,0,0,5,30
1151109,902586,2020-01-14,Assembly,"Assembly Transportation Committee: Favorable refer to committee Rules",24,0,0,1,25
1151109,902794,2020-01-14,Senate,"Senate Floor Vote - Final Passage",60,0,0,2,62
1151109,902942,2020-01-14,Assembly,"Assembly Floor Vote - Final Passage",140,0,0,8,148
1151334,799945,2019-02-12,Assembly,"Assembly Labor Committee: Favorable",17,8,0,4,29
1151334,935212,2020-02-25,Assembly,"Assembly Floor Vote - Final Passage",92,46,0,9,147
1152202,784318,2019-01-22,Senate,"Senate Local Government Committee Vote",7,0,0,0,7
1152202,784661,2019-01-22,Senate,"Senate Local Government Committee Vote",7,0,0,0,7
1152202,784862,2019-01-23,Senate,"Senate Floor Vote - Final Passage",60,0,0,3,63
1152218,787733,2019-01-28,Assembly,"Assembly Judiciary Committee: Favorable",21,0,0,0,21
1152220,971213,2020-07-14,Assembly,"Assembly Judiciary Committee: Held for Consideration",15,6,0,0,21
1152223,810647,2019-02-27,Assembly,"Assembly Real Property Taxation Committee: Favorable refer to committee Ways and Means",9,0,0,1,10
1152223,879263,2019-06-06,Assembly,"Assembly Ways And Means Committee: Favorable refer to committee Rules",29,2,0,4,35
1152223,884945,2019-06-19,Assembly,"Assembly Rules Committee: Favorable",27,0,0,4,31
1152223,886456,2019-06-21,Assembly,"Assembly Floor Vote - Final Passage",144,0,0,6,150
1152244,828902,2019-03-19,Senate,"Senate Education Committee Vote",14,1,0,0,15
1152244,828903,2019-03-26,Senate,"Senate Floor Vote - Final Passage",61,0,0,1,62
1152244,877537,2019-06-03,Assembly,"Assembly Floor Vote - Final Passage",142,0,0,8,150
1152245,972097,2020-07-17,Assembly,"Assembly Ways And Means Committee: Held for Consideration",22,10,0,2,34
1152252,921012,2019-05-29,Senate,"Senate Investigations and Government Operations Committee Vote",7,0,0,0,7
1152252,921013,2020-02-11,Senate,"Senate Investigations and Government Operations Committee Vote",7,0,0,0,7
1152252,935743,2020-02-25,Senate,"Senate Finance Committee Vote",19,3,0,1,23
1152264,878727,2019-06-06,Assembly,"Assembly Environmental Conservation Committee: Favorable refer to committee Rules",21,7,0,2,30
1152280,971452,2020-07-16,Assembly,"Assembly Real Property Taxation Committee: Held for Consideration",8,2,0,0,10
1152284,811111,2019-02-28,Assembly,"Assembly Correction Committee: Favorable",9,3,0,1,13
1152284,881677,2019-06-13,Assembly,"Assembly Floor Vote - Final Passage",95,44,0,11,150
1152289,869462,2019-05-22,Assembly,"Assembly Election Law Committee: Favorable",14,0,0,2,16
1152289,874752,2019-05-29,Assembly,"Assembly Floor Vote - Final Passage",141,0,0,9,150
1152289,880170,2019-06-11,Senate,"Senate Floor Vote - Final Passage",61,0,0,1,62
1152302,863976,2019-05-14,Senate,"Senate Elections Committee Vote",6,0,0,1,7
1152302,876599,2019-06-03,Senate,"Senate Floor Vote - Final Passage",41,21,0,0,62
1152302,879545,2019-06-03,Senate,"Senate Rules Committee Vote",14,5,0,0,19
1152317,881005,2019-05-29,Senate,"Senate Civil Service and Pensions Committee Vote",7,0,0,0,7
1152317,882110,2019-06-12,Senate,"Senate Floor Vote - Final Passage",62,0,0,0,62
1152317,886637,2019-06-21,Assembly,"Assembly Floor Vote - Final Passage",143,1,0,6,150
1152319,971484,2020-07-15,Assembly,"Assembly Labor Committee: Held for Consideration",18,7,0,3,28
1152321,885330,2019-06-18,Senate,"Senate Floor Vote - Final Passage",51,11,0,0,62
1152321,886579,2019-06-18,Senate,"Senate Rules Committee Vote",19,0,0,0,19
1152342,880898,2019-05-30,Senate,"Senate Cities Committee Vote",7,0,0,0,7
1152342,881660,2019-06-13,Assembly,"Assembly Floor Vote - Final Passage",144,1,0,5,150
1152342,882088,2019-06-12,Senate,"Senate Floor Vote - Final Passage",62,0,0,0,62
1152355,881925,2019-06-12,Senate,"Senate Floor Vote - Final Passage",55,7,0,0,62
1152355,881926,2019-06-12,Senate,"Senate Rules Committee Vote",18,1,0,0,19
1152355,935421,2020-02-25,Senate,"Senate Finance Committee Vote",20,2,0,1,23
1152369,856119,2019-04-09,Senate,"Senate Labor Committee Vote",11,2,0,0,13
1152369,856120,2019-05-01,Senate,"Senate Floor Vote - Final Passage",42,20,0,0,62
1152369,886200,2019-06-20,Assembly,"Assembly Floor Vote - Final Passage",111,35,0,4,150
1152375,811156,2019-02-27,Assembly,"Assembly Mental Health Committee: Favorable refer to committee Codes",13,0,0,0,13
1152375,839351,2019-04-09,Assembly,"Assembly Codes Committee: Favorable",22,0,0,0,22
1152375,877880,2019-06-04,Assembly,"Assembly Floor Vote - Final Passage",146,0,0,4,150
1152375,882023,2019-06-12,Senate,"Senate Floor Vote - Final Passage",62,0,0,0,62
1152376,876533,2019-05-07,Senate,"Senate Health Committee Vote",15,0,0,0,15
1152376,876728,2019-06-03,Senate,"Senate Floor Vote - Final Passage",46,16,0,0,62
1152376,877427,2019-06-03,Assembly,"Assembly Floor Vote - Final Passage",114,28,0,8,150
1152392,868893,2019-05-21,Assembly,"Assembly Economic Development Committee: Favorable refer to committee Ways and Means",24,0,0,2,26
1152394,881991,2019-06-12,Senate,"Senate Floor Vote - Final Passage",62,0,0,0,62
1152394,881992,2019-06-12,Senate,"Senate Rules Committee Vote",19,0,0,0,19
1152414,855597,2019-04-30,Senate,"Senate Energy and Telecommunications Committee Vote",9,0,0,0,9
1152417,810919,2019-01-22,Senate,"Senate Transportation Committee Vote",15,0,0,0,15
1152417,811247,2019-02-28,Senate,"Senate Floor Vote - Final Passage",62,0,0,1,63
1152417,915502,2020-02-04,Senate,"Senate Transportation Committee Vote",15,0,0,0,15
1152417,941481,2020-03-03,Senate,"Senate Floor Vote - Final Passage",62,0,0,0,62
1152422,811274,2019-02-27,Assembly,"Assembly Judiciary Committee: Favorable refer to committee Codes",15,6,0,0,21
1152422,881111,2019-06-11,Assembly,"Assembly Codes Committee: Favorable refer to committee Rules",16,6,0,0,22
1152428,870185,2019-05-21,Assembly,"Assembly Transportation Committee: Held for Consideration",18,7,0,0,25
1152440,839371,2019-04-09,Senate,"Senate Health Committee Vote",15,0,0,0,15
1152440,863965,2019-05-14,Senate,"Senate Finance Committee Vote",22,0,0,1,23
1152440,881835,2019-06-13,Senate,"Senate Floor Vote - Final Passage",62,0,0,0,62
1152440,904463,2020-01-22,Senate,"Senate Health Committee Vote",15,0,0,0,15
1152440,942080,2020-03-02,Senate,"Senate Floor Vote - Final Passage",61,0,0,1,62
1152444,972142,2019-04-09,Senate,"Senate Health Committee Vote",14,0,0,1,15
1152444,973036,2020-07-20,Senate,"Senate Health Committee Vote",14,0,0,1,15
1152444,973218,2020-07-22,Senate,"Senate Rules Committee Vote",18,1,0,0,19
1152444,973624,2020-07-23,Senate,"Senate Floor Vote - Final Passage",59,1,0,0,60
1152447,840829,2019-04-09,Assembly,"Assembly Transportation Committee: Held for Consideration",16,7,0,2,25
1152462,971343,2020-07-15,Assembly,"Assembly Labor Committee: Held for Consideration",18,7,0,3,28
1152466,868682,2019-05-21,Assembly,"Assembly Governmental Operations Committee: Favorable refer to committee Codes",13,1,0,0,14
1152466,874922,2019-05-30,Assembly,"Assembly Codes Committee: Favorable",15,4,0,3,22
1152491,881673,2019-06-12,Senate,"Senate Floor Vote - Final Passage",62,0,0,0,62
1152491,881674,2019-06-12,Senate,"Senate Rules Committee Vote",18,1,0,0,19
1152492,839718,2019-04-09,Assembly,"Assembly Codes Committee: Favorable",20,2,0,0,22
1152492,857388,2019-04-29,Assembly,"Assembly Floor Vote - Final Passage",127,18,0,5,150
1152493,787310,2019-01-28,Senate,"Senate Mental Health and Developmental Disabilities Committee Vote",7,0,0,0,7
1152493,839477,2019-04-09,Senate,"Senate Finance Committee Vote",23,0,0,0,23
1152493,874606,2019-05-29,Senate,"Senate Floor Vote - Final Passage",60,0,0,2,62
1152493,950159,2020-03-11,Senate,"Senate Mental Health and Developmental Disabilities Committee Vote",7,0,0,0,7
1152493,972466,2020-07-21,Senate,"Senate Floor Vote - Final Passage",60,0,0,0,60
1152503,855556,2019-04-30,Senate,"Senate Transportation Committee Vote",15,0,0,0,15
1152505,919826,2020-02-11,Assembly,"Assembly Consumer Affairs And Protection Committee: Favorable refer to committee Codes",12,4,0,0,16
1152505,934263,2020-02-25,Assembly,"Assembly Codes Committee: Favorable",15,6,0,1,22
1152522,787328,2019-01-28,Senate,"Senate Veterans, Homeland Security and Military Affairs Committee Vote",9,0,0,0,9
1152522,887100,2019-06-19,Senate,"Senate Floor Vote - Final Passage",62,0,0,0,62
1152522,887101,2019-06-19,Senate,"Senate Rules Committee Vote",19,0,0,0,19
1152523,878987,2019-06-06,Assembly,"Assembly Corporations, Authorities And Commissions Committee: Favorable refer to committee Ways and Means",25,0,0,1,26
1152523,882662,2019-06-17,Assembly,"Assembly Rules Committee: Favorable",25,0,0,6,31
1152523,882663,2019-06-17,Assembly,"Assembly Ways And Means Committee: Favorable refer to committee Rules",32,1,0,2,35
1152526,884421,2019-06-18,Senate,"Senate Rules Committee Vote",19,0,0,0,19
1152526,885490,2019-06-18,Senate,"Senate Floor Vote - Final Passage",62,0,0,0,62
1152533,864240,2019-02-12,Senate,"Senate Transportation Committee Vote",14,1,0,0,15
1152533,864241,2019-05-15,Senate,"Senate Floor Vote - Final Passage",40,18,0,4,62
1152533,935336,2020-02-25,Senate,"Senate Transportation Committee Vote",10,5,0,0,15
1152533,941510,2020-03-03,Senate,"Senate Floor Vote - Final Passage",41,21,0,0,62
1152544,859374,2019-04-08,Senate,"Senate Local Government Committee Vote",7,0,0,0,7
1152544,859375,2019-05-06,Senate,"Senate Floor Vote - Final Passage",58,3,0,1,62
1152544,867911,2019-05-20,Assembly,"Assembly Floor Vote - Final Passage",143,0,0,7,150
1152558,863982,2019-05-14,Senate,"Senate Education Committee Vote",15,0,0,0,15
1152566,840824,2019-03-12,Senate,"Senate Investigations And Government Operations Committee Vote",7,0,0,0,7
1152566,840825,2019-04-10,Senate,"Senate Floor Vote - Final Passage",47,12,0,3,62
1152566,902724,2020-01-14,Senate,"Senate Investigations and Government Operations Committee Vote",6,1,0,0,7
1152566,904679,2020-01-22,Senate,"Senate Finance Committee Vote",22,1,0,0,23
1152596,919863,2020-02-11,Senate,"Senate Housing, Construction and Community Development Committee Vote",11,0,0,0,11
1152596,919864,2020-02-11,Senate,"Senate Rules Committee Vote",19,0,0,0,19
1152596,922135,2020-02-12,Senate,"Senate Floor Vote - Final Passage",56,4,0,2,62
1152596,973203,2020-07-22,Assembly,"Assembly Floor Vote - Final Passage",113,29,0,3,145
1152606,972682,2020-07-21,Senate,"Senate Banks Committee Vote",10,1,0,0,11
1152606,973972,2020-07-22,Senate,"Senate Floor Vote - Final Passage",53,7,0,0,60
1152606,973973,2020-07-22,Senate,"Senate Rules Committee Vote",17,2,0,0,19
1152608,791878,2019-01-21,Senate,"Senate Insurance Committee Vote",11,0,0,0,11
1152608,791879,2019-02-04,Senate,"Senate Floor Vote - Final Passage",59,3,0,1,63
1152608,884142,2019-06-18,Assembly,"Assembly Floor Vote - Final Passage",147,1,0,2,150
1152619,934475,2020-02-25,Assembly,"Assembly Environmental Conservation Committee: Favorable refer to committee Codes",20,7,0,2,29
1152619,940709,2020-03-03,Assembly,"Assembly Codes Committee: Favorable",15,6,0,1,22
1152638,879012,2019-06-06,Assembly,"Assembly Corporations, Authorities And Commissions Committee: Favorable refer to committee Codes",19,6,0,1,26
1152638,880220,2019-06-11,Assembly,"Assembly Codes Committee: Favorable refer to committee Rules",20,2,0,0,22
1152638,881334,2019-06-13,Assembly,"Assembly Rules Committee: Favorable",26,0,0,5,31
1152638,885197,2019-06-19,Assembly,"Assembly Floor Vote - Final Passage",126,23,0,1,150
1152648,971483,2020-07-16,Assembly,"Assembly Transportation Committee: Held for Consideration",16,6,0,2,24
1152650,875402,2019-05-30,Senate,"Senate Floor Vote - Final Passage",56,2,0,4,62
1152650,875403,2019-05-30,Senate,"Senate Rules Committee Vote",17,1,0,1,19
1152660,971393,2020-07-16,Assembly,"Assembly Governmental Operations Committee: Favorable refer to committee Rules",14,0,0,0,14
1152679,972103,2020-07-17,Assembly,"Assembly Ways And Means Committee: Held for Consideration",22,10,0,2,34
1152698,875218,2019-05-30,Senate,"Senate Floor Vote - Final Passage",58,0,0,4,62
1152698,875219,2019-05-30,Senate,"Senate Rules Committee Vote",18,0,0,1,19
1152700,829730,2019-03-26,Senate,"Senate Energy and Telecommunications Committee Vote",6,3,0,0,9
1152707,829830,2019-03-12,Senate,"Senate Health Committee Vote",15,0,0,0,15
1152707,829831,2019-03-27,Senate,"Senate Floor Vote - Final Passage",61,0,0,1,62
1152707,908869,2020-01-28,Senate,"Senate Health Committee Vote",15,0,0,0,15
1152707,949172,2020-03-11,Senate,"Senate Floor Vote - Final Passage",58,0,0,4,62
1152722,971658,2020-07-16,Assembly,"Assembly Governmental Operations Committee: Held for Consideration",10,4,0,0,14
1152733,874701,2019-04-09,Senate,"Senate Finance Committee Vote",23,0,0,0,23
1152733,874702,2019-05-29,Senate,"Senate Floor Vote - Final Passage",52,8,0,2,62
1152733,874703,2019-05-29,Assembly,"Assembly Floor Vote - Final Passage",140,0,0,10,150
1152746,809768,2019-02-27,Assembly,"Assembly Agriculture Committee: Favorable refer to committee Codes",15,5,0,1,21
1152746,875174,2019-05-30,Assembly,"Assembly Codes Committee: Favorable",14,5,0,3,22
1152746,883348,2019-06-17,Assembly,"Assembly Floor Vote - Final Passage",104,41,0,5,150
1152753,882216,2019-06-13,Assembly,"Assembly Codes Committee: Held for Consideration",14,6,0,2,22
1152772,882715,2019-06-17,Assembly,"Assembly Judiciary Committee: Favorable refer to committee Rules",12,6,0,3,21
1152772,884842,2019-06-19,Assembly,"Assembly Rules Committee: Favorable",27,0,0,4,31
1152772,972403,2020-07-20,Assembly,"Assembly Floor Vote - Final Passage",104,37,0,4,145
1152783,857382,2019-04-30,Assembly,"Assembly Codes Committee: Favorable",14,6,0,2,22
1152793,874113,2019-05-13,Senate,"Senate Consumer Protection Committee Vote",7,0,0,0,7
1152793,874114,2019-05-29,Senate,"Senate Floor Vote - Final Passage",51,9,0,2,62
1152793,882878,2019-06-17,Senate,"Senate Floor Vote - Final Passage",49,13,0,0,62
1152793,921320,2020-02-12,Senate,"Senate Consumer Protection Committee Vote",6,1,0,0,7
1152799,867284,2019-05-13,Senate,"Senate Consumer Protection Committee Vote",7,0,0,0,7
1152799,867285,2019-05-20,Senate,"Senate Rules Committee Vote",15,3,0,1,19
1152799,867824,2019-05-20,Senate,"Senate Floor Vote - Final Passage",42,18,0,2,62
1152799,902992,2020-01-15,Senate,"Senate Consumer Protection Committee Vote",6,1,0,0,7
1152811,810606,2019-02-11,Senate,"Senate Children and Families Committee Vote",7,0,0,0,7
1152811,810607,2019-02-27,Senate,"Senate Floor Vote - Final Passage",62,0,0,1,63
1152811,884310,2019-06-14,Senate,"Senate Floor Vote - Final Passage",62,0,0,0,62
1152816,787068,2019-01-28,Assembly,"Assembly Election Law Committee: Favorable refer to committee Ways and Means",15,0,0,1,16
1152816,882325,2019-06-14,Assembly,"Assembly Ways And Means Committee: Favorable refer to committee Rules",30,0,0,5,35
1152816,882517,2019-06-17,Assembly,"Assembly Rules Committee: Favorable",26,0,0,5,31
1152816,884269,2019-06-18,Assembly,"Assembly Floor Vote - Final Passage",146,0,0,4,150
1152816,886593,2019-06-19,Senate,"Senate Floor Vote - Final Passage",62,0,0,0,62
1152822,970895,2020-07-13,Assembly,"Assembly Corporations, Authorities And Commissions Committee: Held for Consideration",19,7,0,0,26
1152841,860530,2019-05-07,Assembly,"Assembly Codes Committee: Favorable",13,7,0,2,22
1152842,825337,2019-03-19,Assembly,"Assembly Agriculture Committee: Favorable refer to committee Codes",20,0,0,1,21
1152842,838967,2019-04-09,Assembly,"Assembly Codes Committee: Favorable refer to committee Ways and Means",22,0,0,0,22
1152842,879272,2019-06-06,Assembly,"Assembly Ways And Means Committee: Favorable refer to committee Rules",31,0,0,4,35
1152842,882425,2019-06-17,Assembly,"Assembly Rules Committee: Favorable",26,0,0,5,31
1152918,784849,2019-01-22,Senate,"Senate Transportation Committee Vote",15,0,0,0,15
1152918,877290,2019-06-04,Senate,"Senate Floor Vote - Final Passage",61,1,0,0,62
1152918,878053,2019-06-04,Senate,"Senate Rules Committee Vote",19,0,0,0,19
1152918,972695,2020-07-21,Senate,"Senate Finance Committee Vote",22,1,0,0,23
1152918,973329,2020-07-22,Senate,"Senate Rules Committee Vote",19,0,0,0,19
1152918,973491,2020-07-22,Senate,"Senate Floor Vote - Final Passage",57,3,0,0,60
1152918,973818,2020-07-22,Senate,"Senate Rules Committee Vote",19,0,0,0,19
1152920,970947,2020-07-13,Assembly,"Assembly Children And Families Committee: Favorable refer to committee Ways and Means",11,4,0,1,16
1152920,971848,2020-07-17,Assembly,"Assembly Ways And Means Committee: Favorable refer to committee Rules",32,0,0,2,34
1152920,972554,2020-07-21,Assembly,"Assembly Rules Committee: Favorable",26,0,0,4,30
1152920,973243,2020-07-22,Assembly,"Assembly Floor Vote - Final Passage",142,0,0,3,145
1152920,973644,2020-07-22,Senate,"Senate Floor Vote - Final Passage",60,0,0,0,60
1152923,878324,2019-06-05,Assembly,"Assembly Small Business Committee: Favorable refer to committee Ways and Means",16,0,0,1,17
1152923,880350,2019-06-11,Assembly,"Assembly Ways And Means Committee: Favorable refer to committee Rules",33,0,0,2,35
1152923,881344,2019-06-13,Assembly,"Assembly Rules Committee: Favorable",26,0,0,5,31
1152931,972083,2020-07-17,Assembly,"Assembly Codes Committee: Held for Consideration",15,6,0,1,22
1152935,859635,2019-05-06,Senate,"Senate Codes Committee Vote",12,1,0,0,13
1152935,863569,2019-05-14,Senate,"Senate Finance Committee Vote",21,1,0,1,23
1152935,874514,2019-05-29,Senate,"Senate Floor Vote - Final Passage",56,4,0,2,62
1152935,875749,2019-05-30,Assembly,"Assembly Floor Vote - Final Passage",142,1,0,7,150
1152939,878458,2019-06-04,Assembly,"Assembly Governmental Operations Committee: Favorable refer to committee Ways and Means",12,0,0,2,14
1152939,882645,2019-06-17,Assembly,"Assembly Rules Committee: Favorable",25,0,0,6,31
1152939,882646,2019-06-17,Assembly,"Assembly Ways And Means Committee: Favorable refer to committee Rules",33,0,0,2,35
1152939,884991,2019-06-19,Assembly,"Assembly Floor Vote - Final Passage",148,0,0,2,150
1152939,886720,2019-06-19,Senate,"Senate Floor Vote - Final Passage",59,3,0,0,62
1152945,874295,2019-05-29,Senate,"Senate Investigations and Government Operations Committee Vote",5,2,0,0,7
1152959,971629,2020-07-16,Assembly,"Assembly Real Property Taxation Committee: Held for Consideration",8,2,0,0,10
1152990,972044,2020-07-17,Assembly,"Assembly Codes Committee: Held for Consideration",15,6,0,1,22
1152998,885417,2019-06-18,Senate,"Senate Floor Vote - Final Passage",61,1,0,0,62
1152998,886627,2019-06-18,Senate,"Senate Rules Committee Vote",19,0,0,0,19
1152998,904852,2020-01-22,Senate,"Senate Finance Committee Vote",23,0,0,0,23
1152998,973073,2020-07-21,Senate,"Senate Floor Vote - Final Passage",59,1,0,0,60
1153015,796940,2019-01-22,Senate,"Senate Transportation Committee Vote",15,0,0,0,15
1153015,796941,2019-02-11,Senate,"Senate Floor Vote - Final Passage",61,0,0,2,63
1153015,935223,2020-02-25,Senate,"Senate Transportation Committee Vote",15,0,0,0,15
1153015,941535,2020-03-03,Senate,"Senate Floor Vote - Final Passage",62,0,0,0,62
1153044,792550,2019-02-05,Assembly,"Assembly Environmental Conservation Committee: Favorable refer to committee Ways and Means",22,6,0,2,30
1153044,864859,2019-05-14,Assembly,"Assembly Ways And Means Committee: Favorable",22,10,0,3,35
1153048,869280,2019-05-13,Senate,"Senate Insurance Committee Vote",11,0,0,0,11
1153048,869281,2019-05-22,Senate,"Senate Floor Vote - Final Passage",61,0,0,1,62
1153048,906197,2020-01-27,Senate,"Senate Insurance Committee Vote",11,0,0,0,11
1153048,950197,2020-03-11,Senate,"Senate Floor Vote - Final Passage",58,0,0,4,62
1153108,867617,2019-04-30,Senate,"Senate Investigations and Government Operations Committee Vote",7,0,0,0,7
1153108,867618,2019-05-20,Senate,"Senate Floor Vote - Final Passage",60,0,0,2,62
1153108,880650,2019-06-11,Assembly,"Assembly Floor Vote - Final Passage",142,0,0,8,150
1153120,880007,2019-06-11,Senate,"Senate Rules Committee Vote",18,1,0,0,19
1153120,880481,2019-06-11,Senate,"Senate Floor Vote - Final Passage",48,13,0,1,62
1153120,902104,2020-01-13,Senate,"Senate Codes Committee Vote",10,3,0,0,13
1153153,875557,2019-05-29,Senate,"Senate Elections Committee Vote",7,0,0,0,7
1153153,876597,2019-06-03,Senate,"Senate Floor Vote - Final Passage",62,0,0,0,62
1153153,879544,2019-06-03,Senate,"Senate Rules Committee Vote",19,0,0,0,19
1153155,935226,2019-04-09,Senate,"Senate Crime Victims, Crime and Correction Committee Vote",7,0,0,0,7
1153155,935227,2020-02-25,Senate,"Senate Crime Victims, Crime and Correction Committee Vote",7,0,0,0,7
1153155,941815,2020-03-03,Senate,"Senate Finance Committee Vote",23,0,0,0,23
1153164,876788,2019-01-28,Senate,"Senate Consumer Protection Committee Vote",7,0,0,0,7
1153164,876789,2019-06-03,Senate,"Senate Floor Vote - Final Passage",62,0,0,0,62
1153164,921290,2020-02-12,Senate,"Senate Consumer Protection Committee Vote",7,0,0,0,7
1153164,936961,2020-02-27,Senate,"Senate Floor Vote - Final Passage",59,0,0,3,62
1153164,973141,2020-07-22,Assembly,"Assembly Floor Vote - Final Passage",140,2,0,3,145
1153169,963643,2020-06-08,Assembly,"Assembly Codes Committee: Favorable refer to committee Rules",19,2,0,1,22
1153169,963644,2020-06-08,Assembly,"Assembly Rules Committee: Favorable",26,0,0,5,31
1153169,963678,2020-06-08,Assembly,"Assembly Floor Vote - Final Passage",115,29,0,3,147
1153169,964312,2020-06-08,Senate,"Senate Floor Vote - Final Passage",56,6,0,0,62
1153184,830958,2019-03-26,Senate,"Senate Rules Committee Vote",19,0,0,0,19
1153184,830959,2019-03-28,Senate,"Senate Floor Vote - Final Passage",61,0,0,1,62
1153184,863020,2019-05-13,Senate,"Senate Floor Vote - Final Passage",60,0,0,2,62
1153184,903075,2020-01-14,Senate,"Senate Cultural Affairs, Tourism, Parks and Recreation Committee Vote",7,0,0,0,7
1153184,904481,2020-01-22,Senate,"Senate Finance Committee Vote",23,0,0,0,23
1153184,940536,2020-03-02,Senate,"Senate Floor Vote - Final Passage",61,0,0,1,62
1153189,972125,2020-07-17,Assembly,"Assembly Codes Committee: Held for Consideration",15,6,0,1,22
1153193,870183,2019-05-21,Assembly,"Assembly Transportation Committee: Held for Consideration",17,8,0,0,25
1153243,868858,2019-05-21,Assembly,"Assembly Economic Development Committee: Favorable refer to committee Codes",16,8,0,2,26
1153243,875054,2019-05-30,Assembly,"Assembly Codes Committee: Favorable",15,4,0,3,22
1153272,906923,2020-01-28,Assembly,"Assembly Consumer Affairs And Protection Committee: Favorable refer to committee Codes",13,0,0,3,16
1153272,914707,2020-02-04,Assembly,"Assembly Codes Committee: Favorable",19,0,0,3,22
1153309,784943,2019-01-22,Senate,"Senate Transportation Committee Vote",15,0,0,0,15
1153309,876596,2019-06-03,Senate,"Senate Floor Vote - Final Passage",61,1,0,0,62
1153309,877302,2019-06-03,Senate,"Senate Rules Committee Vote",19,0,0,0,19
1153309,972662,2020-07-21,Senate,"Senate Finance Committee Vote",22,1,0,0,23
1153309,973324,2020-07-22,Senate,"Senate Rules Committee Vote",19,0,0,0,19
1153309,973480,2020-07-22,Senate,"Senate Floor Vote - Final Passage",57,3,0,0,60
1153309,973812,2020-07-22,Senate,"Senate Rules Committee Vote",19,0,0,0,19
1153318,878345,2019-06-04,Assembly,"Assembly Judiciary Committee: Favorable refer to committee Codes",21,0,0,0,21
1153318,881421,2019-06-13,Assembly,"Assembly Codes Committee: Favorable refer to committee Rules",20,0,0,2,22
1153318,882542,2019-06-17,Assembly,"Assembly Rules Committee: Favorable",26,0,0,5,31
1153318,884251,2019-06-18,Assembly,"Assembly Floor Vote - Final Passage",146,0,0,4,150
1153318,886721,2019-06-19,Senate,"Senate Floor Vote - Final Passage",62,0,0,0,62
1153327,861462,2019-05-07,Assembly,"Assembly Health Committee: Favorable",22,0,0,4,26
1153360,874649,2019-05-29,Assembly,"Assembly Environmental Conservation Committee: Favorable",29,0,0,1,30
1153360,877091,2019-06-03,Assembly,"Assembly Floor Vote - Final Passage",137,5,0,8,150
1153360,882250,2019-06-14,Senate,"Senate Floor Vote - Final Passage",44,18,0,0,62
1153362,857006,2019-04-30,Assembly,"Assembly Corporations, Authorities And Commissions Committee: Favorable refer to committee Ways and Means",25,0,0,1,26
1153362,863647,2019-05-14,Assembly,"Assembly Ways And Means Committee: Favorable",32,0,0,3,35
1153374,880647,2019-06-11,Assembly,"Assembly Codes Committee: Favorable refer to committee Ways and Means",16,6,0,0,22
1153374,880648,2019-06-11,Assembly,"Assembly Ways And Means Committee: Favorable refer to committee Rules",21,12,0,2,35
1153374,963738,2020-06-09,Assembly,"Assembly Rules Committee: Favorable",20,7,0,4,31
1153374,963739,2020-06-09,Assembly,"Assembly Ways And Means Committee: Favorable refer to committee Rules",23,9,0,3,35
1153382,971932,2020-07-17,Assembly,"Assembly Codes Committee: Held for Consideration",15,6,0,1,22
1153406,820792,2019-03-12,Assembly,"Assembly Local Governments Committee: Favorable refer to committee Ways and Means",16,2,0,1,19
1153406,864873,2019-05-14,Assembly,"Assembly Ways And Means Committee: Favorable",30,2,0,3,35
1153406,867922,2019-05-20,Assembly,"Assembly Floor Vote - Final Passage",139,4,0,7,150
1153406,885779,2019-06-18,Senate,"Senate Floor Vote - Final Passage",62,0,0,0,62
1153416,862913,2019-04-30,Senate,"Senate Health Committee Vote",15,0,0,0,15
1153416,862914,2019-05-13,Senate,"Senate Floor Vote - Final Passage",60,0,0,2,62
1153416,881724,2019-06-13,Assembly,"Assembly Floor Vote - Final Passage",145,0,0,5,150
1153419,811056,2019-02-27,Assembly,"Assembly Election Law Committee: Favorable refer to committee Ways and Means",13,0,0,3,16
1153419,864858,2019-05-14,Assembly,"Assembly Ways And Means Committee: Favorable",32,0,0,3,35
1153419,867908,2019-05-20,Assembly,"Assembly Floor Vote - Final Passage",139,4,0,7,150
1153419,876727,2019-06-03,Senate,"Senate Floor Vote - Final Passage",62,0,0,0,62
1153431,857005,2019-05-01,Assembly,"Assembly Election Law Committee: Favorable",16,0,0,0,16
1153431,903302,2020-01-15,Assembly,"Assembly Floor Vote - Final Passage",133,3,0,12,148
1153431,973488,2020-07-22,Senate,"Senate Floor Vote - Final Passage",59,1,0,0,60
1154081,784416,2019-01-22,Senate,"Senate Labor Committee Vote",13,0,0,0,13
1154081,884548,2019-06-18,Senate,"Senate Rules Committee Vote",19,0,0,0,19
1154081,885537,2019-06-18,Senate,"Senate Floor Vote - Final Passage",62,0,0,0,62
1154081,886163,2019-06-21,Assembly,"Assembly Floor Vote - Final Passage",144,0,0,6,150
1154123,876603,2019-06-03,Senate,"Senate Floor Vote - Final Passage",61,1,0,0,62
1154123,877285,2019-06-03,Senate,"Senate Rules Committee Vote",19,0,0,0,19
1154123,886440,2019-06-21,Assembly,"Assembly Floor Vote - Final Passage",144,0,0,6,150
1154199,868130,2019-05-21,Senate,"Senate Housing, Construction and Community Development Committee Vote",7,4,0,0,11
1154199,919854,2020-02-11,Senate,"Senate Housing, Construction and Community Development Committee Vote",7,4,0,0,11
1154199,919855,2020-02-11,Senate,"Senate Rules Committee Vote",14,5,0,0,19
1154199,921523,2020-02-12,Senate,"Senate Floor Vote - Final Passage",37,22,0,3,62
1154273,830217,2019-03-19,Senate,"Senate Environmental Conservation Committee Vote",10,1,0,0,11
1154273,830218,2019-03-27,Senate,"Senate Floor Vote - Final Passage",60,1,0,1,62
1154273,865157,2019-05-15,Assembly,"Assembly Floor Vote - Final Passage",140,1,0,9,150
1154337,884115,2019-02-05,Senate,"Senate Investigations and Government Operations Committee Vote",6,1,0,0,7
1154337,884116,2019-06-17,Senate,"Senate Floor Vote - Final Passage",42,20,0,0,62
1154337,886361,2019-06-20,Assembly,"Assembly Floor Vote - Final Passage",105,41,0,4,150
1154371,784409,2019-01-22,Senate,"Senate Labor Committee Vote",11,2,0,0,13
1154371,814844,2019-03-05,Senate,"Senate Finance Committee Vote",19,2,0,2,23
1154371,818675,2019-03-11,Senate,"Senate Floor Vote - Final Passage",50,12,0,0,62
1154386,884397,2019-06-18,Senate,"Senate Rules Committee Vote",19,0,0,0,19
1154386,885463,2019-06-18,Senate,"Senate Floor Vote - Final Passage",62,0,0,0,62
1154455,886562,2019-06-19,Senate,"Senate Floor Vote - Final Passage",62,0,0,0,62
1154455,886563,2019-06-21,Assembly,"Assembly Floor Vote - Final Passage",144,0,0,6,150
1154455,887360,2019-06-19,Senate,"Senate Rules Committee Vote",19,0,0,0,19
1154553,886526,2019-06-20,Senate,"Senate Floor Vote - Final Passage",62,0,0,0,62
1154553,887352,2019-06-20,Senate,"Senate Rules Committee Vote",19,0,0,0,19
1154645,877710,2019-06-04,Senate,"Senate Floor Vote - Final Passage",62,0,0,0,62
1154645,878082,2019-06-04,Senate,"Senate Rules Committee Vote",19,0,0,0,19
1154645,972323,2020-07-20,Senate,"Senate Local Government Committee Vote",7,0,0,0,7
1154713,839513,2019-04-08,Senate,"Senate Codes Committee Vote",10,2,0,1,13
1154713,963666,2020-06-08,Senate,"Senate Floor Vote - Final Passage",60,2,0,0,62
1154713,966329,2020-05-28,Senate,"Senate Rules Committee Vote",19,0,0,0,19
1154713,966330,2020-06-08,Senate,"Senate Finance Committee Vote",23,0,0,0,23
1154716,792539,2019-02-04,Assembly,"Assembly Health Committee: Favorable",23,2,0,1,26
1154725,875702,2019-05-30,Senate,"Senate Consumer Protection Committee Vote",6,1,0,0,7
1154725,877036,2019-06-03,Senate,"Senate Floor Vote - Final Passage",44,18,0,0,62
1154725,877321,2019-06-03,Senate,"Senate Rules Committee Vote",14,5,0,0,19
1154745,861009,2019-04-30,Senate,"Senate Health Committee Vote",15,0,0,0,15
1154745,861010,2019-05-08,Senate,"Senate Floor Vote - Final Passage",61,0,0,1,62
1154745,948301,2020-03-10,Senate,"Senate Health Committee Vote",14,0,0,1,15
1154810,796930,2019-02-11,Senate,"Senate Women's Issues Committee Vote",7,0,0,0,7
1154810,815005,2019-03-05,Senate,"Senate Finance Committee Vote",21,0,0,2,23
1154810,826148,2019-03-20,Senate,"Senate Floor Vote - Final Passage",62,0,0,0,62
1154831,973560,2020-07-22,Senate,"Senate Floor Vote - Final Passage",59,1,0,0,60
1154831,973922,2020-07-20,Senate,"Senate Transportation Committee Vote",15,0,0,0,15
1154831,973923,2020-07-21,Senate,"Senate Rules Committee Vote",19,0,0,0,19
1154838,885652,2019-06-18,Senate,"Senate Floor Vote - Final Passage",62,0,0,0,62
1154838,886274,2019-06-18,Senate,"Senate Rules Committee Vote",19,0,0,0,19
1154838,886275,2019-06-21,Assembly,"Assembly Floor Vote - Final Passage",135,0,0,15,150
1154893,882153,2019-06-14,Senate,"Senate Floor Vote - Final Passage",62,0,0,0,62
1154893,882154,2019-06-14,Senate,"Senate Rules Committee Vote",19,0,0,0,19
1154893,883148,2019-06-17,Assembly,"Assembly Floor Vote - Final Passage",147,0,0,3,150
1154921,838901,2019-03-26,Senate,"Senate Rules Committee Vote",14,5,0,0,19
1154921,838902,2019-04-08,Senate,"Senate Floor Vote - Final Passage",37,22,0,3,62
1154933,821767,2019-02-27,Senate,"Senate Health Committee Vote",14,0,0,1,15
1154933,821768,2019-03-14,Senate,"Senate Floor Vote - Final Passage",61,0,0,1,62
1154933,828412,2019-03-25,Assembly,"Assembly Floor Vote - Final Passage",132,14,0,4,150
1154945,880896,2019-05-29,Senate,"Senate Investigations and Government Operations Committee Vote",7,0,0,0,7
1154945,882096,2019-06-12,Senate,"Senate Floor Vote - Final Passage",62,0,0,0,62
1154983,881849,2019-06-13,Senate,"Senate Floor Vote - Final Passage",62,0,0,0,62
1154983,881850,2019-06-13,Senate,"Senate Rules Committee Vote",19,0,0,0,19
1154983,885069,2019-06-19,Assembly,"Assembly Floor Vote - Final Passage",146,2,0,2,150
1155058,878218,2019-05-30,Senate,"Senate Health Committee Vote",15,0,0,0,15
1155058,878219,2019-06-05,Senate,"Senate Floor Vote - Final Passage",62,0,0,0,62
1155058,904630,2020-01-22,Senate,"Senate Health Committee Vote",15,0,0,0,15
1155058,942021,2020-03-04,Senate,"Senate Floor Vote - Final Passage",62,0,0,0,62
1155085,880035,2019-06-11,Senate,"Senate Rules Committee Vote",19,0,0,0,19
1155085,880411,2019-06-11,Senate,"Senate Floor Vote - Final Passage",61,0,0,1,62
1155085,948651,2020-03-10,Senate,"Senate Health Committee Vote",14,0,0,1,15
1155116,798350,2019-02-12,Senate,"Senate Labor Committee Vote",12,1,0,0,13
1155116,814913,2019-03-05,Senate,"Senate Finance Committee Vote",20,1,0,2,23
1155116,819815,2019-03-12,Senate,"Senate Floor Vote - Final Passage",58,3,0,1,62
1155116,885425,2019-06-19,Assembly,"Assembly Floor Vote - Final Passage",130,18,0,2,150
1155126,884633,2019-06-18,Senate,"Senate Rules Committee Vote",18,1,0,0,19
1155126,885129,2019-06-18,Senate,"Senate Floor Vote - Final Passage",47,15,0,0,62
1155143,792534,2019-02-04,Assembly,"Assembly Insurance Committee: Favorable refer to committee Codes",23,0,0,1,24
1155143,796949,2019-02-11,Assembly,"Assembly Codes Committee: Favorable",22,0,0,0,22
1155143,809541,2019-02-26,Assembly,"Assembly Floor Vote - Final Passage",131,5,0,14,150
1155143,859603,2019-05-06,Senate,"Senate Floor Vote - Final Passage",53,8,0,1,62
1155150,877574,2019-05-14,Senate,"Senate Higher Education Committee Vote",11,0,0,0,11
1155150,877575,2019-06-04,Senate,"Senate Floor Vote - Final Passage",62,0,0,0,62
1155150,941736,2020-03-03,Senate,"Senate Higher Education Committee Vote",11,0,0,0,11
1155155,796390,2019-01-28,Senate,"Senate Judiciary Committee Vote",15,0,0,0,15
1155155,796391,2019-02-11,Senate,"Senate Floor Vote - Final Passage",61,0,0,2,63
1155180,860980,2019-05-07,Senate,"Senate Health Committee Vote",15,0,0,0,15
1155213,797148,2019-02-11,Senate,"Senate Health Committee Vote",14,0,0,1,15
1155213,863983,2019-05-14,Senate,"Senate Finance Committee Vote",22,0,0,1,23
1155213,874350,2019-05-29,Senate,"Senate Floor Vote - Final Passage",59,1,0,2,62
1155263,856081,2019-04-30,Senate,"Senate Health Committee Vote",15,0,0,0,15
1155263,880024,2019-06-11,Senate,"Senate Rules Committee Vote",19,0,0,0,19
1155263,880497,2019-06-11,Senate,"Senate Floor Vote - Final Passage",60,1,0,1,62
1155263,907625,2020-01-28,Senate,"Senate Health Committee Vote",15,0,0,0,15
1155345,810886,2019-02-27,Senate,"Senate Health Committee Vote",14,0,0,1,15
1155345,839352,2019-04-09,Senate,"Senate Finance Committee Vote",23,0,0,0,23
1155345,859557,2019-05-06,Senate,"Senate Floor Vote - Final Passage",61,0,0,1,62
1155345,884647,2019-06-18,Assembly,"Assembly Floor Vote - Final Passage",146,0,0,4,150
1155373,839332,2019-04-09,Senate,"Senate Education Committee Vote",15,0,0,0,15
1155373,860968,2019-05-07,Senate,"Senate Finance Committee Vote",23,0,0,0,23
1155373,864101,2019-05-15,Senate,"Senate Floor Vote - Final Passage",58,0,0,4,62
1155373,877876,2019-06-04,Assembly,"Assembly Floor Vote - Final Passage",147,0,0,3,150
1155432,840814,2019-04-09,Assembly,"Assembly Transportation Committee: Held for Consideration",16,7,0,2,25
1155446,878476,2019-06-05,Assembly,"Assembly Education Committee: Favorable refer to committee Ways and Means",27,2,0,2,31
1155503,971570,2020-07-16,Assembly,"Assembly Governmental Operations Committee: Held for Consideration",10,4,0,0,14
1155536,970894,2020-07-13,Assembly,"Assembly Corporations, Authorities And Commissions Committee: Held for Consideration",19,7,0,0,26
1155559,971062,2020-07-14,Assembly,"Assembly Judiciary Committee: Held for Consideration",15,6,0,0,21
1155587,792556,2019-02-05,Assembly,"Assembly Environmental Conservation Committee: Favorable refer to committee Codes",23,5,0,2,30
1155587,861506,2019-05-07,Assembly,"Assembly Codes Committee: Favorable",13,7,0,2,22
1155639,971736,2020-07-17,Assembly,"Assembly Codes Committee: Held for Consideration",15,6,0,1,22
1155659,867913,2019-05-21,Assembly,"Assembly Governmental Operations Committee: Favorable refer to committee Ways and Means",14,0,0,0,14
1155659,874754,2019-05-30,Assembly,"Assembly Ways And Means Committee: Favorable",31,0,0,4,35
1155668,857106,2019-04-30,Assembly,"Assembly Housing Committee: Favorable refer to committee Codes",25,0,0,3,28
1155668,859845,2019-05-07,Assembly,"Assembly Codes Committee: Favorable",20,0,0,2,22
1155668,863574,2019-05-13,Assembly,"Assembly Floor Vote - Final Passage",141,0,0,9,150
1155668,874530,2019-05-29,Senate,"Senate Floor Vote - Final Passage",56,4,0,2,62
1155673,971405,2020-07-16,Assembly,"Assembly Housing Committee: Held for Consideration",18,8,0,2,28
1155683,971660,2020-07-16,Assembly,"Assembly Real Property Taxation Committee: Held for Consideration",8,2,0,0,10
1155751,809554,2019-02-26,Assembly,"Assembly Social Services Committee: Favorable refer to committee Ways and Means",14,1,0,3,18
1155762,971173,2020-07-14,Assembly,"Assembly Judiciary Committee: Held for Consideration",15,6,0,0,21
1155774,971454,2020-07-15,Assembly,"Assembly Veterans' Affairs Committee: Held for Consideration",13,4,0,2,19
1155781,971153,2020-07-14,Assembly,"Assembly Judiciary Committee: Held for Consideration",15,6,0,0,21
1155804,971066,2020-07-14,Assembly,"Assembly Judiciary Committee: Held for Consideration",15,6,0,0,21
1155808,972065,2020-07-17,Assembly,"Assembly Codes Committee: Held for Consideration",15,6,0,1,22
1155880,877734,2019-06-04,Assembly,"Assembly Ways And Means Committee: Favorable refer to committee Rules",33,0,0,2,35
1155880,877999,2019-06-05,Assembly,"Assembly Rules Committee: Favorable",27,0,0,4,31
1155880,879388,2019-06-06,Assembly,"Assembly Floor Vote - Final Passage",132,5,0,13,150
1155890,972123,2020-07-17,Assembly,"Assembly Ways And Means Committee: Held for Consideration",22,10,0,2,34
1155958,971152,2020-07-14,Assembly,"Assembly Election Law Committee: Held for Consideration",12,4,0,0,16
1155981,971661,2020-07-16,Assembly,"Assembly Governmental Operations Committee: Held for Consideration",10,4,0,0,14
1156019,786868,2019-01-28,Assembly,"Assembly Codes Committee: Favorable refer to committee Rules",22,0,0,0,22
1156019,786932,2019-01-28,Assembly,"Assembly Rules Committee: Favorable",27,2,0,2,31
1156032,971453,2020-07-15,Assembly,"Assembly Racing And Wagering Committee: Held for Consideration",8,3,0,0,11
1156041,808810,2019-02-04,Senate,"Senate Local Government Committee Vote",7,0,0,0,7
1156041,808811,2019-02-26,Senate,"Senate Floor Vote - Final Passage",61,0,0,2,63
1156041,875813,2019-05-30,Assembly,"Assembly Floor Vote - Final Passage",142,0,0,8,150
1156047,972022,2020-07-17,Assembly,"Assembly Codes Committee: Held for Consideration",15,6,0,1,22
1156064,863945,2019-02-04,Senate,"Senate Corporations, Authorities And Commissions Committee Vote",7,0,0,0,7
1156064,863946,2019-05-13,Senate,"Senate Floor Vote - Final Passage",60,0,0,2,62
1156064,940886,2020-03-02,Senate,"Senate Corporations, Authorities and Commissions Committee Vote",6,0,0,1,7
1156072,972004,2020-07-17,Assembly,"Assembly Ways And Means Committee: Held for Consideration",24,8,0,2,34
1156090,787142,2019-01-28,Assembly,"Assembly Election Law Committee: Favorable refer to committee Codes",15,0,0,1,16
1156090,813644,2019-03-05,Assembly,"Assembly Codes Committee: Favorable",22,0,0,0,22
1156098,971924,2020-07-17,Assembly,"Assembly Ways And Means Committee: Held for Consideration",22,10,0,2,34
1156211,971951,2020-07-17,Assembly,"Assembly Codes Committee: Held for Consideration",15,6,0,1,22
1156236,971061,2020-07-14,Assembly,"Assembly Judiciary Committee: Held for Consideration",15,6,0,0,21
1156241,971100,2020-07-14,Assembly,"Assembly Environmental Conservation Committee: Held for Consideration",18,9,0,1,28
1156275,861484,2019-05-07,Assembly,"Assembly Codes Committee: Favorable",14,6,0,2,22
1156300,820844,2019-03-12,Assembly,"Assembly Election Law Committee: Favorable refer to committee Codes",15,0,0,1,16
1156300,823403,2019-03-18,Assembly,"Assembly Codes Committee: Favorable",21,0,0,1,22
1156300,828926,2019-03-25,Assembly,"Assembly Floor Vote - Final Passage",144,2,0,4,150
1156300,867750,2019-05-20,Senate,"Senate Floor Vote - Final Passage",59,1,0,2,62
1156323,949364,2020-03-11,Assembly,"Assembly Local Governments Committee: Held for Consideration",11,5,0,2,18
1156356,972115,2020-07-17,Assembly,"Assembly Ways And Means Committee: Held for Consideration",22,10,0,2,34
1156382,882225,2019-06-13,Assembly,"Assembly Codes Committee: Held for Consideration",14,6,0,2,22
1157121,784394,2019-01-22,Senate,"Senate Higher Education Committee Vote",11,0,0,0,11
1157121,875032,2019-05-30,Senate,"Senate Floor Vote - Final Passage",57,1,0,4,62
1157121,875033,2019-05-30,Senate,"Senate Rules Committee Vote",18,0,0,1,19
1157187,808759,2019-02-04,Senate,"Senate Local Government Committee Vote",7,0,0,0,7
1157187,808760,2019-02-26,Senate,"Senate Floor Vote - Final Passage",60,1,0,2,63
1157187,860360,2019-05-06,Assembly,"Assembly Floor Vote - Final Passage",142,0,0,8,150
1157250,864043,2019-03-19,Senate,"Senate Judiciary Committee Vote",13,2,0,0,15
1157250,864044,2019-05-14,Senate,"Senate Floor Vote - Final Passage",42,17,0,3,62
1157250,864045,2019-05-14,Assembly,"Assembly Floor Vote - Final Passage",129,12,0,9,150
1157319,972027,2020-07-17,Assembly,"Assembly Codes Committee: Held for Consideration",15,6,0,1,22
1157351,971976,2020-07-17,Assembly,"Assembly Ways And Means Committee: Held for Consideration",22,10,0,2,34
1157416,878096,2019-06-05,Assembly,"Assembly Transportation Committee: Held for Consideration",19,7,0,0,26
1157426,971607,2020-07-16,Assembly,"Assembly Real Property Taxation Committee: Held for Consideration",8,2,0,0,10
1157479,972016,2020-07-17,Assembly,"Assembly Codes Committee: Held for Consideration",15,6,0,1,22
1157487,971788,2020-07-16,Assembly,"Assembly Local Governments Committee: Held for Consideration",15,4,0,1,20
1157504,971266,2020-07-14,Assembly,"Assembly Education Committee: Held for Consideration",23,6,0,2,31
1157549,854457,2019-04-08,Senate,"Senate Corporations, Authorities and Commissions Committee Vote",7,0,0,0,7
1157549,854458,2019-04-29,Senate,"Senate Floor Vote - Final Passage",61,0,0,1,62
1157549,868166,2019-05-20,Assembly,"Assembly Floor Vote - Final Passage",143,0,0,7,150
1157558,797569,2019-02-04,Senate,"Senate Corporations, Authorities and Commissions Committee Vote",7,0,0,0,7
1157558,797570,2019-02-12,Senate,"Senate Floor Vote - Final Passage",59,1,0,3,63
1157568,971722,2020-07-17,Assembly,"Assembly Codes Committee: Held for Consideration",15,6,0,1,22
1157626,784317,2019-01-22,Senate,"Senate Higher Education Committee Vote",11,0,0,0,11
1157626,784886,2019-01-22,Senate,"Senate Higher Education Committee Vote",11,0,0,0,11
1157626,784887,2019-01-23,Senate,"Senate Floor Vote - Final Passage",60,0,0,3,63
1157702,972010,2020-07-17,Assembly,"Assembly Codes Committee: Held for Consideration",15,6,0,1,22
1157749,971098,2020-07-14,Assembly,"Assembly Environmental Conservation Committee: Held for Consideration",19,8,0,1,28
1157780,971734,2020-07-17,Assembly,"Assembly Ways And Means Committee: Held for Consideration",22,10,0,2,34
1157800,819874,2019-02-12,Senate,"Senate Transportation Committee Vote",14,1,0,0,15
1157800,819875,2019-03-12,Senate,"Senate Floor Vote - Final Passage",60,1,0,1,62
1157897,860736,2019-05-06,Senate,"Senate Agriculture Committee Vote",9,0,0,0,9
1157926,788451,2019-01-29,Assembly,"Assembly Environmental Conservation Committee: Favorable refer to committee Ways and Means",29,0,0,1,30
1157926,840074,2019-04-09,Assembly,"Assembly Ways And Means Committee: Favorable",28,4,0,3,35
1157926,855500,2019-04-30,Senate,"Senate Floor Vote - Final Passage",57,5,0,0,62
1157926,857505,2019-04-30,Assembly,"Assembly Floor Vote - Final Passage",133,11,0,6,150
1157939,971167,2020-07-14,Assembly,"Assembly Correction Committee: Held for Consideration",10,2,0,1,13
1157946,881608,2019-06-13,Assembly,"Assembly Floor Vote - Final Passage",146,0,0,4,150
1157946,882058,2019-06-12,Senate,"Senate Floor Vote - Final Passage",62,0,0,0,62
1157946,882059,2019-06-12,Senate,"Senate Rules Committee Vote",19,0,0,0,19
1157955,875695,2019-05-30,Senate,"Senate Environmental Conservation Committee Vote",10,0,0,1,11
1157967,877909,2019-06-05,Assembly,"Assembly Banks Committee: Favorable refer to committee Ways and Means",21,8,0,2,31
1157967,879330,2019-06-06,Assembly,"Assembly Ways And Means Committee: Favorable refer to committee Rules",21,10,0,4,35
1157967,880506,2019-06-11,Assembly,"Assembly Rules Committee: Favorable",25,0,0,6,31
1158032,877521,2019-06-04,Assembly,"Assembly Judiciary Committee: Favorable refer to committee Codes",18,3,0,0,21
1158032,880143,2019-06-11,Assembly,"Assembly Codes Committee: Favorable refer to committee Rules",19,3,0,0,22
1158032,882528,2019-06-17,Assembly,"Assembly Rules Committee: Favorable",26,0,0,5,31
1158056,971075,2020-07-14,Assembly,"Assembly Judiciary Committee: Held for Consideration",15,6,0,0,21
1158077,792551,2019-02-05,Assembly,"Assembly Governmental Operations Committee: Favorable refer to committee Codes",9,4,0,1,14
1158077,796792,2019-02-11,Assembly,"Assembly Codes Committee: Favorable refer to committee Ways and Means",16,6,0,0,22
1158077,796793,2019-02-11,Assembly,"Assembly Ways And Means Committee: Favorable",22,9,0,4,35
1158102,971434,2020-07-15,Assembly,"Assembly Racing And Wagering Committee: Favorable refer to committee Rules",11,0,0,0,11
1158122,878034,2019-06-05,Assembly,"Assembly Education Committee: Favorable refer to committee Rules",29,0,0,2,31
1158122,880230,2019-06-11,Assembly,"Assembly Rules Committee: Favorable",25,0,0,6,31
1158122,881150,2019-06-12,Assembly,"Assembly Floor Vote - Final Passage",147,0,0,3,150
1158246,971778,2020-07-16,Assembly,"Assembly Local Governments Committee: Held for Consideration",15,4,0,1,20
1158358,883027,2019-06-17,Senate,"Senate Floor Vote - Final Passage",59,3,0,0,62
1158358,883028,2019-06-17,Senate,"Senate Rules Committee Vote",18,1,0,0,19
1158358,884490,2019-06-18,Assembly,"Assembly Floor Vote - Final Passage",131,15,0,4,150
1158455,791665,2019-02-04,Senate,"Senate Local Government Committee Vote",5,2,0,0,7
1158455,819577,2019-03-12,Senate,"Senate Finance Committee Vote",18,4,0,1,23
1158526,811361,2019-02-27,Assembly,"Assembly Judiciary Committee: Favorable",15,6,0,0,21
1158533,860705,2019-05-07,Assembly,"Assembly Banks Committee: Favorable refer to committee Codes",18,8,0,5,31
1158533,880207,2019-06-11,Assembly,"Assembly Codes Committee: Favorable refer to committee Rules",21,1,0,0,22
1158533,881363,2019-06-13,Assembly,"Assembly Rules Committee: Favorable",26,0,0,5,31
1158538,970940,2020-07-13,Assembly,"Assembly Agriculture Committee: Held for Consideration",14,5,0,2,21
1158553,972019,2020-07-17,Assembly,"Assembly Ways And Means Committee: Held for Consideration",22,10,0,2,34
1158584,811109,2019-02-27,Assembly,"Assembly Real Property Taxation Committee: Favorable refer to committee Ways and Means",9,0,0,1,10
1158584,864856,2019-05-14,Assembly,"Assembly Ways And Means Committee: Favorable",32,0,0,3,35
1158589,870117,2019-05-21,Assembly,"Assembly Codes Committee: Favorable",21,0,0,1,22
1158589,874841,2019-05-29,Assembly,"Assembly Floor Vote - Final Passage",141,0,0,9,150
1158607,784248,2019-01-22,Senate,"Senate Local Government Committee Vote",7,0,0,0,7
1158607,784660,2019-01-22,Senate,"Senate Local Government Committee Vote",7,0,0,0,7
1158607,784834,2019-01-23,Senate,"Senate Floor Vote - Final Passage",58,2,0,3,63
1158653,883790,2019-06-12,Senate,"Senate Rules Committee Vote",18,1,0,0,19
1158653,885193,2019-06-18,Senate,"Senate Floor Vote - Final Passage",58,4,0,0,62
1158709,857497,2019-05-01,Assembly,"Assembly Education Committee: Favorable refer to committee Ways and Means",28,0,0,3,31
1158709,884826,2019-06-19,Assembly,"Assembly Ways And Means Committee: Favorable refer to committee Rules",33,0,0,2,35
1158709,885256,2019-06-20,Assembly,"Assembly Rules Committee: Favorable",27,0,0,4,31
1158735,793412,2019-02-05,Assembly,"Assembly Veterans' Affairs Committee: Favorable",17,0,0,2,19
1158777,878327,2019-06-05,Assembly,"Assembly Election Law Committee: Favorable refer to committee Rules",15,0,0,1,16
1158777,937401,2020-02-26,Assembly,"Assembly Election Law Committee: Favorable",15,0,0,1,16
1158777,940794,2020-03-02,Assembly,"Assembly Floor Vote - Final Passage",139,0,0,8,147
1158836,824491,2019-03-19,Senate,"Senate Environmental Conservation Committee Vote",11,0,0,0,11
1158848,811087,2019-02-27,Assembly,"Assembly Education Committee: Favorable",28,0,0,3,31
1158855,820773,2019-03-12,Assembly,"Assembly Local Governments Committee: Favorable refer to committee Codes",18,0,0,1,19
1158855,823410,2019-03-18,Assembly,"Assembly Codes Committee: Favorable",21,0,0,1,22
1158855,828406,2019-03-25,Assembly,"Assembly Floor Vote - Final Passage",146,0,0,4,150
1158882,808816,2019-02-04,Senate,"Senate Local Government Committee Vote",7,0,0,0,7
1158882,808817,2019-02-26,Senate,"Senate Floor Vote - Final Passage",61,0,0,2,63
1158882,902272,2020-01-13,Senate,"Senate Local Government Committee Vote",6,0,0,1,7
1158882,921248,2020-02-11,Senate,"Senate Floor Vote - Final Passage",61,1,0,0,62
1158889,971163,2020-07-14,Assembly,"Assembly Judiciary Committee: Held for Consideration",15,6,0,0,21
1158914,878662,2019-06-06,Assembly,"Assembly Environmental Conservation Committee: Held for Consideration",21,7,0,2,30
1158970,825608,2019-03-19,Assembly,"Assembly Real Property Taxation Committee: Favorable refer to committee Codes",9,0,0,1,10
1159025,797572,2019-02-12,Assembly,"Assembly Transportation Committee: Favorable refer to committee Codes",23,0,0,2,25
1159025,814548,2019-03-05,Assembly,"Assembly Codes Committee: Favorable",22,0,0,0,22
1159037,878277,2019-06-05,Assembly,"Assembly Banks Committee: Favorable refer to committee Codes",29,0,0,2,31
1159037,880148,2019-06-11,Assembly,"Assembly Codes Committee: Favorable refer to committee Rules",22,0,0,0,22
1159037,881365,2019-06-13,Assembly,"Assembly Rules Committee: Favorable",26,0,0,5,31
1159044,877010,2019-06-03,Assembly,"Assembly Social Services Committee: Favorable refer to committee Ways and Means",11,5,0,2,18
1159063,877633,2019-05-14,Senate,"Senate Civil Service and Pensions Committee Vote",6,0,0,1,7
1159063,877634,2019-06-04,Senate,"Senate Floor Vote - Final Passage",62,0,0,0,62
1159063,972915,2020-07-20,Senate,"Senate Civil Service and Pensions Committee Vote",7,0,0,0,7
1159063,973590,2020-07-22,Senate,"Senate Floor Vote - Final Passage",60,0,0,0,60
1159063,973933,2020-07-21,Senate,"Senate Rules Committee Vote",19,0,0,0,19
1159081,861491,2019-05-07,Assembly,"Assembly Codes Committee: Favorable",20,0,0,2,22
1159087,877189,2019-06-04,Assembly,"Assembly Housing Committee: Favorable refer to committee Codes",18,8,0,2,28
1159160,878801,2019-05-29,Senate,"Senate Local Government Committee Vote",7,0,0,0,7
1159160,878802,2019-06-06,Senate,"Senate Floor Vote - Final Passage",58,3,0,1,62
1159160,883358,2019-06-17,Assembly,"Assembly Floor Vote - Final Passage",147,0,0,3,150
1159184,920306,2020-02-11,Assembly,"Assembly Economic Development Committee: Favorable refer to committee Codes",16,7,0,3,26
1159184,934495,2020-02-25,Assembly,"Assembly Codes Committee: Favorable",15,6,0,1,22
1159190,970892,2020-07-13,Assembly,"Assembly Corporations, Authorities And Commissions Committee: Held for Consideration",19,7,0,0,26
1160203,792079,2019-02-04,Assembly,"Assembly Banks Committee: Favorable",18,8,0,5,31
1161348,869344,2019-05-13,Senate,"Senate Racing, Gaming and Wagering Committee Vote",7,0,0,0,7
1161348,869345,2019-05-22,Senate,"Senate Floor Vote - Final Passage",61,0,0,1,62
1161348,884255,2019-06-18,Assembly,"Assembly Floor Vote - Final Passage",144,4,0,2,150
1161355,883387,2019-04-09,Senate,"Senate Cities Committee Vote",7,0,0,0,7
1161355,883388,2019-06-17,Senate,"Senate Floor Vote - Final Passage",62,0,0,0,62
1161355,884443,2019-06-18,Assembly,"Assembly Floor Vote - Final Passage",146,0,0,4,150
1161400,885134,2019-06-19,Senate,"Senate Rules Committee Vote",18,1,0,0,19
1161400,886609,2019-06-19,Senate,"Senate Floor Vote - Final Passage",56,6,0,0,62
1161400,943172,2020-03-03,Senate,"Senate Environmental Conservation Committee Vote",10,1,0,0,11
1161414,880087,2019-03-06,Senate,"Senate Racing, Gaming And Wagering Committee Vote",7,0,0,0,7
1161414,880442,2019-06-11,Senate,"Senate Floor Vote - Final Passage",56,5,0,1,62
1161598,882780,2019-06-17,Senate,"Senate Floor Vote - Final Passage",62,0,0,0,62
1161598,882781,2019-06-17,Senate,"Senate Rules Committee Vote",19,0,0,0,19
1161672,885176,2019-06-18,Senate,"Senate Floor Vote - Final Passage",61,1,0,0,62
1161672,886478,2019-06-18,Senate,"Senate Rules Committee Vote",19,0,0,0,19
1161672,903078,2020-01-14,Senate,"Senate Judiciary Committee Vote",15,0,0,0,15
1161672,904575,2020-01-22,Senate,"Senate Finance Committee Vote",23,0,0,0,23
1161672,942850,2020-03-04,Senate,"Senate Floor Vote - Final Passage",61,1,0,0,62
1161672,972729,2020-07-21,Assembly,"Assembly Floor Vote - Final Passage",140,2,0,3,145
1161769,877278,2019-06-04,Senate,"Senate Floor Vote - Final Passage",62,0,0,0,62
1161769,878036,2019-06-04,Senate,"Senate Rules Committee Vote",19,0,0,0,19
1161769,882896,2019-06-17,Senate,"Senate Floor Vote - Final Passage",62,0,0,0,62
1161769,884903,2019-06-19,Assembly,"Assembly Floor Vote - Final Passage",148,0,0,2,150
1161775,787958,2019-01-28,Senate,"Senate Consumer Protection Committee Vote",5,2,0,0,7
1161819,796412,2019-01-28,Senate,"Senate Racing, Gaming and Wagering Committee Vote",7,0,0,0,7
1161819,796413,2019-02-11,Senate,"Senate Floor Vote - Final Passage",60,1,0,2,63
1161819,825533,2019-03-20,Senate,"Senate Floor Vote - Final Passage",62,0,0,0,62
1161819,875760,2019-05-30,Assembly,"Assembly Floor Vote - Final Passage",139,4,0,7,150
1161863,860727,2019-05-07,Assembly,"Assembly Banks Committee: Favorable refer to committee Codes",18,8,0,5,31
1161863,868526,2019-05-21,Assembly,"Assembly Codes Committee: Favorable",15,6,0,1,22
1161867,878498,2019-06-05,Assembly,"Assembly Education Committee: Favorable refer to committee Rules",29,0,0,2,31
1161867,882485,2019-06-17,Assembly,"Assembly Rules Committee: Favorable",26,0,0,5,31
1161940,971072,2020-07-14,Assembly,"Assembly Correction Committee: Held for Consideration",10,2,0,1,13
1161948,880097,2019-05-30,Senate,"Senate Transportation Committee Vote",15,0,0,0,15
1161948,880447,2019-06-11,Senate,"Senate Floor Vote - Final Passage",61,0,0,1,62
1161948,883155,2019-06-17,Assembly,"Assembly Floor Vote - Final Passage",145,0,0,5,150
1162036,972128,2020-07-17,Assembly,"Assembly Ways And Means Committee: Held for Consideration",22,10,0,2,34
1162059,971572,2020-07-16,Assembly,"Assembly Real Property Taxation Committee: Held for Consideration",7,3,0,0,10
1162080,792540,2019-02-04,Assembly,"Assembly Insurance Committee: Favorable refer to committee Codes",23,0,0,1,24
1162080,796514,2019-02-11,Assembly,"Assembly Codes Committee: Favorable",22,0,0,0,22
1162108,972076,2020-07-17,Assembly,"Assembly Ways And Means Committee: Held for Consideration",22,10,0,2,34
1162157,854780,2019-02-05,Senate,"Senate Education Committee Vote",15,0,0,0,15
1162157,854781,2019-04-29,Senate,"Senate Floor Vote - Final Passage",41,20,0,1,62
1162157,883982,2019-06-18,Assembly,"Assembly Floor Vote - Final Passage",142,4,0,4,150
1162204,971340,2020-07-15,Assembly,"Assembly Labor Committee: Held for Consideration",18,7,0,3,28
1162211,970768,2020-07-13,Assembly,"Assembly Economic Development Committee: Held for Consideration",16,8,0,1,25
1162230,877951,2019-06-05,Senate,"Senate Floor Vote - Final Passage",62,0,0,0,62
1162230,877952,2019-06-05,Senate,"Senate Rules Committee Vote",19,0,0,0,19
1162230,884121,2019-06-18,Assembly,"Assembly Floor Vote - Final Passage",146,0,0,4,150
1162251,787661,2019-01-28,Assembly,"Assembly Judiciary Committee: Favorable refer to committee Codes",21,0,0,0,21
1162251,797269,2019-02-11,Assembly,"Assembly Codes Committee: Favorable",22,0,0,0,22
1162251,863691,2019-05-14,Senate,"Senate Floor Vote - Final Passage",59,0,0,3,62
1162251,864019,2019-05-14,Assembly,"Assembly Floor Vote - Final Passage",141,0,0,9,150
1162255,970886,2020-07-13,Assembly,"Assembly Consumer Affairs And Protection Committee: Held for Consideration",12,3,0,1,16
1162263,860735,2019-05-07,Assembly,"Assembly Banks Committee: Favorable",23,3,0,5,31
1162263,863350,2019-05-13,Assembly,"Assembly Floor Vote - Final Passage",135,6,0,9,150
1162263,868693,2019-05-21,Senate,"Senate Floor Vote - Final Passage",61,0,0,1,62
1162361,882204,2019-06-13,Assembly,"Assembly Codes Committee: Held for Consideration",14,6,0,2,22
1162368,799963,2019-02-12,Assembly,"Assembly Labor Committee: Favorable refer to committee Codes",17,8,0,4,29
1162368,813639,2019-03-05,Assembly,"Assembly Codes Committee: Favorable",16,6,0,0,22
1162425,784883,2019-01-22,Senate,"Senate Rules Committee Vote",18,0,0,1,19
1162425,784884,2019-01-23,Senate,"Senate Floor Vote - Final Passage",60,0,0,3,63
1162425,865093,2019-05-15,Assembly,"Assembly Floor Vote - Final Passage",141,0,0,9,150
1162444,971486,2020-07-15,Assembly,"Assembly Labor Committee: Held for Consideration",18,7,0,3,28
1162471,878151,2019-06-05,Assembly,"Assembly Education Committee: Favorable refer to committee Codes",19,10,0,2,31
1162471,880187,2019-06-11,Assembly,"Assembly Codes Committee: Favorable refer to committee Ways and Means",16,6,0,0,22
1162498,791941,2019-01-22,Senate,"Senate Rules Committee Vote",18,0,0,1,19
1162498,791942,2019-02-04,Senate,"Senate Floor Vote - Final Passage",62,0,0,1,63
1162498,884000,2019-06-17,Assembly,"Assembly Floor Vote - Final Passage",148,0,0,2,150
1162501,797177,2019-01-22,Senate,"Senate Rules Committee Vote",18,0,0,1,19
1162501,797178,2019-02-11,Senate,"Senate Floor Vote - Final Passage",61,0,0,2,63
1162501,812024,2019-02-28,Assembly,"Assembly Floor Vote - Final Passage",138,0,0,12,150
1162516,786849,2019-01-22,Senate,"Senate Rules Committee Vote",18,0,0,1,19
1162516,787475,2019-01-28,Senate,"Senate Floor Vote - Final Passage",63,0,0,0,63
1162516,868222,2019-05-20,Assembly,"Assembly Floor Vote - Final Passage",141,2,0,7,150
1162563,814465,2019-03-05,Assembly,"Assembly Consumer Affairs And Protection Committee: Favorable refer to committee Ways and Means",13,3,0,0,16
1162563,882326,2019-06-14,Assembly,"Assembly Ways And Means Committee: Favorable refer to committee Rules",23,7,0,5,35
1162563,883588,2019-06-18,Assembly,"Assembly Rules Committee: Favorable",23,2,0,6,31
1162588,787015,2019-01-28,Assembly,"Assembly Judiciary Committee: Favorable",15,6,0,0,21
1162588,861689,2019-05-08,Assembly,"Assembly Floor Vote - Final Passage",94,43,0,13,150
1162607,787370,2019-01-22,Senate,"Senate Rules Committee Vote",18,0,0,1,19
1162607,787371,2019-01-28,Senate,"Senate Floor Vote - Final Passage",63,0,0,0,63
1162607,816517,2019-03-06,Assembly,"Assembly Floor Vote - Final Passage",146,0,0,4,150
1162611,868894,2019-05-21,Assembly,"Assembly Economic Development Committee: Favorable",23,1,0,2,26
1162611,874724,2019-05-29,Assembly,"Assembly Floor Vote - Final Passage",140,1,0,9,150
1162611,882126,2019-06-14,Senate,"Senate Floor Vote - Final Passage",62,0,0,0,62
1162654,876055,2019-05-30,Assembly,"Assembly Judiciary Committee: Favorable refer to committee Codes",19,1,0,1,21
1162654,884163,2019-06-18,Assembly,"Assembly Codes Committee: Favorable refer to committee Rules",22,0,0,0,22
1162654,884931,2019-06-19,Assembly,"Assembly Rules Committee: Favorable",27,0,0,4,31
1162654,951928,2020-03-10,Assembly,"Assembly Floor Vote - Final Passage",121,17,0,9,147
1162668,787353,2019-01-22,Senate,"Senate Rules Committee Vote",18,0,0,1,19
1162668,787354,2019-01-28,Senate,"Senate Floor Vote - Final Passage",63,0,0,0,63
1162668,859191,2019-05-01,Senate,"Senate Floor Vote - Final Passage",62,0,0,0,62
1162684,878721,2019-06-06,Assembly,"Assembly Environmental Conservation Committee: Held for Consideration",21,7,0,2,30
1164808,829219,2019-03-26,Senate,"Senate Floor Vote - Final Passage",42,19,0,1,62
1164808,829220,2019-03-26,Assembly,"Assembly Rules Committee: Favorable",24,1,0,6,31
1164808,829221,2019-03-26,Assembly,"Assembly Ways And Means Committee: Favorable refer to committee Rules",26,7,0,2,35
1164808,829643,2019-03-26,Assembly,"Assembly Floor Vote - Final Passage",114,34,0,2,150
1164833,878489,2019-06-04,Assembly,"Assembly Governmental Operations Committee: Favorable refer to committee Ways and Means",10,2,0,2,14
1164833,882047,2019-06-14,Assembly,"Assembly Ways And Means Committee: Favorable refer to committee Rules",24,6,0,5,35
1164833,882443,2019-06-17,Assembly,"Assembly Rules Committee: Favorable",26,0,0,5,31
1164881,832530,2019-03-31,Assembly,"Assembly Rules Committee: Favorable",22,8,0,1,31
1164881,832531,2019-03-31,Assembly,"Assembly Ways And Means Committee: Favorable refer to committee Rules",24,10,0,1,35
1164888,832519,2019-03-31,Senate,"Senate Finance Committee Vote",15,8,0,0,23
1164888,832532,2019-03-31,Assembly,"Assembly Floor Vote - Final Passage",103,45,0,2,150
1164888,832899,2019-03-31,Senate,"Senate Floor Vote - Final Passage",39,22,0,1,62
1164901,860687,2019-05-07,Assembly,"Assembly Environmental Conservation Committee: Favorable refer to committee Ways and Means",28,0,0,2,30
1164901,882332,2019-06-14,Assembly,"Assembly Ways And Means Committee: Favorable refer to committee Rules",30,0,0,5,35
1164901,882501,2019-06-17,Assembly,"Assembly Rules Committee: Favorable",26,0,0,5,31
1164901,884513,2019-06-18,Assembly,"Assembly Floor Vote - Final Passage",141,5,0,4,150
1164901,885608,2019-06-18,Senate,"Senate Floor Vote - Final Passage",62,0,0,0,62
1164948,832516,2019-03-31,Assembly,"Assembly Ways And Means Committee: Favorable refer to committee Rules",21,8,0,6,35
1164948,832517,2019-03-31,Assembly,"Assembly Rules Committee: Favorable",22,7,0,2,31
1164948,832518,2019-03-31,Assembly,"Assembly Rules Committee: Favorable",21,8,0,2,31
1164948,832563,2019-03-31,Senate,"Senate Floor Vote - Final Passage",40,22,0,0,62
1164948,832564,2019-03-31,Assembly,"Assembly Floor Vote - Final Passage",125,23,0,2,150
1164959,832501,2019-03-31,Assembly,"Assembly Rules Committee: Favorable",18,8,0,5,31
1164959,832502,2019-03-31,Assembly,"Assembly Ways And Means Committee: Favorable refer to committee Rules",23,10,0,2,35
1164962,868933,2019-02-27,Senate,"Senate Investigations and Government Operations Committee Vote",7,0,0,0,7
1164962,868934,2019-05-21,Senate,"Senate Floor Vote - Final Passage",61,0,0,1,62
1164962,877779,2019-06-04,Assembly,"Assembly Floor Vote - Final Passage",145,2,0,3,150
1164969,792985,2019-02-04,Senate,"Senate Civil Service and Pensions Committee Vote",7,0,0,0,7
1164969,935699,2020-02-26,Senate,"Senate Civil Service and Pensions Committee Vote",6,1,0,0,7
1164985,832528,2019-03-31,Senate,"Senate Finance Committee Vote",15,8,0,0,23
1164985,832535,2019-04-01,Assembly,"Assembly Floor Vote - Final Passage",43,105,0,2,150
1164985,832691,2019-03-31,Senate,"Senate Floor Vote - Final Passage",40,22,0,0,62
1164999,832718,2019-03-31,Senate,"Senate Floor Vote - Final Passage",40,22,0,0,62
1164999,832719,2019-03-31,Senate,"Senate Finance Committee Vote",15,8,0,0,23
1164999,832720,2019-04-01,Assembly,"Assembly Floor Vote - Final Passage",104,43,0,3,150
1165001,832510,2019-03-31,Senate,"Senate Finance Committee Vote",15,8,0,0,23
1165001,832542,2019-03-31,Assembly,"Assembly Floor Vote - Final Passage",92,56,0,2,150
1165001,832583,2019-03-31,Senate,"Senate Floor Vote - Final Passage",40,22,0,0,62
1165035,832500,2019-03-31,Assembly,"Assembly Ways And Means Committee: Favorable refer to committee Rules",24,9,0,2,35
1165035,832529,2019-03-31,Assembly,"Assembly Rules Committee: Favorable",22,8,0,1,31
1165040,808907,2019-02-04,Senate,"Senate Agriculture Committee Vote",9,0,0,0,9
1165040,808908,2019-02-26,Senate,"Senate Floor Vote - Final Passage",61,0,0,2,63
1165040,905212,2020-01-23,Senate,"Senate Agriculture Committee Vote",9,0,0,0,9
1165040,941803,2020-03-02,Senate,"Senate Floor Vote - Final Passage",61,0,0,1,62
1165040,972600,2020-07-21,Assembly,"Assembly Floor Vote - Final Passage",142,0,0,3,145
1165043,812590,2019-01-28,Senate,"Senate Mental Health and Developmental Disabilities Committee Vote",7,0,0,0,7
1165043,812591,2019-03-04,Senate,"Senate Floor Vote - Final Passage",59,0,0,4,63
1165043,884002,2019-06-18,Assembly,"Assembly Floor Vote - Final Passage",146,0,0,4,150
1165060,832537,2019-03-31,Assembly,"Assembly Rules Committee: Favorable",22,8,0,1,31
1165060,832538,2019-03-31,Assembly,"Assembly Ways And Means Committee: Favorable refer to committee Rules",24,10,0,1,35
1165110,832540,2019-03-31,Senate,"Senate Finance Committee Vote",15,8,0,0,23
1165110,832541,2019-04-01,Assembly,"Assembly Floor Vote - Final Passage",45,101,0,4,150
1165110,832640,2019-03-31,Senate,"Senate Floor Vote - Final Passage",40,22,0,0,62
1165141,832503,2019-03-31,Assembly,"Assembly Rules Committee: Favorable",18,8,0,5,31
1165141,832504,2019-03-31,Assembly,"Assembly Ways And Means Committee: Favorable refer to committee Rules",23,10,0,2,35
1165174,880177,2019-06-11,Senate,"Senate Floor Vote - Final Passage",40,21,0,1,62
1165174,880178,2019-06-11,Senate,"Senate Rules Committee Vote",14,5,0,0,19
1165211,832520,2019-03-31,Assembly,"Assembly Ways And Means Committee: Favorable refer to committee Rules",20,9,0,6,35
1165211,832521,2019-03-31,Assembly,"Assembly Rules Committee: Favorable",21,8,0,2,31
1165211,832522,2019-03-31,Assembly,"Assembly Rules Committee: Favorable",21,8,0,2,31
1165211,832534,2019-03-31,Assembly,"Assembly Floor Vote - Final Passage",111,37,0,2,150
1165211,832565,2019-03-31,Senate,"Senate Floor Vote - Final Passage",40,22,0,0,62
1165218,878648,2019-06-06,Assembly,"Assembly Corporations, Authorities And Commissions Committee: Favorable refer to committee Ways and Means",18,7,0,1,26
1165218,879230,2019-06-06,Assembly,"Assembly Ways And Means Committee: Favorable refer to committee Rules",30,1,0,4,35
1165218,880417,2019-06-11,Assembly,"Assembly Rules Committee: Favorable",25,0,0,6,31
1165224,792552,2019-02-04,Senate,"Senate Civil Service and Pensions Committee Vote",7,0,0,0,7
1165224,935846,2020-02-26,Senate,"Senate Civil Service and Pensions Committee Vote",7,0,0,0,7
1165250,855464,2019-02-11,Senate,"Senate Judiciary Committee Vote",12,3,0,0,15
1165250,855465,2019-04-30,Senate,"Senate Floor Vote - Final Passage",45,17,0,0,62
1165250,857073,2019-04-30,Assembly,"Assembly Floor Vote - Final Passage",110,34,0,6,150
1165265,787365,2019-01-28,Assembly,"Assembly Codes Committee: Favorable",22,0,0,0,22
1165279,832523,2019-03-31,Senate,"Senate Finance Committee Vote",15,8,0,0,23
1165279,832533,2019-04-01,Assembly,"Assembly Floor Vote - Final Passage",102,45,0,3,150
1165279,832654,2019-03-31,Senate,"Senate Floor Vote - Final Passage",40,22,0,0,62
1165313,943182,2020-03-03,Assembly,"Assembly Mental Health Committee: Favorable refer to committee Ways and Means",12,0,0,1,13
1165351,869427,2019-05-22,Assembly,"Assembly Election Law Committee: Favorable",10,4,0,2,16
1165366,832507,2019-03-31,Assembly,"Assembly Rules Committee: Favorable",18,8,0,5,31
1165366,832508,2019-03-31,Assembly,"Assembly Ways And Means Committee: Favorable refer to committee Rules",23,10,0,2,35
1165366,832549,2019-03-31,Assembly,"Assembly Floor Vote - Final Passage",100,48,0,2,150
1165366,832940,2019-03-31,Senate,"Senate Floor Vote - Final Passage",40,22,0,0,62
1165370,885327,2019-06-18,Senate,"Senate Floor Vote - Final Passage",61,1,0,0,62
1165370,886577,2019-06-18,Senate,"Senate Rules Committee Vote",19,0,0,0,19
1165370,904854,2020-01-22,Senate,"Senate Finance Committee Vote",23,0,0,0,23
1165374,832525,2019-03-31,Assembly,"Assembly Rules Committee: Favorable",22,8,0,1,31
1165374,832526,2019-03-31,Assembly,"Assembly Rules Committee: Favorable",22,8,0,1,31
1165374,832527,2019-03-31,Assembly,"Assembly Ways And Means Committee: Favorable refer to committee Rules",23,11,0,1,35
1165385,877058,2019-06-03,Assembly,"Assembly Consumer Affairs And Protection Committee: Favorable refer to committee Rules",15,0,0,1,16
1165385,877979,2019-06-05,Assembly,"Assembly Rules Committee: Favorable",27,0,0,4,31
1165423,797559,2019-02-12,Assembly,"Assembly Transportation Committee: Favorable",23,0,0,2,25
1165423,810981,2019-02-27,Assembly,"Assembly Floor Vote - Final Passage",143,0,0,7,150
1165424,870077,2019-05-21,Assembly,"Assembly Corporations, Authorities And Commissions Committee: Favorable",25,0,0,1,26
1165429,877891,2019-06-05,Assembly,"Assembly Small Business Committee: Favorable refer to committee Ways and Means",14,2,0,1,17
1165434,792538,2019-02-04,Assembly,"Assembly Health Committee: Favorable refer to committee Ways and Means",25,0,0,1,26
1165434,864849,2019-05-14,Assembly,"Assembly Ways And Means Committee: Favorable",32,0,0,3,35
1165438,820789,2019-03-12,Assembly,"Assembly Environmental Conservation Committee: Favorable refer to committee Ways and Means",29,0,0,1,30
1165438,864837,2019-05-14,Assembly,"Assembly Ways And Means Committee: Favorable",32,0,0,3,35
1165438,868151,2019-05-20,Assembly,"Assembly Floor Vote - Final Passage",143,0,0,7,150
1165438,874336,2019-05-29,Senate,"Senate Floor Vote - Final Passage",60,0,0,2,62
1165442,876613,2019-06-03,Senate,"Senate Floor Vote - Final Passage",44,18,0,0,62
1165442,877333,2019-06-03,Senate,"Senate Rules Committee Vote",16,3,0,0,19
1165442,913918,2020-02-04,Senate,"Senate Banks Committee Vote",6,4,0,1,11
1165442,972463,2020-07-21,Senate,"Senate Floor Vote - Final Passage",41,19,0,0,60
1165494,971440,2020-07-15,Assembly,"Assembly Racing And Wagering Committee: Held for Consideration",8,3,0,0,11
1165514,808537,2019-02-26,Senate,"Senate Civil Service and Pensions Committee Vote",7,0,0,0,7
1165520,971812,2020-07-16,Assembly,"Assembly Local Governments Committee: Held for Consideration",14,5,0,1,20
1165527,881665,2019-06-13,Assembly,"Assembly Health Committee: Favorable refer to committee Codes",14,12,0,0,26
1165527,883784,2019-06-18,Assembly,"Assembly Codes Committee: Favorable refer to committee Rules",14,8,0,0,22
1165527,886189,2019-06-20,Assembly,"Assembly Rules Committee: Favorable",27,0,0,4,31
1165539,857494,2019-04-30,Assembly,"Assembly Racing And Wagering Committee: Favorable",8,3,0,0,11
1165539,883404,2019-06-17,Assembly,"Assembly Floor Vote - Final Passage",111,34,0,5,150
1165539,883927,2019-06-18,Senate,"Senate Floor Vote - Final Passage",46,16,0,0,62
1165542,877271,2019-06-04,Senate,"Senate Floor Vote - Final Passage",41,21,0,0,62
1165542,877797,2019-06-04,Senate,"Senate Rules Committee Vote",14,5,0,0,19
1165542,950220,2020-03-10,Senate,"Senate Banks Committee Vote",7,4,0,0,11
1165544,825358,2019-03-19,Assembly,"Assembly Governmental Employees Committee: Favorable refer to committee Ways and Means",14,0,0,0,14
1165544,877737,2019-06-04,Assembly,"Assembly Ways And Means Committee: Favorable refer to committee Rules",32,1,0,2,35
1165544,882428,2019-06-17,Assembly,"Assembly Rules Committee: Favorable",26,0,0,5,31
1165544,884257,2019-06-18,Assembly,"Assembly Floor Vote - Final Passage",144,2,0,4,150
1165552,830298,2019-03-19,Senate,"Senate Environmental Conservation Committee Vote",10,1,0,0,11
1165552,830299,2019-03-27,Senate,"Senate Floor Vote - Final Passage",48,13,0,1,62
1165552,854443,2019-04-29,Senate,"Senate Floor Vote - Final Passage",48,13,0,1,62
1165552,883135,2019-06-17,Senate,"Senate Floor Vote - Final Passage",47,15,0,0,62
1165552,884124,2019-06-18,Assembly,"Assembly Floor Vote - Final Passage",139,9,0,2,150
1165555,857197,2019-04-30,Assembly,"Assembly Judiciary Committee: Favorable refer to committee Ways and Means",18,1,0,2,21
1165555,879245,2019-06-06,Assembly,"Assembly Ways And Means Committee: Favorable refer to committee Rules",30,1,0,4,35
1165555,881356,2019-06-13,Assembly,"Assembly Rules Committee: Favorable",26,0,0,5,31
1165555,883112,2019-06-17,Assembly,"Assembly Floor Vote - Final Passage",113,32,0,5,150
1165577,869853,2019-03-12,Senate,"Senate Investigations and Government Operations Committee Vote",7,0,0,0,7
1165577,869854,2019-05-22,Senate,"Senate Floor Vote - Final Passage",61,0,0,1,62
1165577,884318,2019-06-18,Assembly,"Assembly Floor Vote - Final Passage",145,1,0,4,150
1165588,824310,2019-03-19,Assembly,"Assembly Banks Committee: Favorable refer to committee Codes",29,0,0,2,31
1165597,816495,2019-03-06,Assembly,"Assembly Health Committee: Favorable refer to committee Codes",25,0,0,1,26
1165597,819207,2019-03-12,Assembly,"Assembly Codes Committee: Favorable",21,0,0,1,22
1165601,921263,2020-02-11,Assembly,"Assembly Social Services Committee: Held for Consideration",12,5,0,0,17
1165609,970944,2020-07-13,Assembly,"Assembly Consumer Affairs And Protection Committee: Favorable refer to committee Rules",15,0,0,1,16
1165616,864481,2019-05-14,Senate,"Senate Committee Vote",7,0,0,0,7
1165618,971599,2020-07-16,Assembly,"Assembly Governmental Operations Committee: Favorable refer to committee Rules",14,0,0,0,14
1165635,787140,2019-01-28,Assembly,"Assembly Correction Committee: Favorable",11,0,0,2,13
1165635,797516,2019-02-11,Assembly,"Assembly Floor Vote - Final Passage",120,23,0,7,150
1165635,862247,2019-05-08,Senate,"Senate Floor Vote - Final Passage",56,5,0,1,62
1165636,793490,2019-02-05,Assembly,"Assembly Environmental Conservation Committee: Favorable refer to committee Ways and Means",28,0,0,2,30
1165636,868962,2019-05-21,Assembly,"Assembly Ways And Means Committee: Favorable",31,1,0,3,35
1165636,875703,2019-05-30,Assembly,"Assembly Floor Vote - Final Passage",140,3,0,7,150
1165636,884166,2019-06-18,Senate,"Senate Floor Vote - Final Passage",62,0,0,0,62
1165645,881885,2019-03-26,Senate,"Senate Rules Committee Vote",13,6,0,0,19
1165645,881886,2019-06-13,Senate,"Senate Floor Vote - Final Passage",43,19,0,0,62
1165647,878515,2019-06-05,Assembly,"Assembly Transportation Committee: Favorable refer to committee Ways and Means",26,0,0,0,26
1165647,879352,2019-06-06,Assembly,"Assembly Ways And Means Committee: Favorable refer to committee Rules",31,0,0,4,35
1165647,880502,2019-06-11,Assembly,"Assembly Rules Committee: Favorable",25,0,0,6,31
1165647,881324,2019-06-12,Assembly,"Assembly Floor Vote - Final Passage",146,1,0,3,150
1165651,792532,2019-02-05,Assembly,"Assembly Environmental Conservation Committee: Favorable refer to committee Judiciary",22,6,0,2,30
1165651,838353,2019-04-08,Assembly,"Assembly Judiciary Committee: Favorable",15,5,0,1,21
1165652,971221,2020-07-14,Assembly,"Assembly Correction Committee: Favorable refer to committee Ways and Means",12,0,0,1,13
1165652,973264,2020-07-23,Assembly,"Assembly Rules Committee: Favorable",28,0,0,2,30
1165652,973265,2020-07-23,Assembly,"Assembly Ways And Means Committee: Favorable refer to committee Rules",30,3,0,1,34
1165652,973583,2020-07-23,Assembly,"Assembly Floor Vote - Final Passage",136,5,0,4,145
1165675,882607,2019-06-17,Assembly,"Assembly Rules Committee: Favorable",24,1,0,6,31
1165675,882608,2019-06-17,Assembly,"Assembly Ways And Means Committee: Favorable refer to committee Rules",27,6,0,2,35
1165675,884070,2019-06-18,Assembly,"Assembly Floor Vote - Final Passage",115,33,0,2,150
1165675,886338,2019-06-19,Senate,"Senate Floor Vote - Final Passage",49,13,0,0,62
1165679,970800,2020-07-13,Assembly,"Assembly Health Committee: Favorable refer to committee Rules",24,0,0,2,26
1165688,971970,2020-07-17,Assembly,"Assembly Ways And Means Committee: Held for Consideration",22,10,0,2,34
1165704,972081,2020-07-17,Assembly,"Assembly Ways And Means Committee: Held for Consideration",22,10,0,2,34
1165708,868218,2019-05-21,Assembly,"Assembly Transportation Committee: Favorable refer to committee Codes",25,0,0,0,25
1165708,874987,2019-05-30,Assembly,"Assembly Codes Committee: Favorable",19,0,0,3,22
1165708,877399,2019-06-03,Assembly,"Assembly Floor Vote - Final Passage",142,0,0,8,150
1165714,972046,2020-07-17,Assembly,"Assembly Codes Committee: Held for Consideration",15,6,0,1,22
1165729,811166,2019-02-28,Assembly,"Assembly Correction Committee: Favorable",9,3,0,1,13
1165735,882639,2019-06-17,Assembly,"Assembly Real Property Taxation Committee: Favorable refer to committee Ways and Means",10,0,0,0,10
1165735,883503,2019-06-18,Assembly,"Assembly Rules Committee: Favorable",25,0,0,6,31
1165735,883504,2019-06-18,Assembly,"Assembly Ways And Means Committee: Favorable refer to committee Rules",33,0,0,2,35
1165740,820821,2019-03-12,Assembly,"Assembly Election Law Committee: Favorable",15,0,0,1,16
1165740,824054,2019-03-18,Assembly,"Assembly Floor Vote - Final Passage",143,0,0,7,150
1165740,881743,2019-06-13,Senate,"Senate Floor Vote - Final Passage",40,22,0,0,62
1165745,868963,2019-05-21,Assembly,"Assembly Ways And Means Committee: Favorable refer to committee Codes",22,10,0,3,35
1165745,877367,2019-06-04,Assembly,"Assembly Codes Committee: Favorable refer to committee Rules",19,3,0,0,22
1165745,880475,2019-06-11,Assembly,"Assembly Rules Committee: Favorable",23,2,0,6,31
1165746,825544,2019-02-27,Senate,"Senate Banks Committee Vote",8,3,0,0,11
1165746,825545,2019-03-20,Senate,"Senate Floor Vote - Final Passage",46,16,0,0,62
1165746,903261,2020-01-15,Senate,"Senate Banks Committee Vote",7,3,0,0,10
1165746,972389,2020-07-21,Senate,"Senate Floor Vote - Final Passage",47,13,0,0,60
1165753,971341,2020-07-15,Assembly,"Assembly Labor Committee: Favorable refer to committee Rules",22,3,0,3,28
1165753,972158,2020-07-20,Assembly,"Assembly Rules Committee: Favorable",20,7,0,3,30
1165753,972544,2020-07-21,Assembly,"Assembly Floor Vote - Final Passage",108,34,0,3,145
1165756,868029,2019-05-21,Assembly,"Assembly Insurance Committee: Favorable refer to committee Codes",23,0,0,1,24
1165756,875003,2019-05-30,Assembly,"Assembly Codes Committee: Favorable",19,0,0,3,22
1165756,878054,2019-06-04,Assembly,"Assembly Floor Vote - Final Passage",147,0,0,3,150
1165765,970887,2020-07-13,Assembly,"Assembly Consumer Affairs And Protection Committee: Favorable refer to committee Codes",15,0,0,1,16
1165765,971733,2020-07-17,Assembly,"Assembly Codes Committee: Favorable refer to committee Rules",21,0,0,1,22
1165773,877055,2019-06-03,Assembly,"Assembly Consumer Affairs And Protection Committee: Favorable refer to committee Ways and Means",11,4,0,1,16
1165774,841114,2019-04-09,Senate,"Senate Crime Victims, Crime and Correction Committee Vote",5,2,0,0,7
1165778,875607,2019-05-30,Assembly,"Assembly Ways And Means Committee: Favorable",25,6,0,4,35
1165778,877094,2019-06-03,Assembly,"Assembly Floor Vote - Final Passage",98,44,0,8,150
1165778,883903,2019-06-18,Senate,"Senate Floor Vote - Final Passage",48,14,0,0,62
1165788,838849,2019-04-09,Assembly,"Assembly Environmental Conservation Committee: Favorable",29,0,0,1,30
1165788,855559,2019-04-30,Senate,"Senate Floor Vote - Final Passage",58,4,0,0,62
1165788,857249,2019-04-30,Assembly,"Assembly Floor Vote - Final Passage",143,1,0,6,150
1165792,879242,2019-06-06,Assembly,"Assembly Agriculture Committee: Favorable refer to committee Ways and Means",20,0,0,1,21
1165792,884317,2019-06-18,Assembly,"Assembly Ways And Means Committee: Favorable refer to committee Rules",33,0,0,2,35
1165792,884956,2019-06-19,Assembly,"Assembly Rules Committee: Favorable",27,0,0,4,31
1165818,874939,2019-05-30,Assembly,"Assembly Codes Committee: Favorable",15,4,0,3,22
1165818,972333,2020-07-20,Assembly,"Assembly Floor Vote - Final Passage",97,44,0,4,145
1165818,973559,2020-07-22,Senate,"Senate Floor Vote - Final Passage",42,18,0,0,60
1165822,857135,2019-04-30,Assembly,"Assembly Children And Families Committee: Favorable",14,0,0,2,16
1165833,970869,2020-07-13,Assembly,"Assembly Consumer Affairs And Protection Committee: Favorable refer to committee Codes",12,3,0,1,16
1165833,971758,2020-07-17,Assembly,"Assembly Codes Committee: Favorable refer to committee Rules",15,6,0,1,22
1165885,921240,2020-02-11,Senate,"Senate Health Committee Vote",15,0,0,0,15
1165887,864741,2019-05-14,Assembly,"Assembly Mental Health Committee: Favorable refer to committee Codes",12,0,0,1,13
1165891,950513,2020-03-10,Assembly,"Assembly Transportation Committee: Held for Consideration",16,9,0,0,25
1165896,797577,2019-02-12,Assembly,"Assembly Transportation Committee: Favorable refer to committee Codes",23,0,0,2,25
1165911,876579,2019-05-22,Senate,"Senate Energy and Telecommunications Committee Vote",8,1,0,0,9
1165911,877013,2019-06-03,Senate,"Senate Floor Vote - Final Passage",46,16,0,0,62
1165911,904552,2020-01-22,Senate,"Senate Energy and Telecommunications Committee Vote",6,3,0,0,9
1165946,829767,2019-03-26,Assembly,"Assembly Economic Development Committee: Favorable",24,0,0,2,26
1165952,971716,2020-07-17,Assembly,"Assembly Ways And Means Committee: Held for Consideration",22,10,0,2,34
1165957,863854,2019-03-05,Senate,"Senate Finance Committee Vote",21,0,0,2,23
1165957,863855,2019-05-14,Senate,"Senate Floor Vote - Final Passage",59,0,0,3,62
1165957,884234,2019-06-18,Assembly,"Assembly Floor Vote - Final Passage",146,0,0,4,150
1165961,972130,2020-07-17,Assembly,"Assembly Ways And Means Committee: Held for Consideration",32,0,0,2,34
1165985,797480,2019-02-12,Assembly,"Assembly Corporations, Authorities And Commissions Committee: Favorable refer to committee Ways and Means",21,3,0,2,26
1166006,971630,2020-07-16,Assembly,"Assembly Governmental Operations Committee: Held for Consideration",10,4,0,0,14
1166014,971176,2020-07-14,Assembly,"Assembly Correction Committee: Held for Consideration",10,2,0,1,13
1166016,868198,2019-05-21,Assembly,"Assembly Governmental Operations Committee: Favorable",14,0,0,0,14
1166017,880602,2019-06-11,Assembly,"Assembly Ways And Means Committee: Favorable refer to committee Rules",33,0,0,2,35
1166023,882199,2019-06-13,Assembly,"Assembly Codes Committee: Held for Consideration",14,6,0,2,22
1166059,876792,2019-06-03,Assembly,"Assembly Consumer Affairs And Protection Committee: Favorable refer to committee Rules",15,0,0,1,16
1166059,882452,2019-06-17,Assembly,"Assembly Rules Committee: Favorable",26,0,0,5,31
1166093,792545,2019-02-04,Assembly,"Assembly Health Committee: Favorable refer to committee Codes",25,0,0,1,26
1166093,840716,2019-04-09,Assembly,"Assembly Codes Committee: Favorable refer to committee Ways and Means",22,0,0,0,22
1166114,864860,2019-05-14,Assembly,"Assembly Ways And Means Committee: Favorable",28,4,0,3,35
1166114,867871,2019-05-20,Assembly,"Assembly Floor Vote - Final Passage",105,39,0,6,150
1166114,882112,2019-06-14,Senate,"Senate Floor Vote - Final Passage",53,9,0,0,62
1166141,883378,2019-06-18,Assembly,"Assembly Education Committee: Favorable refer to committee Rules",16,13,0,2,31
1166142,877586,2019-06-04,Assembly,"Assembly Labor Committee: Favorable refer to committee Codes",26,2,0,1,29
1166142,880376,2019-06-11,Assembly,"Assembly Codes Committee: Favorable refer to committee Rules",22,0,0,0,22
1166142,881355,2019-06-13,Assembly,"Assembly Rules Committee: Favorable",26,0,0,5,31
1166142,883978,2019-06-18,Assembly,"Assembly Floor Vote - Final Passage",124,24,0,2,150
1166142,886783,2019-06-20,Senate,"Senate Floor Vote - Final Passage",49,13,0,0,62
1166158,816141,2019-02-27,Senate,"Senate Banks Committee Vote",10,1,0,0,11
1166158,816142,2019-03-07,Senate,"Senate Floor Vote - Final Passage",58,0,0,5,63
1166158,882005,2019-06-14,Senate,"Senate Floor Vote - Final Passage",62,0,0,0,62
1166158,883416,2019-06-17,Assembly,"Assembly Floor Vote - Final Passage",145,0,0,5,150
1166163,864841,2019-05-14,Assembly,"Assembly Labor Committee: Favorable refer to committee Ways and Means",26,0,0,3,29
1166163,874760,2019-05-30,Assembly,"Assembly Ways And Means Committee: Favorable",31,0,0,4,35
1166163,877442,2019-06-03,Assembly,"Assembly Floor Vote - Final Passage",142,0,0,8,150
1166163,878925,2019-06-06,Senate,"Senate Floor Vote - Final Passage",61,0,0,1,62
1166168,838334,2019-04-08,Assembly,"Assembly Judiciary Committee: Favorable refer to committee Codes",15,5,0,1,21
1166168,880261,2019-06-11,Assembly,"Assembly Codes Committee: Favorable refer to committee Rules",15,7,0,0,22
1166168,881343,2019-06-13,Assembly,"Assembly Rules Committee: Favorable",26,0,0,5,31
1166175,882321,2019-06-14,Assembly,"Assembly Ways And Means Committee: Favorable refer to committee Rules",24,6,0,5,35
1166175,882506,2019-06-17,Assembly,"Assembly Rules Committee: Favorable",26,0,0,5,31
1166175,884512,2019-06-18,Assembly,"Assembly Floor Vote - Final Passage",116,32,0,2,150
1166175,886711,2019-06-19,Senate,"Senate Floor Vote - Final Passage",46,16,0,0,62
1166186,811107,2019-02-27,Assembly,"Assembly Small Business Committee: Favorable",17,0,0,0,17
1166186,813480,2019-03-04,Assembly,"Assembly Floor Vote - Final Passage",143,0,0,7,150
1166186,886712,2019-06-19,Senate,"Senate Floor Vote - Final Passage",62,0,0,0,62
1166197,811119,2019-02-27,Assembly,"Assembly Mental Health Committee: Favorable refer to committee Ways and Means",13,0,0,0,13
1166203,787456,2019-01-28,Assembly,"Assembly Election Law Committee: Favorable refer to committee Ways and Means",13,2,0,1,16
1166206,792554,2019-02-05,Assembly,"Assembly Economic Development Committee: Favorable",24,1,0,1,26
1166206,809644,2019-02-26,Assembly,"Assembly Floor Vote - Final Passage",133,3,0,14,150
1166206,825022,2019-03-19,Senate,"Senate Floor Vote - Final Passage",61,0,0,1,62
1166217,840801,2019-04-09,Assembly,"Assembly Codes Committee: Favorable",13,9,0,0,22
1166217,863541,2019-05-13,Assembly,"Assembly Floor Vote - Final Passage",93,48,0,9,150
1166217,884486,2019-06-18,Senate,"Senate Floor Vote - Final Passage",44,18,0,0,62
1166225,883567,2019-06-17,Assembly,"Assembly Education Committee: Favorable refer to committee Rules",27,0,0,4,31
1166225,883568,2019-06-18,Assembly,"Assembly Rules Committee: Favorable",25,0,0,6,31
1166228,878462,2019-06-04,Assembly,"Assembly Mental Health Committee: Favorable refer to committee Ways and Means",12,0,0,1,13
1166277,814045,2019-03-05,Assembly,"Assembly Social Services Committee: Favorable refer to committee Ways and Means",13,5,0,0,18
1166310,799815,2019-02-12,Assembly,"Assembly Aging Committee: Favorable refer to committee Ways and Means",25,0,0,5,30
1166310,864872,2019-05-14,Assembly,"Assembly Ways And Means Committee: Favorable",32,0,0,3,35
1166314,970762,2020-07-13,Assembly,"Assembly Health Committee: Favorable refer to committee Codes",18,6,0,2,26
1166315,933944,2020-02-25,Assembly,"Assembly Energy Committee: Favorable refer to committee Codes",12,4,0,0,16
1166337,920230,2020-02-11,Assembly,"Assembly Economic Development Committee: Favorable",16,7,0,3,26
1166348,881279,2019-06-12,Assembly,"Assembly Ways And Means Committee: Favorable refer to committee Rules",30,0,0,5,35
1166348,881280,2019-06-12,Assembly,"Assembly Real Property Taxation Committee: Favorable refer to committee Ways and Means",9,0,0,1,10
1166348,881370,2019-06-13,Assembly,"Assembly Rules Committee: Favorable",26,0,0,5,31
1166353,971122,2020-07-14,Assembly,"Assembly Judiciary Committee: Held for Consideration",15,6,0,0,21
1166363,819487,2019-03-12,Assembly,"Assembly Codes Committee: Favorable",20,1,0,1,22
1166379,830087,2019-03-26,Assembly,"Assembly Housing Committee: Favorable refer to committee Codes",27,0,0,1,28
1166379,838966,2019-04-09,Assembly,"Assembly Codes Committee: Favorable",22,0,0,0,22
1166379,857353,2019-04-29,Assembly,"Assembly Floor Vote - Final Passage",144,0,0,6,150
1166379,874496,2019-05-29,Senate,"Senate Floor Vote - Final Passage",60,0,0,2,62
1166381,902666,2020-01-14,Assembly,"Assembly Judiciary Committee: Favorable",19,2,0,0,21
1166381,914291,2020-01-14,Assembly,"Assembly Judiciary Committee: Favorable",19,2,0,0,21
1166394,864180,2019-03-26,Senate,"Senate Rules Committee Vote",19,0,0,0,19
1166394,864181,2019-05-14,Senate,"Senate Floor Vote - Final Passage",59,0,0,3,62
1166410,809138,2019-01-28,Senate,"Senate Veterans, Homeland Security and Military Affairs Committee Vote",9,0,0,0,9
1166410,809139,2019-02-26,Senate,"Senate Floor Vote - Final Passage",61,0,0,2,63
1166410,903152,2020-01-14,Senate,"Senate Veterans, Homeland Security and Military Affairs Committee Vote",8,0,0,1,9
1166410,951213,2020-03-11,Senate,"Senate Floor Vote - Final Passage",58,0,0,4,62
1166434,814515,2019-03-05,Assembly,"Assembly Energy Committee: Favorable",14,2,0,1,17
1166439,877177,2019-06-03,Assembly,"Assembly Consumer Affairs And Protection Committee: Favorable refer to committee Codes",15,0,0,1,16
1166439,880240,2019-06-11,Assembly,"Assembly Codes Committee: Favorable refer to committee Rules",22,0,0,0,22
1166439,884832,2019-06-19,Assembly,"Assembly Rules Committee: Favorable",27,0,0,4,31
1166504,971501,2020-07-15,Assembly,"Assembly Labor Committee: Held for Consideration",18,7,0,3,28
1166524,971208,2020-07-14,Assembly,"Assembly Judiciary Committee: Held for Consideration",15,6,0,0,21
1166529,787412,2019-01-28,Assembly,"Assembly Correction Committee: Favorable refer to committee Codes",9,2,0,2,13
1166529,796654,2019-02-11,Assembly,"Assembly Codes Committee: Favorable refer to committee Ways and Means",16,6,0,0,22
1166529,868976,2019-05-21,Assembly,"Assembly Ways And Means Committee: Favorable",22,10,0,3,35
1166611,876816,2019-06-03,Assembly,"Assembly Consumer Affairs And Protection Committee: Favorable refer to committee Rules",15,0,0,1,16
1166611,880529,2019-06-11,Assembly,"Assembly Rules Committee: Favorable",24,1,0,6,31
1166616,838352,2019-04-08,Assembly,"Assembly Judiciary Committee: Favorable refer to committee Codes",15,5,0,1,21
1166616,856988,2019-04-30,Assembly,"Assembly Codes Committee: Favorable",18,2,0,2,22
1166622,816306,2019-03-06,Assembly,"Assembly Corporations, Authorities And Commissions Committee: Favorable refer to committee Ways and Means",17,7,0,2,26
1166622,863856,2019-05-14,Assembly,"Assembly Ways And Means Committee: Favorable",24,8,0,3,35
1166622,877811,2019-06-04,Assembly,"Assembly Floor Vote - Final Passage",109,37,0,4,150
1166673,881137,2019-06-13,Assembly,"Assembly Rules Committee: Favorable",20,8,0,3,31
1166673,881138,2019-06-13,Assembly,"Assembly Health Committee: Favorable refer to committee Rules",14,12,0,0,26
1166673,882037,2019-06-13,Senate,"Senate Floor Vote - Final Passage",36,26,0,0,62
1166673,882038,2019-06-13,Assembly,"Assembly Floor Vote - Final Passage",84,61,0,5,150
1166758,970778,2020-07-13,Assembly,"Assembly Mental Health Committee: Held for Consideration",9,4,0,0,13
1166787,868090,2019-05-21,Assembly,"Assembly Transportation Committee: Favorable refer to committee Codes",25,0,0,0,25
1166843,856992,2019-04-30,Assembly,"Assembly Social Services Committee: Favorable refer to committee Ways and Means",13,5,0,0,18
1166843,869037,2019-05-21,Assembly,"Assembly Ways And Means Committee: Favorable",21,11,0,3,35
1166874,787116,2019-01-28,Assembly,"Assembly Judiciary Committee: Favorable refer to committee Codes",16,5,0,0,21
1166893,877516,2019-06-04,Assembly,"Assembly Labor Committee: Favorable refer to committee Codes",27,1,0,1,29
1166893,880221,2019-06-11,Assembly,"Assembly Codes Committee: Favorable refer to committee Rules",21,1,0,0,22
1166893,881346,2019-06-13,Assembly,"Assembly Rules Committee: Favorable",26,0,0,5,31
1166893,972335,2020-07-20,Assembly,"Assembly Floor Vote - Final Passage",120,21,0,4,145
1166927,876049,2019-05-30,Assembly,"Assembly Social Services Committee: Favorable refer to committee Ways and Means",16,0,0,2,18
1166952,876040,2019-05-30,Assembly,"Assembly Judiciary Committee: Favorable",19,1,0,1,21
1166959,870080,2019-05-21,Assembly,"Assembly Governmental Operations Committee: Favorable refer to committee Ways and Means",10,4,0,0,14
1166959,882016,2019-06-14,Assembly,"Assembly Ways And Means Committee: Favorable refer to committee Rules",22,8,0,5,35
1166965,840759,2019-04-09,Assembly,"Assembly Transportation Committee: Favorable refer to committee Codes",23,0,0,2,25
1166971,884638,2019-06-19,Assembly,"Assembly Codes Committee: Favorable refer to committee Rules",16,6,0,0,22
1166971,885271,2019-06-20,Assembly,"Assembly Rules Committee: Favorable",27,0,0,4,31
1166976,877057,2019-06-03,Assembly,"Assembly Higher Education Committee: Favorable refer to committee Ways and Means",24,1,0,1,26
1166976,885449,2019-06-19,Assembly,"Assembly Rules Committee: Favorable",28,0,0,3,31
1166976,885450,2019-06-19,Assembly,"Assembly Ways And Means Committee: Favorable refer to committee Rules",33,0,0,2,35
1166996,868957,2019-05-21,Assembly,"Assembly Ways And Means Committee: Favorable",30,2,0,3,35
1166996,875752,2019-05-30,Assembly,"Assembly Floor Vote - Final Passage",133,10,0,7,150
1166996,886377,2019-06-19,Senate,"Senate Floor Vote - Final Passage",61,1,0,0,62
1167084,787439,2019-01-28,Assembly,"Assembly Correction Committee: Favorable refer to committee Codes",9,2,0,2,13
1167084,796637,2019-02-11,Assembly,"Assembly Codes Committee: Favorable refer to committee Ways and Means",16,6,0,0,22
1167084,864857,2019-05-14,Assembly,"Assembly Ways And Means Committee: Favorable",22,10,0,3,35
1167097,902657,2020-01-14,Assembly,"Assembly Insurance Committee: Favorable refer to committee Codes",15,6,0,1,22
1167097,906910,2020-01-28,Assembly,"Assembly Codes Committee: Favorable",15,6,0,1,22
1167131,875600,2019-05-29,Assembly,"Assembly Environmental Conservation Committee: Favorable refer to committee Ways and Means",29,0,0,1,30
1167131,875601,2019-05-30,Assembly,"Assembly Ways And Means Committee: Favorable",31,0,0,4,35
1167131,877765,2019-06-04,Assembly,"Assembly Floor Vote - Final Passage",147,0,0,3,150
1167148,838367,2019-04-08,Assembly,"Assembly Judiciary Committee: Favorable refer to committee Codes",19,1,0,1,21
1167148,857077,2019-04-30,Assembly,"Assembly Codes Committee: Favorable",18,2,0,2,22
1167193,970889,2020-07-13,Assembly,"Assembly Consumer Affairs And Protection Committee: Favorable refer to committee Rules",15,0,0,1,16
1167199,874717,2019-05-30,Assembly,"Assembly Consumer Affairs And Protection Committee: Favorable refer to committee Codes",15,0,0,1,16
1167199,881400,2019-06-13,Assembly,"Assembly Codes Committee: Favorable refer to committee Rules",19,1,0,2,22
1167199,882476,2019-06-17,Assembly,"Assembly Rules Committee: Favorable",24,2,0,5,31
1167206,792537,2019-02-05,Assembly,"Assembly Veterans' Affairs Committee: Favorable",17,0,0,2,19
1167206,809620,2019-02-26,Assembly,"Assembly Floor Vote - Final Passage",136,0,0,14,150
1167206,882301,2019-06-14,Senate,"Senate Floor Vote - Final Passage",62,0,0,0,62
1167225,840769,2019-04-09,Assembly,"Assembly Higher Education Committee: Favorable",26,0,0,0,26
1167225,857525,2019-04-29,Assembly,"Assembly Floor Vote - Final Passage",142,2,0,6,150
1167238,857561,2019-04-30,Assembly,"Assembly Health Committee: Favorable refer to committee Codes",22,3,0,1,26
1167238,859859,2019-05-07,Assembly,"Assembly Codes Committee: Favorable refer to committee Ways and Means",19,1,0,2,22
1167251,972106,2020-07-17,Assembly,"Assembly Codes Committee: Held for Consideration",15,6,0,1,22
1167272,792664,2019-02-05,Assembly,"Assembly Consumer Affairs And Protection Committee: Favorable refer to committee Codes",15,0,0,1,16
1167272,796829,2019-02-11,Assembly,"Assembly Codes Committee: Favorable",22,0,0,0,22
1167272,810892,2019-02-27,Assembly,"Assembly Floor Vote - Final Passage",143,0,0,7,150
1167272,886682,2019-06-19,Senate,"Senate Floor Vote - Final Passage",62,0,0,0,62
1167302,798093,2019-02-12,Assembly,"Assembly Corporations, Authorities And Commissions Committee: Favorable refer to committee Ways and Means",17,7,0,2,26
1167309,839471,2019-04-09,Assembly,"Assembly Codes Committee: Favorable",15,7,0,0,22
1167309,839472,2019-04-09,Assembly,"Assembly Environmental Conservation Committee: Favorable refer to committee Codes",21,8,0,1,30
1167322,816299,2019-03-06,Assembly,"Assembly Corporations, Authorities And Commissions Committee: Favorable refer to committee Ways and Means",23,1,0,2,26
1167322,875612,2019-05-30,Assembly,"Assembly Ways And Means Committee: Favorable",31,0,0,4,35
1168084,885770,2019-06-18,Senate,"Senate Floor Vote - Final Passage",62,0,0,0,62
1168084,886313,2019-06-18,Senate,"Senate Rules Committee Vote",19,0,0,0,19
1168112,819964,2019-03-11,Senate,"Senate Crime Victims, Crime and Correction Committee Vote",6,1,0,0,7
1168112,861638,2019-05-07,Senate,"Senate Finance Committee Vote",20,3,0,0,23
1168112,882002,2019-06-12,Senate,"Senate Floor Vote - Final Passage",44,18,0,0,62
1168112,886503,2019-06-20,Senate,"Senate Floor Vote - Final Passage",43,19,0,0,62
1168112,904772,2020-01-21,Senate,"Senate Crime Victims, Crime and Correction Committee Vote",6,1,0,0,7
1168112,935423,2020-02-25,Senate,"Senate Finance Committee Vote",16,6,0,1,23
1168126,810255,2019-02-27,Senate,"Senate Commerce, Economic Development and Small Business Committee Vote",9,0,0,0,9
1168126,885198,2019-06-18,Senate,"Senate Floor Vote - Final Passage",62,0,0,0,62
1168126,886492,2019-06-18,Senate,"Senate Rules Committee Vote",18,1,0,0,19
1168126,941944,2020-03-03,Senate,"Senate Commerce, Economic Development and Small Business Committee Vote",9,0,0,0,9
1168224,825384,2019-02-04,Senate,"Senate Social Services Committee Vote",6,1,0,0,7
1168224,825385,2019-03-20,Senate,"Senate Floor Vote - Final Passage",62,0,0,0,62
1168224,902561,2020-01-14,Senate,"Senate Social Services Committee Vote",7,0,0,0,7
1168224,918617,2020-02-10,Senate,"Senate Floor Vote - Final Passage",61,0,0,1,62
1168272,863785,2019-02-11,Senate,"Senate Judiciary Committee Vote",15,0,0,0,15
1168272,863786,2019-05-14,Senate,"Senate Floor Vote - Final Passage",59,0,0,3,62
1168272,902948,2020-01-14,Senate,"Senate Judiciary Committee Vote",15,0,0,0,15
1168272,972521,2020-07-21,Senate,"Senate Floor Vote - Final Passage",60,0,0,0,60
1168284,884373,2019-06-18,Senate,"Senate Rules Committee Vote",17,2,0,0,19
1168284,885427,2019-06-18,Senate,"Senate Floor Vote - Final Passage",59,3,0,0,62
1168305,796870,2019-02-11,Senate,"Senate Alcoholism and Substance Abuse Committee Vote",5,2,0,0,7
1168311,868658,2019-02-12,Senate,"Senate Aging Committee Vote",6,0,0,1,7
1168311,868659,2019-05-21,Senate,"Senate Floor Vote - Final Passage",61,0,0,1,62
1168311,972337,2020-07-20,Senate,"Senate Aging Committee Vote",6,0,0,0,6
1168311,973415,2020-07-22,Senate,"Senate Floor Vote - Final Passage",60,0,0,0,60
1168311,973784,2020-07-21,Senate,"Senate Rules Committee Vote",19,0,0,0,19
1168320,883031,2019-06-17,Senate,"Senate Floor Vote - Final Passage",62,0,0,0,62
1168320,883032,2019-06-17,Senate,"Senate Rules Committee Vote",19,0,0,0,19
1168320,884180,2019-06-18,Assembly,"Assembly Floor Vote - Final Passage",141,7,0,2,150
1168490,973432,2020-07-22,Senate,"Senate Floor Vote - Final Passage",60,0,0,0,60
1168490,973794,2020-07-21,Senate,"Senate Rules Committee Vote",18,1,0,0,19
1168490,974010,2020-07-21,Senate,"Senate Rules Committee Vote",18,1,0,0,19
1168499,881949,2019-06-12,Senate,"Senate Floor Vote - Final Passage",39,23,0,0,62
1168499,881950,2019-06-12,Senate,"Senate Rules Committee Vote",12,7,0,0,19
1168510,875700,2019-05-30,Senate,"Senate Alcoholism and Substance Abuse Committee Vote",7,0,0,0,7
1168558,934976,2020-02-25,Senate,"Senate Crime Victims, Crime and Correction Committee Vote",7,0,0,0,7
1168563,839397,2019-04-08,Senate,"Senate Corporations, Authorities and Commissions Committee Vote",7,0,0,0,7
1168563,882139,2019-06-14,Senate,"Senate Floor Vote - Final Passage",62,0,0,0,62
1168563,882140,2019-06-14,Senate,"Senate Rules Committee Vote",19,0,0,0,19
1168563,903804,2020-01-21,Senate,"Senate Corporations, Authorities and Commissions Committee Vote",7,0,0,0,7
1168563,935308,2020-02-25,Senate,"Senate Finance Committee Vote",22,0,0,1,23
1168563,942228,2020-03-04,Senate,"Senate Floor Vote - Final Passage",61,1,0,0,62
1168563,972969,2020-07-21,Assembly,"Assembly Floor Vote - Final Passage",142,0,0,3,145
1168664,883060,2019-06-17,Senate,"Senate Floor Vote - Final Passage",61,1,0,0,62
1168664,883061,2019-06-17,Senate,"Senate Rules Committee Vote",19,0,0,0,19
1168664,923048,2020-02-12,Senate,"Senate Corporations, Authorities and Commissions Committee Vote",6,0,0,1,7
1168664,942571,2020-03-04,Senate,"Senate Floor Vote - Final Passage",62,0,0,0,62
1168713,787109,2019-01-28,Assembly,"Assembly Correction Committee: Favorable refer to committee Codes",9,2,0,2,13
1168713,813744,2019-03-05,Assembly,"Assembly Codes Committee: Favorable refer to committee Ways and Means",15,7,0,0,22
1168779,788123,2019-01-29,Assembly,"Assembly Environmental Conservation Committee: Favorable refer to committee Codes",29,0,0,1,30
1168779,796694,2019-02-11,Assembly,"Assembly Codes Committee: Favorable",22,0,0,0,22
1168779,810847,2019-02-27,Assembly,"Assembly Floor Vote - Final Passage",141,2,0,7,150
1168779,856021,2019-04-30,Senate,"Senate Floor Vote - Final Passage",62,0,0,0,62
1168857,860979,2019-05-07,Senate,"Senate Health Committee Vote",13,2,0,0,15
1168857,886875,2019-06-18,Senate,"Senate Floor Vote - Final Passage",59,3,0,0,62
1168857,886876,2019-06-18,Senate,"Senate Rules Committee Vote",19,0,0,0,19
1168907,824497,2019-03-18,Senate,"Senate Agriculture Committee Vote",9,0,0,0,9
1168907,861509,2019-05-07,Senate,"Senate Finance Committee Vote",23,0,0,0,23
1168907,874392,2019-05-29,Senate,"Senate Floor Vote - Final Passage",60,0,0,2,62
1168907,905521,2020-01-23,Senate,"Senate Agriculture Committee Vote",8,1,0,0,9
1169075,863519,2019-03-26,Senate,"Senate Rules Committee Vote",19,0,0,0,19
1169075,863957,2019-05-14,Senate,"Senate Floor Vote - Final Passage",59,0,0,3,62
1169213,840577,2019-04-09,Senate,"Senate Veterans, Homeland Security and Military Affairs Committee Vote",9,0,0,0,9
1169213,875451,2019-05-30,Senate,"Senate Floor Vote - Final Passage",58,0,0,4,62
1169213,875452,2019-05-30,Senate,"Senate Rules Committee Vote",18,0,0,1,19
1169213,921982,2020-02-11,Senate,"Senate Veterans, Homeland Security and Military Affairs Committee Vote",9,0,0,0,9
1169213,941223,2020-03-03,Senate,"Senate Finance Committee Vote",23,0,0,0,23
1169213,973020,2020-07-21,Senate,"Senate Floor Vote - Final Passage",60,0,0,0,60
1169339,972124,2020-07-17,Assembly,"Assembly Codes Committee: Held for Consideration",15,6,0,1,22
1169348,839295,2019-04-08,Senate,"Senate Corporations, Authorities and Commissions Committee Vote",7,0,0,0,7
1169380,971961,2020-07-17,Assembly,"Assembly Ways And Means Committee: Held for Consideration",22,10,0,2,34
1169385,861263,2019-05-07,Assembly,"Assembly Judiciary Committee: Favorable",19,1,0,1,21
1169385,877803,2019-06-04,Assembly,"Assembly Floor Vote - Final Passage",101,45,0,4,150
1169385,882013,2019-06-13,Senate,"Senate Floor Vote - Final Passage",40,22,0,0,62
1169404,788259,2019-01-29,Assembly,"Assembly Environmental Conservation Committee: Favorable",29,0,0,1,30
1169404,797905,2019-02-11,Assembly,"Assembly Floor Vote - Final Passage",137,6,0,7,150
1169404,813356,2019-03-04,Senate,"Senate Floor Vote - Final Passage",59,0,0,4,63
1169426,971614,2020-07-16,Assembly,"Assembly Real Property Taxation Committee: Held for Consideration",8,2,0,0,10
1169451,786915,2019-01-28,Assembly,"Assembly Rules Committee: Favorable",29,0,0,2,31
1169451,786916,2019-01-28,Assembly,"Assembly Election Law Committee: Favorable refer to committee Rules",14,1,0,1,16
1169451,787819,2019-01-28,Assembly,"Assembly Floor Vote - Final Passage",136,9,0,5,150
1169451,797713,2019-02-12,Senate,"Senate Floor Vote - Final Passage",54,6,0,3,63
1169530,971956,2020-07-17,Assembly,"Assembly Codes Committee: Held for Consideration",15,6,0,1,22
1169550,971689,2020-07-16,Assembly,"Assembly Real Property Taxation Committee: Held for Consideration",8,2,0,0,10
1169586,864853,2019-05-14,Assembly,"Assembly Ways And Means Committee: Favorable",31,1,0,3,35
1169586,874974,2019-05-29,Assembly,"Assembly Floor Vote - Final Passage",140,0,0,10,150
1169586,874975,2019-05-30,Senate,"Senate Floor Vote - Final Passage",58,0,0,4,62
1169605,788122,2019-01-29,Assembly,"Assembly Environmental Conservation Committee: Favorable",29,0,0,1,30
1169605,792470,2019-02-04,Assembly,"Assembly Floor Vote - Final Passage",143,0,0,7,150
1169605,793316,2019-02-05,Senate,"Senate Floor Vote - Final Passage",61,0,0,2,63
1169633,788265,2019-01-29,Assembly,"Assembly Environmental Conservation Committee: Favorable",29,0,0,1,30
1169633,797702,2019-02-11,Assembly,"Assembly Floor Vote - Final Passage",140,3,0,7,150
1169633,813616,2019-03-04,Senate,"Senate Floor Vote - Final Passage",59,0,0,4,63
1169655,864705,2019-05-14,Assembly,"Assembly Consumer Affairs And Protection Committee: Favorable refer to committee Codes",14,1,0,1,16
1169655,868775,2019-05-21,Assembly,"Assembly Codes Committee: Favorable",15,6,0,1,22
1169669,870174,2019-05-21,Assembly,"Assembly Transportation Committee: Favorable refer to committee Codes",23,2,0,0,25
1169750,877740,2019-06-04,Assembly,"Assembly Ways And Means Committee: Favorable refer to committee Rules",33,0,0,2,35
1169750,880426,2019-06-11,Assembly,"Assembly Rules Committee: Favorable",25,0,0,6,31
1169750,881171,2019-06-12,Assembly,"Assembly Floor Vote - Final Passage",132,15,0,3,150
1169781,811347,2019-02-27,Assembly,"Assembly Election Law Committee: Favorable",13,0,0,3,16
1169806,814466,2019-03-05,Assembly,"Assembly Education Committee: Favorable refer to committee Ways and Means",24,0,0,7,31
1169806,857207,2019-04-30,Assembly,"Assembly Ways And Means Committee: Favorable",33,0,0,2,35
1169830,814219,2019-02-25,Senate,"Senate Elections Committee Vote",7,0,0,0,7
1169830,814220,2019-03-05,Senate,"Senate Floor Vote - Final Passage",40,20,0,3,63
1169830,819039,2019-03-11,Assembly,"Assembly Floor Vote - Final Passage",139,0,0,11,150
1170037,792529,2019-02-05,Assembly,"Assembly Governmental Operations Committee: Favorable refer to committee Codes",11,2,0,1,14
1170037,796517,2019-02-11,Assembly,"Assembly Codes Committee: Favorable refer to committee Ways and Means",18,4,0,0,22
1170037,839106,2019-04-09,Assembly,"Assembly Rules Committee: Favorable",26,0,0,5,31
1170037,839107,2019-04-09,Assembly,"Assembly Ways And Means Committee: Favorable refer to committee Rules",27,5,0,3,35
1170037,840255,2019-04-09,Assembly,"Assembly Floor Vote - Final Passage",122,24,0,4,150
1170037,864021,2019-05-14,Senate,"Senate Floor Vote - Final Passage",59,0,0,3,62
1170078,788146,2019-01-29,Assembly,"Assembly Environmental Conservation Committee: Favorable refer to committee Ways and Means",29,0,0,1,30
1170078,791657,2019-02-04,Assembly,"Assembly Rules Committee: Favorable",25,4,0,2,31
1170078,791658,2019-02-04,Assembly,"Assembly Ways And Means Committee: Favorable refer to committee Rules",25,5,0,5,35
1170078,792464,2019-02-04,Assembly,"Assembly Floor Vote - Final Passage",121,22,0,7,150
1170078,792877,2019-02-05,Senate,"Senate Floor Vote - Final Passage",48,13,0,2,63
1170104,876058,2019-05-30,Assembly,"Assembly Codes Committee: Favorable",19,0,0,3,22
1170118,788258,2019-01-29,Assembly,"Assembly Environmental Conservation Committee: Favorable refer to committee Ways and Means",29,0,0,1,30
1170118,856990,2019-04-30,Assembly,"Assembly Ways And Means Committee: Favorable",33,0,0,2,35
1170660,856180,2019-04-09,Senate,"Senate Finance Committee Vote",23,0,0,0,23
1170660,856181,2019-05-01,Senate,"Senate Floor Vote - Final Passage",62,0,0,0,62
1170660,904624,2020-01-22,Senate,"Senate Finance Committee Vote",23,0,0,0,23
1170660,972529,2020-07-21,Senate,"Senate Floor Vote - Final Passage",60,0,0,0,60
1170660,972985,2020-07-21,Assembly,"Assembly Floor Vote - Final Passage",142,0,0,3,145
1170668,882123,2019-05-14,Senate,"Senate Judiciary Committee Vote",15,0,0,0,15
1170668,882124,2019-06-14,Senate,"Senate Floor Vote - Final Passage",53,9,0,0,62
1170668,884362,2019-06-18,Assembly,"Assembly Floor Vote - Final Passage",139,9,0,2,150
1170767,813681,2019-02-25,Senate,"Senate Elections Committee Vote",6,1,0,0,7
1170767,814434,2019-03-05,Senate,"Senate Floor Vote - Final Passage",53,7,0,3,63
1170796,797563,2019-02-12,Assembly,"Assembly Transportation Committee: Favorable refer to committee Ways and Means",23,0,0,2,25
1170823,870479,2019-05-21,Senate,"Senate Elections Committee Vote",5,2,0,0,7
1170830,818393,2019-01-28,Senate,"Senate Racing, Gaming and Wagering Committee Vote",7,0,0,0,7
1170830,818394,2019-03-11,Senate,"Senate Floor Vote - Final Passage",62,0,0,0,62
1170830,861599,2019-05-07,Assembly,"Assembly Floor Vote - Final Passage",132,1,0,17,150
1170847,883659,2019-06-17,Assembly,"Assembly Education Committee: Favorable refer to committee Ways and Means",27,0,0,4,31
1170847,883660,2019-06-18,Assembly,"Assembly Rules Committee: Favorable",25,0,0,6,31
1170847,883661,2019-06-18,Assembly,"Assembly Ways And Means Committee: Favorable refer to committee Rules",33,0,0,2,35
1170935,876604,2019-06-03,Senate,"Senate Floor Vote - Final Passage",47,15,0,0,62
1170935,877330,2019-06-03,Senate,"Senate Rules Committee Vote",15,4,0,0,19
1170935,904842,2020-01-21,Senate,"Senate Elections Committee Vote",6,1,0,0,7
1170935,972531,2020-07-21,Senate,"Senate Floor Vote - Final Passage",46,14,0,0,60
1170947,809783,2019-02-26,Senate,"Senate Mental Health and Developmental Disabilities Committee Vote",7,0,0,0,7
1170947,902961,2020-01-15,Senate,"Senate Mental Health and Developmental Disabilities Committee Vote",7,0,0,0,7
1170951,970888,2020-07-13,Assembly,"Assembly Consumer Affairs And Protection Committee: Favorable refer to committee Codes",12,3,0,1,16
1170951,971825,2020-07-17,Assembly,"Assembly Codes Committee: Favorable refer to committee Rules",15,6,0,1,22
1170953,787813,2019-01-28,Senate,"Senate Rules Committee Vote",13,6,0,0,19
1170953,787814,2019-01-29,Senate,"Senate Floor Vote - Final Passage",40,23,0,0,63
1170953,787815,2019-01-29,Senate,"Senate Codes Committee Vote",9,4,0,0,13
1170953,788355,2019-01-29,Assembly,"Assembly Floor Vote - Final Passage",85,52,0,13,150
1170981,971497,2020-07-15,Assembly,"Assembly Labor Committee: Held for Consideration",18,7,0,3,28
1170994,798211,2019-02-12,Senate,"Senate Aging Committee Vote",6,0,0,1,7
1170994,885141,2019-06-19,Senate,"Senate Rules Committee Vote",19,0,0,0,19
1170994,886442,2019-06-19,Senate,"Senate Floor Vote - Final Passage",62,0,0,0,62
1170994,904373,2020-01-22,Senate,"Senate Aging Committee Vote",7,0,0,0,7
1171026,798059,2019-02-04,Senate,"Senate Energy and Telecommunications Committee Vote",8,1,0,0,9
1171026,798060,2019-02-12,Senate,"Senate Floor Vote - Final Passage",57,3,0,3,63
1171067,971164,2020-07-14,Assembly,"Assembly Judiciary Committee: Held for Consideration",15,6,0,0,21
1171072,786957,2019-01-28,Assembly,"Assembly Election Law Committee: Favorable",10,5,0,1,16
1171080,868974,2019-05-22,Assembly,"Assembly Election Law Committee: Favorable refer to committee Ways and Means",10,4,0,2,16
1171080,882018,2019-06-14,Assembly,"Assembly Ways And Means Committee: Favorable refer to committee Rules",23,7,0,5,35
1171080,882519,2019-06-17,Assembly,"Assembly Rules Committee: Favorable",26,0,0,5,31
1171105,868896,2019-05-21,Assembly,"Assembly Judiciary Committee: Favorable refer to committee Codes",13,8,0,0,21
1171105,880216,2019-06-11,Assembly,"Assembly Codes Committee: Favorable refer to committee Rules",22,0,0,0,22
1171105,934989,2020-02-25,Assembly,"Assembly Codes Committee: Favorable",18,3,0,1,22
1171121,793040,2019-01-28,Senate,"Senate Veterans, Homeland Security and Military Affairs Committee Vote",9,0,0,0,9
1171121,793041,2019-02-05,Senate,"Senate Floor Vote - Final Passage",55,6,0,2,63
1171121,798660,2019-02-12,Assembly,"Assembly Floor Vote - Final Passage",137,1,0,12,150
1171124,814590,2019-03-05,Senate,"Senate Social Services Committee Vote",6,1,0,0,7
1171124,855562,2019-04-30,Senate,"Senate Finance Committee Vote",22,1,0,0,23
1171124,919890,2020-02-11,Senate,"Senate Social Services Committee Vote",7,0,0,0,7
1171153,882946,2019-06-17,Senate,"Senate Floor Vote - Final Passage",61,1,0,0,62
1171153,882947,2019-06-17,Senate,"Senate Rules Committee Vote",19,0,0,0,19
1171153,886231,2019-06-20,Assembly,"Assembly Floor Vote - Final Passage",105,41,0,4,150
1171161,971464,2020-07-15,Assembly,"Assembly Labor Committee: Held for Consideration",18,7,0,3,28
1171168,798091,2019-02-12,Senate,"Senate Aging Committee Vote",6,0,0,1,7
1171173,818190,2019-01-28,Senate,"Senate Racing, Gaming and Wagering Committee Vote",7,0,0,0,7
1171173,818191,2019-03-11,Senate,"Senate Floor Vote - Final Passage",62,0,0,0,62
1171173,861233,2019-05-07,Assembly,"Assembly Floor Vote - Final Passage",134,0,0,16,150
1171255,971925,2020-07-17,Assembly,"Assembly Ways And Means Committee: Held for Consideration",22,10,0,2,34
1171289,880030,2019-06-11,Senate,"Senate Rules Committee Vote",18,1,0,0,19
1171289,880520,2019-06-11,Senate,"Senate Floor Vote - Final Passage",47,14,0,1,62
1171289,919653,2020-02-10,Senate,"Senate Higher Education Committee Vote",10,1,0,0,11
1171289,923084,2020-02-13,Senate,"Senate Floor Vote - Final Passage",43,14,0,5,62
1171305,885848,2019-06-19,Senate,"Senate Rules Committee Vote",19,0,0,0,19
1171305,886333,2019-06-19,Senate,"Senate Floor Vote - Final Passage",62,0,0,0,62
1171305,886334,2019-06-20,Assembly,"Assembly Floor Vote - Final Passage",117,30,0,3,150
1171335,971034,2020-07-14,Assembly,"Assembly Higher Education Committee: Held for Consideration",18,7,0,0,25
1171346,857579,2019-04-30,Assembly,"Assembly Judiciary Committee: Favorable",14,5,0,2,21
1171346,877761,2019-06-04,Assembly,"Assembly Floor Vote - Final Passage",106,40,0,4,150
1171357,881975,2019-06-12,Senate,"Senate Floor Vote - Final Passage",62,0,0,0,62
1171357,881976,2019-06-12,Senate,"Senate Rules Committee Vote",19,0,0,0,19
1171357,886479,2019-06-21,Assembly,"Assembly Floor Vote - Final Passage",133,1,0,16,150
1171383,971187,2020-07-14,Assembly,"Assembly Judiciary Committee: Held for Consideration",15,6,0,0,21
1171384,972055,2020-07-17,Assembly,"Assembly Ways And Means Committee: Held for Consideration",22,10,0,2,34
1171388,971735,2020-07-17,Assembly,"Assembly Ways And Means Committee: Held for Consideration",23,9,0,2,34
1171462,878706,2019-06-06,Assembly,"Assembly Environmental Conservation Committee: Held for Consideration",21,7,0,2,30
1171469,824222,2019-03-19,Assembly,"Assembly Judiciary Committee: Favorable",20,0,0,1,21
1171469,830781,2019-03-27,Assembly,"Assembly Floor Vote - Final Passage",124,23,0,3,150
1171469,881918,2019-06-12,Senate,"Senate Floor Vote - Final Passage",53,9,0,0,62
1171478,856167,2019-04-30,Senate,"Senate Cities Committee Vote",7,0,0,0,7
1171490,787025,2019-01-28,Assembly,"Assembly Election Law Committee: Favorable",15,0,0,1,16
1171490,797410,2019-02-11,Assembly,"Assembly Floor Vote - Final Passage",142,1,0,7,150
1171494,879447,2019-06-06,Assembly,"Assembly Environmental Conservation Committee: Favorable refer to committee Codes",25,3,0,2,30
1171494,880053,2019-06-11,Assembly,"Assembly Codes Committee: Favorable refer to committee Rules",18,4,0,0,22
1171494,881361,2019-06-13,Assembly,"Assembly Rules Committee: Favorable",20,6,0,5,31
1171494,973764,2020-07-20,Assembly,"Assembly Floor Vote - Final Passage",110,31,0,4,145
1171497,840737,2019-04-10,Senate,"Senate Banks Committee Vote",10,1,0,0,11
1171497,869040,2019-05-21,Senate,"Senate Consumer Protection Committee Vote",7,0,0,0,7
1171497,949117,2020-03-10,Senate,"Senate Banks Committee Vote",10,1,0,0,11
1171507,971144,2020-07-14,Assembly,"Assembly Election Law Committee: Favorable refer to committee Ways and Means",16,0,0,0,16
1171507,971876,2020-07-17,Assembly,"Assembly Ways And Means Committee: Favorable refer to committee Rules",24,8,0,2,34
1171507,972536,2020-07-21,Assembly,"Assembly Rules Committee: Favorable",26,0,0,4,30
1171507,973193,2020-07-22,Assembly,"Assembly Floor Vote - Final Passage",111,31,0,3,145
1171516,811108,2019-02-27,Assembly,"Assembly Higher Education Committee: Favorable refer to committee Codes",25,0,0,1,26
1171516,814204,2019-03-05,Assembly,"Assembly Codes Committee: Favorable",22,0,0,0,22
1171531,809785,2019-02-27,Senate,"Senate Commerce, Economic Development and Small Business Committee Vote",9,0,0,0,9
1171531,914174,2020-02-04,Senate,"Senate Commerce, Economic Development and Small Business Committee Vote",9,0,0,0,9
1171545,859533,2019-04-29,Senate,"Senate Women's Issues Committee Vote",6,1,0,0,7
1171545,859534,2019-05-06,Senate,"Senate Floor Vote - Final Passage",49,12,0,1,62
1171545,882945,2019-06-17,Senate,"Senate Floor Vote - Final Passage",51,11,0,0,62
1171545,886174,2019-06-20,Assembly,"Assembly Floor Vote - Final Passage",146,0,0,4,150
1171550,875769,2019-05-30,Assembly,"Assembly Consumer Affairs And Protection Committee: Favorable refer to committee Codes",12,3,0,1,16
1171550,877174,2019-06-04,Assembly,"Assembly Codes Committee: Favorable refer to committee Rules",15,7,0,0,22
1171550,971921,2020-07-17,Assembly,"Assembly Codes Committee: Favorable refer to committee Rules",15,6,0,1,22
1171556,863399,2019-05-14,Assembly,"Assembly Consumer Affairs And Protection Committee: Favorable refer to committee Codes",11,4,0,1,16
1171556,881467,2019-06-13,Assembly,"Assembly Codes Committee: Favorable refer to committee Rules",14,6,0,2,22
1171556,882460,2019-06-17,Assembly,"Assembly Rules Committee: Favorable",18,8,0,5,31
1171556,972258,2020-07-20,Assembly,"Assembly Floor Vote - Final Passage",102,39,0,4,145
1171586,855592,2019-04-30,Senate,"Senate Committee Vote",7,0,0,0,7
1171586,868574,2019-05-21,Senate,"Senate Finance Committee Vote",23,0,0,0,23
1171586,877169,2019-05-30,Senate,"Senate Floor Vote - Final Passage",58,0,0,4,62
1171586,877170,2019-05-30,Senate,"Senate Rules Committee Vote",18,0,0,1,19
1171587,825370,2019-03-19,Assembly,"Assembly Judiciary Committee: Favorable refer to committee Codes",20,0,0,1,21
1171587,838924,2019-04-09,Assembly,"Assembly Rules Committee: Favorable",26,0,0,5,31
1171587,838925,2019-04-09,Assembly,"Assembly Codes Committee: Favorable refer to committee Rules",22,0,0,0,22
1171587,840138,2019-04-09,Assembly,"Assembly Floor Vote - Final Passage",93,53,0,4,150
1171587,864399,2019-05-14,Senate,"Senate Floor Vote - Final Passage",58,1,0,3,62
1171600,884376,2019-06-18,Senate,"Senate Rules Committee Vote",18,1,0,0,19
1171600,885036,2019-06-18,Senate,"Senate Floor Vote - Final Passage",62,0,0,0,62
1171600,903372,2020-01-15,Senate,"Senate Banks Committee Vote",10,0,0,0,10
1171600,906383,2020-01-27,Senate,"Senate Floor Vote - Final Passage",61,0,0,1,62
1171603,971665,2020-07-16,Assembly,"Assembly Governmental Operations Committee: Held for Consideration",10,4,0,0,14
1171619,970953,2020-07-13,Assembly,"Assembly Consumer Affairs And Protection Committee: Favorable refer to committee Rules",12,3,0,1,16
1171653,814511,2019-03-05,Assembly,"Assembly Judiciary Committee: Favorable refer to committee Codes",19,0,0,2,21
1171653,819252,2019-03-12,Assembly,"Assembly Codes Committee: Favorable",21,0,0,1,22
1171653,824234,2019-03-18,Assembly,"Assembly Floor Vote - Final Passage",140,3,0,7,150
1171653,922356,2020-02-12,Senate,"Senate Floor Vote - Final Passage",43,17,0,2,62
1171696,882710,2019-06-17,Assembly,"Assembly Banks Committee: Favorable refer to committee Codes",29,0,0,2,31
1171696,883783,2019-06-18,Assembly,"Assembly Codes Committee: Favorable refer to committee Rules",22,0,0,0,22
1171696,884930,2019-06-19,Assembly,"Assembly Rules Committee: Favorable",27,0,0,4,31
1171701,950535,2020-03-10,Assembly,"Assembly Transportation Committee: Favorable refer to committee Codes",25,0,0,0,25
1171717,861593,2019-05-07,Assembly,"Assembly Transportation Committee: Held for Consideration",16,7,0,2,25
1171737,874632,2019-05-29,Assembly,"Assembly Housing Committee: Favorable refer to committee Codes",19,8,0,1,28
1171775,792541,2019-02-05,Assembly,"Assembly Governmental Operations Committee: Favorable refer to committee Codes",13,0,0,1,14
1171775,796798,2019-02-11,Assembly,"Assembly Codes Committee: Favorable",22,0,0,0,22
1171775,811922,2019-02-28,Assembly,"Assembly Floor Vote - Final Passage",138,0,0,12,150
1171775,839989,2019-04-08,Senate,"Senate Floor Vote - Final Passage",59,0,0,3,62
1171794,971782,2020-07-16,Assembly,"Assembly Governmental Employees Committee: Held for Consideration",9,5,0,0,14
1171816,793150,2019-01-28,Senate,"Senate Environmental Conservation Committee Vote",11,0,0,0,11
1171816,793151,2019-02-05,Senate,"Senate Floor Vote - Final Passage",61,0,0,2,63
1171816,859737,2019-05-06,Assembly,"Assembly Floor Vote - Final Passage",135,7,0,8,150
1171817,813247,2019-01-28,Senate,"Senate Mental Health and Developmental Disabilities Committee Vote",7,0,0,0,7
1171817,813248,2019-03-04,Senate,"Senate Floor Vote - Final Passage",59,0,0,4,63
1171817,881064,2019-06-11,Assembly,"Assembly Floor Vote - Final Passage",142,0,0,8,150
1171901,786918,2019-01-28,Assembly,"Assembly Rules Committee: Favorable",24,5,0,2,31
1171901,786919,2019-01-28,Assembly,"Assembly Codes Committee: Favorable refer to committee Rules",17,5,0,0,22
1171945,786893,2019-01-28,Senate,"Senate Floor Vote - Final Passage",63,0,0,0,63
1171945,786894,2019-01-28,Senate,"Senate Judiciary Committee Vote",15,0,0,0,15
1171945,787532,2019-01-28,Senate,"Senate Judiciary Committee Vote",15,0,0,0,15
1171945,787533,2019-01-28,Assembly,"Assembly Floor Vote - Final Passage",142,3,0,5,150
1171966,797578,2019-02-12,Assembly,"Assembly Corporations, Authorities And Commissions Committee: Favorable refer to committee Ways and Means",23,1,0,2,26
1171966,864854,2019-05-14,Assembly,"Assembly Ways And Means Committee: Favorable",32,0,0,3,35
1171992,786891,2019-01-28,Assembly,"Assembly Rules Committee: Favorable",26,3,0,2,31
1171992,786892,2019-01-28,Assembly,"Assembly Codes Committee: Favorable refer to committee Rules",15,7,0,0,22
1172034,787540,2019-01-28,Senate,"Senate Rules Committee Vote",16,3,0,0,19
1172034,787541,2019-01-29,Senate,"Senate Codes Committee Vote",12,1,0,0,13
1172034,787768,2019-01-29,Senate,"Senate Floor Vote - Final Passage",50,13,0,0,63
1172034,788403,2019-01-29,Assembly,"Assembly Floor Vote - Final Passage",108,36,0,6,150
1172058,786923,2019-01-28,Assembly,"Assembly Rules Committee: Favorable",29,0,0,2,31
1172058,786924,2019-01-28,Assembly,"Assembly Codes Committee: Favorable refer to committee Rules",22,0,0,0,22
1172081,786895,2019-01-28,Assembly,"Assembly Rules Committee: Favorable",22,7,0,2,31
1172081,786896,2019-01-28,Assembly,"Assembly Codes Committee: Favorable refer to committee Rules",15,7,0,0,22
1172125,787599,2019-01-28,Senate,"Senate Rules Committee Vote",18,1,0,0,19
1172125,787600,2019-01-29,Senate,"Senate Codes Committee Vote",13,0,0,0,13
1172125,791528,2019-01-29,Senate,"Senate Floor Vote - Final Passage",62,1,0,0,63
1172327,787593,2019-01-28,Senate,"Senate Rules Committee Vote",15,4,0,0,19
1172327,787594,2019-01-29,Senate,"Senate Codes Committee Vote",10,3,0,0,13
1172327,813063,2019-03-04,Senate,"Senate Floor Vote - Final Passage",37,22,0,4,63
1172327,813441,2019-03-04,Assembly,"Assembly Floor Vote - Final Passage",91,52,0,7,150
1172347,786906,2019-01-28,Assembly,"Assembly Rules Committee: Favorable",22,7,0,2,31
1172347,786907,2019-01-28,Assembly,"Assembly Codes Committee: Favorable refer to committee Ways and Means",22,0,0,0,22
1172347,786908,2019-01-28,Assembly,"Assembly Ways And Means Committee: Favorable refer to committee Rules",23,9,0,3,35
1172347,791534,2019-01-29,Assembly,"Assembly Floor Vote - Final Passage",90,55,0,5,150
1172542,786920,2019-01-28,Assembly,"Assembly Rules Committee: Favorable",27,2,0,2,31
1172542,786921,2019-01-28,Assembly,"Assembly Codes Committee: Favorable refer to committee Rules",22,0,0,0,22
1172590,786948,2019-01-28,Assembly,"Assembly Election Law Committee: Favorable",15,0,0,1,16
1172590,797432,2019-02-11,Assembly,"Assembly Floor Vote - Final Passage",143,0,0,7,150
1172590,878601,2019-06-05,Senate,"Senate Floor Vote - Final Passage",62,0,0,0,62
1172631,787605,2019-01-28,Senate,"Senate Rules Committee Vote",15,4,0,0,19
1172631,787606,2019-01-29,Senate,"Senate Codes Committee Vote",12,1,0,0,13
1172631,787835,2019-01-29,Senate,"Senate Floor Vote - Final Passage",49,14,0,0,63
1172631,788356,2019-01-29,Assembly,"Assembly Floor Vote - Final Passage",134,11,0,5,150
1172670,786927,2019-01-28,Senate,"Senate Judiciary Committee Vote",12,3,0,0,15
1172670,787607,2019-01-28,Senate,"Senate Judiciary Committee Vote",12,3,0,0,15
1172670,787876,2019-01-29,Senate,"Senate Floor Vote - Final Passage",42,21,0,0,63
1172670,788358,2019-01-29,Assembly,"Assembly Floor Vote - Final Passage",100,37,0,13,150
1173264,881840,2019-06-13,Senate,"Senate Floor Vote - Final Passage",62,0,0,0,62
1173264,881841,2019-06-13,Senate,"Senate Rules Committee Vote",19,0,0,0,19
1173264,884019,2019-06-18,Assembly,"Assembly Floor Vote - Final Passage",146,0,0,4,150
1173567,880014,2019-06-11,Senate,"Senate Rules Committee Vote",19,0,0,0,19
1173567,880482,2019-06-11,Senate,"Senate Floor Vote - Final Passage",61,0,0,1,62
1173567,886386,2019-06-19,Senate,"Senate Floor Vote - Final Passage",62,0,0,0,62
1173567,886387,2019-06-21,Assembly,"Assembly Floor Vote - Final Passage",123,18,0,9,150
1173694,883010,2019-06-17,Senate,"Senate Floor Vote - Final Passage",62,0,0,0,62
1173694,883011,2019-06-17,Senate,"Senate Rules Committee Vote",19,0,0,0,19
1173694,886811,2019-06-18,Senate,"Senate Floor Vote - Final Passage",62,0,0,0,62
1173758,875580,2019-05-30,Senate,"Senate New York City Education Committee Vote",7,0,0,0,7
1173811,868703,2019-04-30,Senate,"Senate Veterans, Homeland Security and Military Affairs Committee Vote",9,0,0,0,9
1173811,868704,2019-05-21,Senate,"Senate Floor Vote - Final Passage",61,0,0,1,62
1173815,819356,2019-03-12,Assembly,"Assembly Energy Committee: Favorable refer to committee Ways and Means",14,2,0,1,17
1173882,934407,2020-02-25,Assembly,"Assembly Correction Committee: Favorable refer to committee Ways and Means",10,0,0,3,13
1173930,824518,2019-03-19,Senate,"Senate Environmental Conservation Committee Vote",11,0,0,0,11
1173930,839832,2019-04-09,Senate,"Senate Finance Committee Vote",22,1,0,0,23
1173930,867821,2019-05-20,Senate,"Senate Floor Vote - Final Passage",55,5,0,2,62
1173936,877028,2019-06-03,Senate,"Senate Floor Vote - Final Passage",53,9,0,0,62
1173936,877317,2019-06-03,Senate,"Senate Rules Committee Vote",17,2,0,0,19
1173936,914946,2020-02-04,Senate,"Senate Environmental Conservation Committee Vote",10,1,0,0,11
1173936,972508,2020-07-21,Senate,"Senate Floor Vote - Final Passage",51,9,0,0,60
1173963,879168,2019-06-05,Assembly,"Assembly Transportation Committee: Held for Consideration",26,0,0,0,26
1174001,810906,2019-02-12,Senate,"Senate Transportation Committee Vote",14,1,0,0,15
1174001,811382,2019-02-28,Senate,"Senate Floor Vote - Final Passage",61,1,0,1,63
1174001,828518,2019-03-25,Assembly,"Assembly Floor Vote - Final Passage",146,0,0,4,150
1174010,876577,2019-04-08,Senate,"Senate Codes Committee Vote",12,0,0,1,13
1174010,877006,2019-06-03,Senate,"Senate Floor Vote - Final Passage",62,0,0,0,62
1174010,906467,2020-01-27,Senate,"Senate Codes Committee Vote",12,0,0,0,12
1174010,973087,2020-07-21,Senate,"Senate Floor Vote - Final Passage",60,0,0,0,60
1174028,860974,2019-05-07,Senate,"Senate Committee Vote",6,1,0,0,7
1174028,886773,2019-06-19,Senate,"Senate Floor Vote - Final Passage",61,1,0,0,62
1174028,888352,2019-06-19,Senate,"Senate Rules Committee Vote",19,0,0,0,19
1174125,786928,2019-01-28,Assembly,"Assembly Rules Committee: Favorable",29,0,0,2,31
1174125,786929,2019-01-28,Assembly,"Assembly Election Law Committee: Favorable refer to committee Rules",13,2,0,1,16
1174125,787793,2019-01-28,Assembly,"Assembly Floor Vote - Final Passage",134,10,0,6,150
1174125,798216,2019-02-12,Senate,"Senate Floor Vote - Final Passage",57,3,0,3,63
1174147,884410,2019-06-18,Senate,"Senate Rules Committee Vote",18,1,0,0,19
1174147,885475,2019-06-18,Senate,"Senate Floor Vote - Final Passage",60,2,0,0,62
1174155,862905,2019-05-06,Senate,"Senate Alcoholism and Substance Abuse Committee Vote",7,0,0,0,7
1174155,863191,2019-05-13,Senate,"Senate Floor Vote - Final Passage",60,0,0,2,62
1174155,901904,2020-01-13,Senate,"Senate Alcoholism and Substance Abuse Committee Vote",7,0,0,0,7
1174155,914648,2020-02-04,Senate,"Senate Floor Vote - Final Passage",61,0,0,1,62
1174168,808819,2019-02-05,Senate,"Senate Cultural Affairs, Tourism, Parks and Recreation Committee Vote",7,0,0,0,7
1174168,808820,2019-02-26,Senate,"Senate Floor Vote - Final Passage",61,0,0,2,63
1174168,903047,2020-01-14,Senate,"Senate Cultural Affairs, Tourism, Parks and Recreation Committee Vote",7,0,0,0,7
1174168,919384,2020-02-10,Senate,"Senate Floor Vote - Final Passage",61,0,0,1,62
1174179,882709,2019-05-30,Senate,"Senate Environmental Conservation Committee Vote",8,2,0,1,11
1174179,883150,2019-06-17,Senate,"Senate Floor Vote - Final Passage",50,12,0,0,62
1174179,972771,2020-07-20,Senate,"Senate Environmental Conservation Committee Vote",9,2,0,0,11
1174210,868402,2019-05-21,Assembly,"Assembly Economic Development Committee: Favorable refer to committee Codes",22,2,0,2,26
1174210,874994,2019-05-30,Assembly,"Assembly Codes Committee: Favorable refer to committee Ways and Means",16,3,0,3,22
1174210,880653,2019-06-11,Assembly,"Assembly Ways And Means Committee: Favorable refer to committee Rules",33,0,0,2,35
1174210,881329,2019-06-13,Assembly,"Assembly Rules Committee: Favorable",26,0,0,5,31
1174348,878344,2019-06-05,Assembly,"Assembly Energy Committee: Favorable refer to committee Ways and Means",14,3,0,0,17
1174374,839387,2019-04-09,Senate,"Senate Cultural Affairs, Tourism, Parks and Recreation Committee Vote",7,0,0,0,7
1174374,884423,2019-06-18,Senate,"Senate Rules Committee Vote",18,1,0,0,19
1174374,885493,2019-06-18,Senate,"Senate Floor Vote - Final Passage",60,2,0,0,62
1174395,811017,2019-02-28,Assembly,"Assembly Health Committee: Favorable refer to committee Codes",18,7,0,1,26
1174395,868732,2019-05-21,Assembly,"Assembly Codes Committee: Favorable refer to committee Ways and Means",16,5,0,1,22
1174395,883484,2019-06-18,Assembly,"Assembly Ways And Means Committee: Favorable refer to committee Rules",28,5,0,2,35
1174395,883607,2019-06-18,Assembly,"Assembly Rules Committee: Favorable",25,0,0,6,31
1174407,796691,2019-02-11,Assembly,"Assembly Health Committee: Favorable refer to committee Ways and Means",24,0,0,2,26
1174407,973058,2020-07-22,Assembly,"Assembly Ways And Means Committee: Favorable refer to committee Rules",32,0,0,2,34
1174416,970777,2020-07-13,Assembly,"Assembly Health Committee: Favorable refer to committee Rules",24,0,0,2,26
1174416,972213,2020-07-20,Assembly,"Assembly Rules Committee: Favorable",27,0,0,3,30
1174416,972277,2020-07-20,Assembly,"Assembly Floor Vote - Final Passage",141,0,0,4,145
1174416,973520,2020-07-23,Senate,"Senate Floor Vote - Final Passage",60,0,0,0,60
1174460,877240,2019-06-04,Assembly,"Assembly Children And Families Committee: Favorable refer to committee Ways and Means",16,0,0,0,16
1174460,880347,2019-06-11,Assembly,"Assembly Ways And Means Committee: Favorable refer to committee Rules",33,0,0,2,35
1174460,881381,2019-06-13,Assembly,"Assembly Rules Committee: Favorable",26,0,0,5,31
1174485,812193,2019-02-28,Assembly,"Assembly Health Committee: Favorable refer to committee Ways and Means",25,0,0,1,26
1174485,878568,2019-06-05,Assembly,"Assembly Ways And Means Committee: Favorable refer to committee Rules",31,0,0,4,35
1174485,880403,2019-06-11,Assembly,"Assembly Rules Committee: Favorable",25,0,0,6,31
1174485,881827,2019-06-13,Assembly,"Assembly Floor Vote - Final Passage",146,0,0,4,150
1174485,883610,2019-06-18,Senate,"Senate Floor Vote - Final Passage",57,5,0,0,62
1174494,816301,2019-03-06,Assembly,"Assembly Health Committee: Favorable refer to committee Ways and Means",25,0,0,1,26
1174521,971641,2020-07-16,Assembly,"Assembly Governmental Operations Committee: Held for Consideration",10,4,0,0,14
1174553,864513,2019-05-14,Assembly,"Assembly Health Committee: Favorable refer to committee Codes",18,6,0,2,26
1174553,875170,2019-05-30,Assembly,"Assembly Codes Committee: Favorable",18,1,0,3,22
1174580,863492,2019-05-14,Assembly,"Assembly Mental Health Committee: Favorable refer to committee Ways and Means",12,0,0,1,13
1174580,878640,2019-06-05,Assembly,"Assembly Ways And Means Committee: Favorable refer to committee Rules",31,0,0,4,35
1174592,920864,2020-02-11,Assembly,"Assembly Mental Health Committee: Favorable refer to committee Codes",11,0,0,2,13
1174592,935015,2020-02-25,Assembly,"Assembly Codes Committee: Favorable",14,7,0,1,22
1174602,907427,2020-01-28,Assembly,"Assembly Health Committee: Favorable refer to committee Ways and Means",24,0,0,2,26
1174606,796669,2019-02-11,Assembly,"Assembly Health Committee: Favorable refer to committee Ways and Means",24,0,0,2,26
1174612,874734,2019-05-30,Senate,"Senate Aging Committee Vote",7,0,0,0,7
1174656,904873,2020-01-22,Assembly,"Assembly Health Committee: Favorable refer to committee Ways and Means",24,1,0,1,26
1174677,820811,2019-03-12,Assembly,"Assembly Insurance Committee: Favorable refer to committee Codes",17,6,0,1,24
1174677,823387,2019-03-18,Assembly,"Assembly Codes Committee: Favorable refer to committee Ways and Means",17,4,0,1,22
1174682,970816,2020-07-13,Assembly,"Assembly Health Committee: Held for Consideration",18,6,0,2,26
1174698,810706,2019-02-27,Assembly,"Assembly Real Property Taxation Committee: Favorable refer to committee Ways and Means",8,1,0,1,10
1174735,971154,2020-07-14,Assembly,"Assembly Insurance Committee: Held for Consideration",14,6,0,2,22
1174750,859757,2019-05-06,Assembly,"Assembly Insurance Committee: Favorable refer to committee Codes",22,0,0,2,24
1174750,859758,2019-05-07,Assembly,"Assembly Codes Committee: Favorable",20,0,0,2,22
1174750,864257,2019-05-14,Assembly,"Assembly Floor Vote - Final Passage",141,0,0,9,150
1174767,796687,2019-02-11,Assembly,"Assembly Health Committee: Favorable refer to committee Ways and Means",24,0,0,2,26
1174767,877746,2019-06-04,Assembly,"Assembly Ways And Means Committee: Favorable refer to committee Rules",33,0,0,2,35
1174767,880405,2019-06-11,Assembly,"Assembly Rules Committee: Favorable",25,0,0,6,31
1174767,881782,2019-06-13,Assembly,"Assembly Floor Vote - Final Passage",146,0,0,4,150
1174767,886624,2019-06-19,Senate,"Senate Floor Vote - Final Passage",62,0,0,0,62
1174799,796645,2019-02-11,Assembly,"Assembly Health Committee: Favorable refer to committee Ways and Means",24,0,0,2,26
1174814,796640,2019-02-11,Assembly,"Assembly Health Committee: Favorable refer to committee Ways and Means",24,0,0,2,26
1174892,971323,2020-07-14,Assembly,"Assembly Higher Education Committee: Held for Consideration",18,7,0,0,25
1174902,796643,2019-02-11,Assembly,"Assembly Health Committee: Favorable",24,0,0,2,26
1174902,864876,2019-05-14,Senate,"Senate Floor Vote - Final Passage",59,0,0,3,62
1174902,864877,2019-05-14,Assembly,"Assembly Floor Vote - Final Passage",137,4,0,9,150
1174911,796656,2019-02-11,Assembly,"Assembly Health Committee: Favorable refer to committee Ways and Means",17,7,0,2,26
1174920,857418,2019-04-30,Assembly,"Assembly Mental Health Committee: Favorable refer to committee Ways and Means",11,0,0,2,13
1174920,874778,2019-05-30,Assembly,"Assembly Ways And Means Committee: Favorable",31,0,0,4,35
1174920,877758,2019-06-04,Assembly,"Assembly Floor Vote - Final Passage",147,0,0,3,150
1174920,882191,2019-06-14,Senate,"Senate Floor Vote - Final Passage",62,0,0,0,62
1175061,860976,2019-05-07,Senate,"Senate Committee Vote",7,0,0,0,7
1175098,875563,2019-05-29,Senate,"Senate Codes Committee Vote",8,5,0,0,13
1175103,786901,2019-01-28,Assembly,"Assembly Rules Committee: Favorable",29,0,0,2,31
1175103,786902,2019-01-28,Assembly,"Assembly Ways And Means Committee: Favorable refer to committee Rules",32,0,0,3,35
1175110,877286,2019-06-04,Senate,"Senate Floor Vote - Final Passage",40,22,0,0,62
1175110,877809,2019-06-04,Senate,"Senate Rules Committee Vote",12,7,0,0,19
1175197,798203,2019-02-12,Senate,"Senate Cities Committee Vote",7,0,0,0,7
1175229,884769,2019-05-06,Senate,"Senate Codes Committee Vote",12,1,0,0,13
1175229,886553,2019-06-19,Senate,"Senate Floor Vote - Final Passage",43,19,0,0,62
1175229,966083,2020-06-08,Senate,"Senate Floor Vote - Final Passage",59,3,0,0,62
1175229,967211,2020-05-28,Senate,"Senate Rules Committee Vote",18,1,0,0,19
1175260,864188,2019-03-26,Senate,"Senate Rules Committee Vote",19,0,0,0,19
1175260,864189,2019-05-14,Senate,"Senate Floor Vote - Final Passage",59,0,0,3,62
1175260,903134,2020-01-14,Senate,"Senate Veterans, Homeland Security and Military Affairs Committee Vote",8,0,0,1,9
1175260,936418,2020-02-26,Senate,"Senate Floor Vote - Final Passage",60,0,0,2,62
1175266,786911,2019-01-28,Senate,"Senate Floor Vote - Final Passage",63,0,0,0,63
1175266,787563,2019-01-28,Senate,"Senate Rules Committee Vote",19,0,0,0,19
1175266,787564,2019-01-28,Assembly,"Assembly Floor Vote - Final Passage",87,57,0,6,150
1175288,883025,2019-06-17,Senate,"Senate Floor Vote - Final Passage",41,21,0,0,62
1175288,883026,2019-06-17,Senate,"Senate Rules Committee Vote",15,4,0,0,19
1175333,884528,2019-06-18,Senate,"Senate Rules Committee Vote",19,0,0,0,19
1175333,885000,2019-06-18,Senate,"Senate Floor Vote - Final Passage",62,0,0,0,62
1175338,819900,2019-03-12,Senate,"Senate Committee Vote",6,0,0,0,6
1175376,815341,2019-03-05,Senate,"Senate Social Services Committee Vote",6,1,0,0,7
1175383,886507,2019-06-20,Senate,"Senate Floor Vote - Final Passage",62,0,0,0,62
1175383,887347,2019-06-20,Senate,"Senate Rules Committee Vote",19,0,0,0,19
1175389,868594,2019-05-21,Senate,"Senate Mental Health and Developmental Disabilities Committee Vote",7,0,0,0,7
1175389,902898,2020-01-15,Senate,"Senate Mental Health and Developmental Disabilities Committee Vote",7,0,0,0,7
1175392,874835,2019-05-21,Senate,"Senate Housing, Construction and Community Development Committee Vote",11,0,0,0,11
1175392,875532,2019-05-30,Senate,"Senate Floor Vote - Final Passage",58,0,0,4,62
1175396,786903,2019-01-28,Assembly,"Assembly Rules Committee: Favorable",29,0,0,2,31
1175396,786904,2019-01-28,Assembly,"Assembly Ways And Means Committee: Favorable refer to committee Rules",27,5,0,3,35
1175396,786905,2019-01-28,Assembly,"Assembly Real Property Taxation Committee: Favorable refer to committee Ways and Means",9,0,0,1,10
1175396,787536,2019-01-28,Assembly,"Assembly Floor Vote - Final Passage",122,22,0,6,150
1175396,788093,2019-01-29,Senate,"Senate Floor Vote - Final Passage",63,0,0,0,63
1175402,878705,2019-05-30,Senate,"Senate Housing, Construction and Community Development Committee Vote",8,2,0,1,11
1175402,878978,2019-06-06,Senate,"Senate Floor Vote - Final Passage",61,0,0,1,62
1175405,874211,2019-05-29,Senate,"Senate Codes Committee Vote",8,5,0,0,13
1175405,964696,2020-06-10,Senate,"Senate Floor Vote - Final Passage",45,17,0,0,62
1175405,965331,2020-06-10,Assembly,"Assembly Floor Vote - Final Passage",97,47,0,3,147
1175405,966209,2020-05-28,Senate,"Senate Rules Committee Vote",17,2,0,0,19
1175405,966528,2020-06-08,Senate,"Senate Finance Committee Vote",19,4,0,0,23
1175458,884730,2019-05-29,Senate,"Senate Local Government Committee Vote",6,1,0,0,7
1175458,886715,2019-06-19,Senate,"Senate Floor Vote - Final Passage",47,15,0,0,62
1175458,901957,2020-01-13,Senate,"Senate Local Government Committee Vote",6,0,0,1,7
1175460,811550,2019-02-04,Senate,"Senate Social Services Committee Vote",7,0,0,0,7
1175460,811551,2019-02-28,Senate,"Senate Floor Vote - Final Passage",61,1,0,1,63
1175460,864279,2019-05-14,Assembly,"Assembly Floor Vote - Final Passage",141,0,0,9,150
1175512,859756,2019-05-06,Assembly,"Assembly Insurance Committee: Favorable refer to committee Codes",22,0,0,2,24
1175512,877364,2019-06-04,Assembly,"Assembly Codes Committee: Favorable refer to committee Rules",22,0,0,0,22
1175512,877969,2019-06-05,Assembly,"Assembly Rules Committee: Favorable",27,0,0,4,31
1175552,886621,2019-06-19,Senate,"Senate Floor Vote - Final Passage",46,16,0,0,62
1175552,886622,2019-06-20,Assembly,"Assembly Floor Vote - Final Passage",104,42,0,4,150
1175552,887130,2019-06-19,Senate,"Senate Rules Committee Vote",18,1,0,0,19
1175554,811903,2019-02-28,Assembly,"Assembly Health Committee: Favorable",18,7,0,1,26
1175554,829578,2019-03-26,Assembly,"Assembly Floor Vote - Final Passage",109,39,0,2,150
1175560,870265,2019-05-21,Assembly,"Assembly Insurance Committee: Favorable refer to committee Codes",23,0,0,1,24
1175560,875071,2019-05-30,Assembly,"Assembly Codes Committee: Favorable",19,0,0,3,22
1175560,877953,2019-06-04,Assembly,"Assembly Floor Vote - Final Passage",147,0,0,3,150
1175592,857570,2019-04-30,Assembly,"Assembly Judiciary Committee: Favorable",17,2,0,2,21
1175604,810988,2019-02-28,Assembly,"Assembly Health Committee: Favorable refer to committee Codes",25,0,0,1,26
1175646,868410,2019-05-21,Assembly,"Assembly Insurance Committee: Favorable refer to committee Codes",23,0,0,1,24
1175646,877505,2019-06-04,Assembly,"Assembly Codes Committee: Favorable refer to committee Rules",22,0,0,0,22
1175646,877947,2019-06-05,Assembly,"Assembly Rules Committee: Favorable",27,0,0,4,31
1175646,883123,2019-06-17,Assembly,"Assembly Floor Vote - Final Passage",146,1,0,3,150
1175646,886634,2019-06-19,Senate,"Senate Floor Vote - Final Passage",56,6,0,0,62
1175679,878973,2019-06-06,Assembly,"Assembly Environmental Conservation Committee: Favorable refer to committee Ways and Means",28,0,0,2,30
1175679,881302,2019-06-13,Assembly,"Assembly Ways And Means Committee: Favorable refer to committee Rules",29,0,0,6,35
1175679,882430,2019-06-17,Assembly,"Assembly Rules Committee: Favorable",26,0,0,5,31
1175713,864540,2019-05-14,Assembly,"Assembly Health Committee: Favorable",16,8,0,2,26
1175713,867881,2019-05-20,Assembly,"Assembly Floor Vote - Final Passage",120,23,0,7,150
1175748,914745,2020-02-04,Assembly,"Assembly Health Committee: Favorable",18,5,0,3,26
1175748,972838,2020-07-21,Assembly,"Assembly Floor Vote - Final Passage",102,40,0,3,145
1175847,971407,2020-07-16,Assembly,"Assembly Governmental Operations Committee: Favorable refer to committee Ways and Means",14,0,0,0,14
1175847,971730,2020-07-17,Assembly,"Assembly Ways And Means Committee: Favorable refer to committee Rules",32,0,0,2,34
1175847,972178,2020-07-20,Assembly,"Assembly Rules Committee: Favorable",27,0,0,3,30
1175847,972247,2020-07-20,Assembly,"Assembly Floor Vote - Final Passage",141,0,0,4,145
1175889,854594,2019-02-04,Senate,"Senate Energy and Telecommunications Committee Vote",9,0,0,0,9
1175889,854595,2019-04-29,Senate,"Senate Floor Vote - Final Passage",61,0,0,1,62
1175889,904817,2020-01-22,Senate,"Senate Energy and Telecommunications Committee Vote",9,0,0,0,9
1175889,937069,2020-02-27,Senate,"Senate Floor Vote - Final Passage",59,0,0,3,62
1175889,972730,2020-07-21,Assembly,"Assembly Floor Vote - Final Passage",142,0,0,3,145
1175901,942494,2020-03-03,Senate,"Senate Committee Vote",5,2,0,0,7
1175901,972944,2020-07-21,Senate,"Senate Finance Committee Vote",17,6,0,0,23
1175901,973675,2020-07-22,Senate,"Senate Floor Vote - Final Passage",41,19,0,0,60
1175901,973777,2020-07-21,Senate,"Senate Finance Committee Vote",17,6,0,0,23
1175924,868261,2019-05-21,Assembly,"Assembly Governmental Employees Committee: Favorable refer to committee Ways and Means",14,0,0,0,14
1175924,878110,2019-06-05,Assembly,"Assembly Ways And Means Committee: Favorable refer to committee Rules",31,0,0,4,35
1175924,880232,2019-06-11,Assembly,"Assembly Rules Committee: Favorable",25,0,0,6,31
1175959,878384,2019-06-05,Assembly,"Assembly Insurance Committee: Favorable refer to committee Rules",24,0,0,0,24
1175959,880542,2019-06-11,Assembly,"Assembly Rules Committee: Favorable",25,0,0,6,31
1175965,829026,2019-03-26,Senate,"Senate Investigations and Government Operations Committee Vote",7,0,0,0,7
1175965,839610,2019-04-09,Senate,"Senate Finance Committee Vote",22,1,0,0,23
1175965,856124,2019-05-01,Senate,"Senate Floor Vote - Final Passage",45,17,0,0,62
1175988,878220,2019-06-05,Assembly,"Assembly Health Committee: Favorable refer to committee Rules",25,0,0,1,26
1175988,880410,2019-06-11,Assembly,"Assembly Rules Committee: Favorable",25,0,0,6,31
1175988,884014,2019-06-18,Assembly,"Assembly Floor Vote - Final Passage",145,3,0,2,150
1175988,886278,2019-06-19,Senate,"Senate Floor Vote - Final Passage",62,0,0,0,62
1175994,792027,2019-02-04,Senate,"Senate Social Services Committee Vote",7,0,0,0,7
1175994,875376,2019-05-30,Senate,"Senate Floor Vote - Final Passage",55,3,0,4,62
1175994,875377,2019-05-30,Senate,"Senate Rules Committee Vote",18,0,0,1,19
1176012,811957,2019-02-28,Assembly,"Assembly Health Committee: Favorable refer to committee Codes",25,0,0,1,26
1176012,813660,2019-03-05,Assembly,"Assembly Codes Committee: Favorable",18,4,0,0,22
1176030,964539,2020-06-10,Assembly,"Assembly Rules Committee: Favorable",28,0,0,3,31
1176030,964540,2020-06-10,Assembly,"Assembly Ways And Means Committee: Favorable refer to committee Rules",31,0,0,4,35
1176030,965403,2020-06-10,Assembly,"Assembly Floor Vote - Final Passage",144,0,0,3,147
1176045,820762,2019-03-12,Assembly,"Assembly Energy Committee: Favorable refer to committee Ways and Means",16,0,0,1,17
1176098,839377,2019-04-09,Senate,"Senate Education Committee Vote",15,0,0,0,15
1176098,860895,2019-05-07,Senate,"Senate Finance Committee Vote",23,0,0,0,23
1176098,864737,2019-05-15,Senate,"Senate Floor Vote - Final Passage",58,0,0,4,62
1176098,875649,2019-05-30,Assembly,"Assembly Floor Vote - Final Passage",143,0,0,7,150
1176117,839088,2019-04-09,Assembly,"Assembly Higher Education Committee: Held for Consideration",15,11,0,0,26
1176119,971159,2020-07-14,Assembly,"Assembly Insurance Committee: Held for Consideration",14,6,0,2,22
1176133,884049,2019-06-18,Assembly,"Assembly Floor Vote - Final Passage",106,42,0,2,150
1176133,884588,2019-06-18,Senate,"Senate Rules Committee Vote",17,2,0,0,19
1176133,885074,2019-06-18,Senate,"Senate Floor Vote - Final Passage",47,15,0,0,62
1176144,811275,2019-02-28,Assembly,"Assembly Local Governments Committee: Favorable",15,0,0,4,19
1176144,830757,2019-03-27,Assembly,"Assembly Floor Vote - Final Passage",145,3,0,2,150
1176144,839696,2019-04-09,Senate,"Senate Floor Vote - Final Passage",50,10,0,2,62
1176146,882856,2019-05-21,Senate,"Senate Health Committee Vote",13,2,0,0,15
1176146,882857,2019-06-17,Senate,"Senate Floor Vote - Final Passage",50,12,0,0,62
1176162,813538,2019-03-04,Senate,"Senate Local Government Committee Vote",7,0,0,0,7
1176162,884395,2019-06-18,Senate,"Senate Rules Committee Vote",14,5,0,0,19
1176162,885454,2019-06-18,Senate,"Senate Floor Vote - Final Passage",49,13,0,0,62
1176162,902451,2020-01-13,Senate,"Senate Local Government Committee Vote",6,0,0,1,7
1176168,857454,2019-04-30,Assembly,"Assembly Health Committee: Favorable refer to committee Codes",22,3,0,1,26
1176168,880380,2019-06-11,Assembly,"Assembly Codes Committee: Favorable refer to committee Ways and Means",18,4,0,0,22
1176170,819859,2019-03-12,Assembly,"Assembly Insurance Committee: Favorable refer to committee Codes",23,0,0,1,24
1176170,823419,2019-03-18,Assembly,"Assembly Codes Committee: Favorable",21,0,0,1,22
1176170,841883,2019-04-10,Assembly,"Assembly Floor Vote - Final Passage",139,2,0,9,150
1176170,877533,2019-06-03,Senate,"Senate Floor Vote - Final Passage",62,0,0,0,62
1176207,876772,2019-05-20,Senate,"Senate Codes Committee Vote",13,0,0,0,13
1176207,876773,2019-06-03,Senate,"Senate Floor Vote - Final Passage",62,0,0,0,62
1176207,902105,2020-01-13,Senate,"Senate Codes Committee Vote",13,0,0,0,13
1176207,972413,2020-07-21,Senate,"Senate Floor Vote - Final Passage",60,0,0,0,60
1176291,877054,2019-06-03,Assembly,"Assembly Higher Education Committee: Held for Consideration",18,7,0,1,26
1176332,855664,2019-04-30,Senate,"Senate Transportation Committee Vote",14,1,0,0,15
1176342,971322,2020-07-14,Assembly,"Assembly Higher Education Committee: Held for Consideration",18,7,0,0,25
1176366,877012,2019-06-03,Assembly,"Assembly Social Services Committee: Favorable refer to committee Ways and Means",11,5,0,2,18
1176378,861601,2019-05-07,Assembly,"Assembly Transportation Committee: Favorable refer to committee Codes",20,3,0,2,25
1176378,868580,2019-05-21,Assembly,"Assembly Codes Committee: Favorable",15,6,0,1,22
1176393,833864,2019-04-02,Assembly,"Assembly Local Governments Committee: Favorable",17,0,0,2,19
1176393,838695,2019-04-08,Assembly,"Assembly Floor Vote - Final Passage",139,0,0,11,150
1176393,882188,2019-06-14,Senate,"Senate Floor Vote - Final Passage",51,11,0,0,62
1176403,841750,2019-04-09,Assembly,"Assembly Insurance Committee: Favorable",24,0,0,0,24
1176412,878615,2019-05-20,Senate,"Senate Codes Committee Vote",13,0,0,0,13
1176412,879077,2019-06-06,Senate,"Senate Floor Vote - Final Passage",61,0,0,1,62
1176412,906094,2020-01-27,Senate,"Senate Codes Committee Vote",12,0,0,0,12
1176412,973070,2020-07-21,Senate,"Senate Floor Vote - Final Passage",60,0,0,0,60
1176484,841222,2019-04-09,Assembly,"Assembly Insurance Committee: Favorable refer to committee Codes",23,1,0,0,24
1176484,857115,2019-04-30,Assembly,"Assembly Codes Committee: Favorable",20,0,0,2,22
1176484,859657,2019-05-06,Assembly,"Assembly Floor Vote - Final Passage",142,0,0,8,150
1176488,796708,2019-02-11,Assembly,"Assembly Health Committee: Favorable refer to committee Codes",17,7,0,2,26
1176488,819195,2019-03-12,Assembly,"Assembly Codes Committee: Favorable",15,6,0,1,22
1176488,877843,2019-06-04,Assembly,"Assembly Floor Vote - Final Passage",109,37,0,4,150
1176510,796675,2019-02-11,Assembly,"Assembly Health Committee: Favorable refer to committee Ways and Means",24,0,0,2,26
1176542,816479,2019-03-06,Assembly,"Assembly Corporations, Authorities And Commissions Committee: Favorable",21,3,0,2,26
1176542,820611,2019-03-12,Assembly,"Assembly Floor Vote - Final Passage",135,7,0,8,150
1176542,880180,2019-06-11,Senate,"Senate Floor Vote - Final Passage",61,0,0,1,62
1176562,970845,2020-07-13,Assembly,"Assembly Corporations, Authorities And Commissions Committee: Held for Consideration",18,8,0,0,26
1176566,877889,2019-06-05,Assembly,"Assembly Insurance Committee: Favorable refer to committee Rules",24,0,0,0,24
1176566,880406,2019-06-11,Assembly,"Assembly Rules Committee: Favorable",25,0,0,6,31
1176566,882003,2019-06-13,Assembly,"Assembly Floor Vote - Final Passage",146,0,0,4,150
1176566,882821,2019-06-17,Senate,"Senate Floor Vote - Final Passage",61,1,0,0,62
1176590,861500,2019-05-07,Assembly,"Assembly Health Committee: Favorable",16,6,0,4,26
1176597,914370,2020-02-04,Assembly,"Assembly Health Committee: Favorable",17,6,0,3,26
1176599,839330,2019-04-08,Senate,"Senate Local Government Committee Vote",7,0,0,0,7
1176604,861596,2019-05-07,Assembly,"Assembly Transportation Committee: Held for Consideration",16,7,0,2,25
1176634,934158,2020-02-25,Assembly,"Assembly Labor Committee: Favorable",25,3,0,1,29
1176634,973027,2020-07-21,Assembly,"Assembly Floor Vote - Final Passage",110,32,0,3,145
1176634,973617,2020-07-23,Senate,"Senate Floor Vote - Final Passage",46,14,0,0,60
1176644,864565,2019-05-14,Senate,"Senate Crime Victims, Crime and Correction Committee Vote",5,2,0,0,7
1176658,970745,2020-07-13,Assembly,"Assembly Health Committee: Favorable refer to committee Rules",24,0,0,2,26
1176658,972591,2020-07-21,Assembly,"Assembly Floor Vote - Final Passage",142,0,0,3,145
1176658,972592,2020-07-21,Assembly,"Assembly Rules Committee: Favorable",26,0,0,4,30
1176658,973616,2020-07-23,Senate,"Senate Floor Vote - Final Passage",60,0,0,0,60
1176680,877742,2019-06-04,Assembly,"Assembly Ways And Means Committee: Favorable refer to committee Rules",23,10,0,2,35
1176680,880550,2019-06-11,Assembly,"Assembly Rules Committee: Favorable",23,2,0,6,31
1176690,882180,2019-06-14,Assembly,"Assembly Governmental Operations Committee: Favorable refer to committee Ways and Means",8,4,0,2,14
1176715,879043,2019-05-29,Senate,"Senate Codes Committee Vote",13,0,0,0,13
1176715,879044,2019-06-06,Senate,"Senate Floor Vote - Final Passage",61,0,0,1,62
1176715,902266,2020-01-13,Senate,"Senate Codes Committee Vote",13,0,0,0,13
1176715,972393,2020-07-21,Senate,"Senate Floor Vote - Final Passage",60,0,0,0,60
1176728,861254,2019-05-07,Assembly,"Assembly Judiciary Committee: Favorable refer to committee Codes",15,5,0,1,21
1176728,868515,2019-05-21,Assembly,"Assembly Codes Committee: Favorable",16,5,0,1,22
1176740,878321,2019-06-05,Assembly,"Assembly Small Business Committee: Favorable refer to committee Ways and Means",16,0,0,1,17
1176740,880340,2019-06-11,Assembly,"Assembly Ways And Means Committee: Favorable refer to committee Rules",33,0,0,2,35
1176740,881350,2019-06-13,Assembly,"Assembly Rules Committee: Favorable",26,0,0,5,31
1176751,861469,2019-05-07,Assembly,"Assembly Health Committee: Favorable refer to committee Codes",22,0,0,4,26
1176751,875188,2019-05-30,Assembly,"Assembly Codes Committee: Favorable refer to committee Ways and Means",19,0,0,3,22
1176763,970772,2020-07-13,Assembly,"Assembly Health Committee: Held for Consideration",18,6,0,2,26
1176772,838917,2019-04-09,Assembly,"Assembly Aging Committee: Favorable refer to committee Ways and Means",28,0,0,2,30
1176772,857131,2019-04-30,Assembly,"Assembly Ways And Means Committee: Favorable",33,0,0,2,35
1176774,814509,2019-03-05,Assembly,"Assembly Codes Committee: Favorable",16,6,0,0,22
1176776,840799,2019-04-09,Assembly,"Assembly Aging Committee: Favorable refer to committee Ways and Means",28,0,0,2,30
1176838,883808,2019-06-17,Assembly,"Assembly Local Governments Committee: Held for Consideration",13,5,0,1,19
1176856,934126,2020-02-25,Assembly,"Assembly Correction Committee: Favorable refer to committee Ways and Means",8,2,0,3,13
1176861,792276,2019-02-04,Assembly,"Assembly Banks Committee: Favorable refer to committee Codes",26,0,0,5,31
1176861,856989,2019-04-30,Assembly,"Assembly Codes Committee: Favorable",20,0,0,2,22
1176861,859360,2019-05-06,Senate,"Senate Floor Vote - Final Passage",61,0,0,1,62
1176861,859615,2019-05-06,Assembly,"Assembly Floor Vote - Final Passage",142,0,0,8,150
1176883,878348,2019-06-05,Assembly,"Assembly Local Governments Committee: Favorable refer to committee Rules",18,0,0,1,19
1176883,880555,2019-06-11,Assembly,"Assembly Rules Committee: Favorable",25,0,0,6,31
1176893,950543,2020-03-10,Assembly,"Assembly Transportation Committee: Favorable refer to committee Codes",24,1,0,0,25
1176913,970917,2020-07-13,Assembly,"Assembly Consumer Affairs And Protection Committee: Favorable refer to committee Codes",12,3,0,1,16
1176913,971764,2020-07-17,Assembly,"Assembly Codes Committee: Favorable refer to committee Rules",21,0,0,1,22
1176913,973028,2020-07-22,Assembly,"Assembly Rules Committee: Favorable",19,6,0,5,30
1176963,971257,2020-07-14,Assembly,"Assembly Education Committee: Held for Consideration",23,6,0,2,31
1177093,820052,2019-03-04,Senate,"Senate Local Government Committee Vote",7,0,0,0,7
1177093,820053,2019-03-12,Senate,"Senate Floor Vote - Final Passage",60,1,0,1,62
1177093,874776,2019-05-29,Assembly,"Assembly Floor Vote - Final Passage",140,0,0,10,150
1177098,881110,2019-06-11,Assembly,"Assembly Codes Committee: Favorable refer to committee Rules",16,6,0,0,22
1177121,861592,2019-05-07,Assembly,"Assembly Transportation Committee: Favorable refer to committee Ways and Means",20,3,0,2,25
1177155,857109,2019-04-30,Assembly,"Assembly Housing Committee: Favorable refer to committee Codes",25,0,0,3,28
1177155,859826,2019-05-07,Assembly,"Assembly Codes Committee: Favorable",20,0,0,2,22
1177155,863580,2019-05-13,Assembly,"Assembly Floor Vote - Final Passage",140,0,0,10,150
1177155,972483,2020-07-21,Senate,"Senate Floor Vote - Final Passage",54,6,0,0,60
1177181,972090,2020-07-17,Assembly,"Assembly Ways And Means Committee: Held for Consideration",22,10,0,2,34
1177220,913882,2020-02-04,Assembly,"Assembly Judiciary Committee: Favorable",17,3,0,1,21
1177232,878946,2019-06-06,Assembly,"Assembly Environmental Conservation Committee: Favorable refer to committee Rules",28,0,0,2,30
1177232,880512,2019-06-11,Assembly,"Assembly Rules Committee: Favorable",25,0,0,6,31
1177242,875640,2019-05-29,Assembly,"Assembly Environmental Conservation Committee: Favorable refer to committee Codes",29,0,0,1,30
1177242,877413,2019-06-04,Assembly,"Assembly Codes Committee: Favorable refer to committee Ways and Means",19,3,0,0,22
1177266,874644,2019-05-29,Assembly,"Assembly Environmental Conservation Committee: Favorable refer to committee Codes",29,0,0,1,30
1177266,877384,2019-06-04,Assembly,"Assembly Codes Committee: Favorable refer to committee Rules",22,0,0,0,22
1177266,877978,2019-06-05,Assembly,"Assembly Rules Committee: Favorable",27,0,0,4,31
1177266,879316,2019-06-06,Assembly,"Assembly Floor Vote - Final Passage",129,8,0,13,150
1177266,880503,2019-06-11,Senate,"Senate Floor Vote - Final Passage",49,12,0,1,62
1177290,863944,2019-05-14,Assembly,"Assembly Aging Committee: Favorable refer to committee Ways and Means",29,0,0,1,30
1177290,868795,2019-05-21,Assembly,"Assembly Ways And Means Committee: Favorable",31,1,0,3,35
1177297,971490,2020-07-16,Assembly,"Assembly Transportation Committee: Held for Consideration",16,6,0,2,24
1177303,869263,2019-05-07,Senate,"Senate Elections Committee Vote",6,0,0,1,7
1177303,869264,2019-05-22,Senate,"Senate Floor Vote - Final Passage",61,0,0,1,62
1177303,880595,2019-06-11,Senate,"Senate Floor Vote - Final Passage",60,1,0,1,62
1177303,885118,2019-06-19,Assembly,"Assembly Floor Vote - Final Passage",127,21,0,2,150
1177435,874637,2019-05-29,Assembly,"Assembly Banks Committee: Favorable refer to committee Codes",30,0,0,1,31
1177435,877429,2019-06-04,Assembly,"Assembly Codes Committee: Favorable refer to committee Rules",21,1,0,0,22
1177435,877989,2019-06-05,Assembly,"Assembly Rules Committee: Favorable",20,7,0,4,31
1177446,839847,2019-03-11,Senate,"Senate Crime Victims, Crime and Correction Committee Vote",5,2,0,0,7
1177446,839848,2019-04-09,Senate,"Senate Floor Vote - Final Passage",41,19,0,2,62
1177781,882706,2019-06-17,Assembly,"Assembly Banks Committee: Favorable refer to committee Ways and Means",25,4,0,2,31
1177797,829011,2019-03-26,Senate,"Senate Committee Vote",7,0,0,0,7
1177803,878990,2019-06-06,Assembly,"Assembly Corporations, Authorities And Commissions Committee: Favorable refer to committee Rules",24,1,0,1,26
1177803,881368,2019-06-13,Assembly,"Assembly Rules Committee: Favorable",26,0,0,5,31
1177809,860969,2019-05-07,Senate,"Senate Committee Vote",7,0,0,0,7
1177834,825747,2019-03-12,Senate,"Senate Corporations, Authorities and Commissions Committee Vote",7,0,0,0,7
1177834,825748,2019-03-20,Senate,"Senate Floor Vote - Final Passage",62,0,0,0,62
1177834,903959,2020-01-21,Senate,"Senate Corporations, Authorities and Commissions Committee Vote",7,0,0,0,7
1177834,972354,2020-07-21,Senate,"Senate Floor Vote - Final Passage",60,0,0,0,60
1177845,878046,2019-06-05,Assembly,"Assembly Banks Committee: Favorable refer to committee Rules",21,8,0,2,31
1177845,881364,2019-06-13,Assembly,"Assembly Rules Committee: Favorable",26,0,0,5,31
1177845,884468,2019-06-18,Assembly,"Assembly Floor Vote - Final Passage",120,28,0,2,150
1177845,973556,2020-07-22,Senate,"Senate Floor Vote - Final Passage",53,7,0,0,60
1177878,796683,2019-02-11,Assembly,"Assembly Codes Committee: Favorable refer to committee Ways and Means",22,0,0,0,22
1177878,796684,2019-02-11,Assembly,"Assembly Ways And Means Committee: Favorable",31,0,0,4,35
1177878,796685,2019-02-11,Assembly,"Assembly Health Committee: Favorable refer to committee Codes",24,0,0,2,26
1177878,825745,2019-03-20,Senate,"Senate Floor Vote - Final Passage",62,0,0,0,62
1177878,826119,2019-03-20,Assembly,"Assembly Floor Vote - Final Passage",144,0,0,6,150
1177886,860972,2019-05-07,Senate,"Senate Committee Vote",7,0,0,0,7
1177886,884586,2019-06-18,Senate,"Senate Rules Committee Vote",19,0,0,0,19
1177886,885073,2019-06-18,Senate,"Senate Floor Vote - Final Passage",62,0,0,0,62
1177895,810246,2019-02-27,Assembly,"Assembly Judiciary Committee: Favorable refer to committee Codes",16,5,0,0,21
1177906,883346,2019-06-05,Senate,"Senate Rules Committee Vote",19,0,0,0,19
1177906,885373,2019-06-18,Senate,"Senate Floor Vote - Final Passage",62,0,0,0,62
1177906,935263,2020-02-25,Senate,"Senate Transportation Committee Vote",15,0,0,0,15
1177908,882613,2019-06-17,Assembly,"Assembly Rules Committee: Favorable",24,1,0,6,31
1177908,882614,2019-06-17,Assembly,"Assembly Ways And Means Committee: Favorable refer to committee Rules",26,7,0,2,35
1177908,884062,2019-06-18,Assembly,"Assembly Floor Vote - Final Passage",116,32,0,2,150
1177908,886329,2019-06-19,Senate,"Senate Floor Vote - Final Passage",47,15,0,0,62
1178019,863902,2019-04-30,Senate,"Senate Veterans, Homeland Security and Military Affairs Committee Vote",9,0,0,0,9
1178019,863903,2019-05-14,Senate,"Senate Floor Vote - Final Passage",59,0,0,3,62
1178019,921436,2020-02-11,Senate,"Senate Veterans, Homeland Security and Military Affairs Committee Vote",9,0,0,0,9
1178019,973050,2020-07-21,Senate,"Senate Floor Vote - Final Passage",59,1,0,0,60
1178032,971631,2020-07-16,Assembly,"Assembly Governmental Operations Committee: Held for Consideration",10,4,0,0,14
1178033,878005,2019-06-05,Assembly,"Assembly Banks Committee: Favorable refer to committee Ways and Means",25,4,0,2,31
1178033,879259,2019-06-06,Assembly,"Assembly Ways And Means Committee: Favorable refer to committee Rules",24,7,0,4,35
1178033,880236,2019-06-11,Assembly,"Assembly Rules Committee: Favorable",24,1,0,6,31
1178077,814724,2019-03-06,Senate,"Senate Racing, Gaming and Wagering Committee Vote",7,0,0,0,7
1178135,839362,2019-04-09,Senate,"Senate Veterans, Homeland Security and Military Affairs Committee Vote",9,0,0,0,9
1178135,867288,2019-05-20,Senate,"Senate Rules Committee Vote",18,0,0,1,19
1178135,868159,2019-05-21,Senate,"Senate Floor Vote - Final Passage",61,0,0,1,62
1178149,861264,2019-05-07,Assembly,"Assembly Judiciary Committee: Favorable refer to committee Ways and Means",20,0,0,1,21
1178151,874926,2019-05-30,Assembly,"Assembly Consumer Affairs And Protection Committee: Favorable refer to committee Codes",15,0,0,1,16
1178151,877512,2019-06-04,Assembly,"Assembly Codes Committee: Favorable refer to committee Rules",22,0,0,0,22
1178151,877970,2019-06-05,Assembly,"Assembly Rules Committee: Favorable",27,0,0,4,31
1178151,879246,2019-06-06,Assembly,"Assembly Floor Vote - Final Passage",137,0,0,13,150
1178151,881997,2019-06-12,Senate,"Senate Floor Vote - Final Passage",62,0,0,0,62
1178181,971147,2020-07-14,Assembly,"Assembly Judiciary Committee: Held for Consideration",15,6,0,0,21
1178182,885375,2019-06-18,Senate,"Senate Floor Vote - Final Passage",62,0,0,0,62
1178182,886603,2019-06-18,Senate,"Senate Rules Committee Vote",19,0,0,0,19
1178184,878444,2019-02-28,Senate,"Senate Domestic Animal Welfare Committee Vote",7,0,0,0,7
1178184,878445,2019-06-04,Senate,"Senate Floor Vote - Final Passage",62,0,0,0,62
1178184,950224,2020-03-11,Senate,"Senate Domestic Animal Welfare Committee Vote",7,0,0,0,7
1178193,824615,2019-03-18,Senate,"Senate Agriculture Committee Vote",9,0,0,0,9
1178193,839835,2019-04-09,Senate,"Senate Finance Committee Vote",23,0,0,0,23
1178193,855386,2019-04-30,Senate,"Senate Floor Vote - Final Passage",62,0,0,0,62
1178193,883834,2019-06-13,Senate,"Senate Floor Vote - Final Passage",62,0,0,0,62
1178208,877111,2019-06-04,Assembly,"Assembly Veterans' Affairs Committee: Held for Consideration",10,8,0,1,19
1178223,906680,2020-01-28,Assembly,"Assembly Real Property Taxation Committee: Favorable refer to committee Codes",10,0,0,0,10
1178237,857204,2019-04-30,Assembly,"Assembly Judiciary Committee: Favorable refer to committee Ways and Means",17,2,0,2,21
1178257,825332,2019-03-19,Assembly,"Assembly Governmental Employees Committee: Favorable refer to committee Ways and Means",13,1,0,0,14
1178286,971120,2020-07-14,Assembly,"Assembly Environmental Conservation Committee: Held for Consideration",18,9,0,1,28
1178340,815205,2019-03-06,Assembly,"Assembly Health Committee: Favorable refer to committee Ways and Means",23,2,0,1,26
1178344,877197,2019-06-04,Assembly,"Assembly Housing Committee: Favorable refer to committee Codes",26,0,0,2,28
1178353,820785,2019-03-12,Assembly,"Assembly Tourism, Arts And Sports Development Committee: Favorable refer to committee Ways and Means",19,0,0,1,20
1178360,864704,2019-05-14,Assembly,"Assembly Consumer Affairs And Protection Committee: Favorable refer to committee Codes",15,0,0,1,16
1178360,868415,2019-05-21,Assembly,"Assembly Codes Committee: Favorable",21,0,0,1,22
1178360,875681,2019-05-30,Assembly,"Assembly Floor Vote - Final Passage",143,0,0,7,150
1178362,861020,2019-04-30,Senate,"Senate Judiciary Committee Vote",15,0,0,0,15
1178362,861021,2019-05-08,Senate,"Senate Floor Vote - Final Passage",53,8,0,1,62
1178362,903123,2020-01-14,Senate,"Senate Judiciary Committee Vote",14,1,0,0,15
1178362,934727,2020-02-25,Senate,"Senate Floor Vote - Final Passage",49,11,0,2,62
1178362,973155,2020-07-22,Assembly,"Assembly Floor Vote - Final Passage",97,45,0,3,145
1178392,830971,2019-03-26,Senate,"Senate Rules Committee Vote",19,0,0,0,19
1178392,830972,2019-03-28,Senate,"Senate Floor Vote - Final Passage",61,0,0,1,62
1178398,864275,2019-04-30,Senate,"Senate Transportation Committee Vote",14,1,0,0,15
1178398,864276,2019-05-15,Senate,"Senate Floor Vote - Final Passage",58,0,0,4,62
1178398,935384,2020-02-25,Senate,"Senate Transportation Committee Vote",15,0,0,0,15
1178398,972427,2020-07-21,Senate,"Senate Floor Vote - Final Passage",60,0,0,0,60
1178404,874642,2019-05-29,Assembly,"Assembly Banks Committee: Favorable",30,0,0,1,31
1178404,878100,2019-06-04,Assembly,"Assembly Floor Vote - Final Passage",147,0,0,3,150
1178404,883894,2019-06-18,Senate,"Senate Floor Vote - Final Passage",44,18,0,0,62
1178432,810955,2019-02-11,Senate,"Senate Children and Families Committee Vote",7,0,0,0,7
1178432,811601,2019-02-28,Senate,"Senate Floor Vote - Final Passage",62,0,0,1,63
1178432,819010,2019-03-11,Assembly,"Assembly Floor Vote - Final Passage",139,0,0,11,150
1178457,875658,2019-02-27,Senate,"Senate Investigations and Government Operations Committee Vote",7,0,0,0,7
1178457,875659,2019-05-29,Senate,"Senate Floor Vote - Final Passage",49,11,0,2,62
1178457,902600,2020-01-14,Senate,"Senate Investigations and Government Operations Committee Vote",6,1,0,0,7
1178457,972814,2020-07-21,Senate,"Senate Floor Vote - Final Passage",50,10,0,0,60
1178488,814517,2019-03-05,Assembly,"Assembly Judiciary Committee: Favorable",18,1,0,2,21
1178488,820369,2019-03-12,Assembly,"Assembly Floor Vote - Final Passage",140,2,0,8,150
1178488,831296,2019-03-28,Senate,"Senate Floor Vote - Final Passage",59,2,0,1,62
1178496,811746,2019-02-28,Assembly,"Assembly Health Committee: Favorable refer to committee Ways and Means",25,0,0,1,26
1178498,819972,2019-03-12,Senate,"Senate Corporations, Authorities and Commissions Committee Vote",7,0,0,0,7
1178505,809876,2019-02-27,Assembly,"Assembly Election Law Committee: Favorable refer to committee Ways and Means",13,0,0,3,16
1178514,878484,2019-06-04,Assembly,"Assembly Economic Development Committee: Favorable refer to committee Rules",17,7,0,2,26
1178514,880487,2019-06-11,Assembly,"Assembly Rules Committee: Favorable",25,0,0,6,31
1178516,857500,2019-04-30,Assembly,"Assembly Judiciary Committee: Favorable",15,4,0,2,21
1178519,809767,2019-02-27,Senate,"Senate Health Committee Vote",11,3,0,1,15
1178519,829807,2019-03-26,Senate,"Senate Rules Committee Vote",19,0,0,0,19
1178519,837571,2019-04-01,Senate,"Senate Floor Vote - Final Passage",52,9,0,1,62
1178530,863985,2019-05-13,Senate,"Senate Transportation Committee Vote",14,0,0,1,15
1178530,875222,2019-05-30,Senate,"Senate Floor Vote - Final Passage",56,2,0,4,62
1178530,875223,2019-05-30,Senate,"Senate Rules Committee Vote",18,0,0,1,19
1178560,880892,2019-05-30,Senate,"Senate Labor Committee Vote",13,0,0,0,13
1178560,882082,2019-06-12,Senate,"Senate Floor Vote - Final Passage",62,0,0,0,62
1178560,915494,2020-02-04,Senate,"Senate Labor Committee Vote",13,0,0,0,13
1178560,972963,2020-07-21,Senate,"Senate Floor Vote - Final Passage",60,0,0,0,60
1178564,855634,2019-04-30,Senate,"Senate Veterans, Homeland Security and Military Affairs Committee Vote",9,0,0,0,9
1178565,876675,2019-05-21,Senate,"Senate Consumer Protection Committee Vote",7,0,0,0,7
1178565,876676,2019-06-03,Senate,"Senate Floor Vote - Final Passage",61,1,0,0,62
1178565,902963,2020-01-15,Senate,"Senate Consumer Protection Committee Vote",7,0,0,0,7
1178617,972009,2020-07-17,Assembly,"Assembly Codes Committee: Held for Consideration",15,6,0,1,22
1178638,809761,2019-02-27,Assembly,"Assembly Real Property Taxation Committee: Favorable refer to committee Ways and Means",9,0,0,1,10
1178649,868308,2019-05-21,Assembly,"Assembly Transportation Committee: Favorable",25,0,0,0,25
1178649,877431,2019-06-03,Assembly,"Assembly Floor Vote - Final Passage",141,1,0,8,150
1178649,881785,2019-06-13,Senate,"Senate Floor Vote - Final Passage",62,0,0,0,62
1178671,947951,2019-02-28,Senate,"Senate Ethics And Internal Governance Committee Vote",7,0,0,0,7
1178671,949225,2020-03-10,Senate,"Senate Ethics And Internal Governance Committee Vote",7,0,0,0,7
1178706,857379,2019-04-30,Assembly,"Assembly Housing Committee: Favorable refer to committee Codes",17,8,0,3,28
1178706,880130,2019-06-11,Assembly,"Assembly Codes Committee: Favorable refer to committee Rules",16,6,0,0,22
1178717,878135,2019-06-05,Assembly,"Assembly Energy Committee: Held for Consideration",12,5,0,0,17
1178724,830963,2019-03-26,Senate,"Senate Rules Committee Vote",18,1,0,0,19
1178724,830964,2019-03-28,Senate,"Senate Floor Vote - Final Passage",61,0,0,1,62
1178724,940283,2020-03-02,Senate,"Senate Agriculture Committee Vote",9,0,0,0,9
1178724,948037,2020-03-10,Senate,"Senate Floor Vote - Final Passage",59,0,0,3,62
1178745,906956,2020-01-28,Assembly,"Assembly Real Property Taxation Committee: Favorable refer to committee Ways and Means",10,0,0,0,10
1178745,972862,2020-07-22,Assembly,"Assembly Ways And Means Committee: Favorable refer to committee Rules",32,0,0,2,34
1178745,973047,2020-07-22,Assembly,"Assembly Rules Committee: Favorable",29,0,0,1,30
1178763,798180,2019-02-12,Senate,"Senate Cities Committee Vote",7,0,0,0,7
1178763,934757,2020-02-25,Senate,"Senate Cities Committee Vote",7,0,0,0,7
1178788,868405,2019-05-21,Assembly,"Assembly Ways And Means Committee: Favorable",26,6,0,3,35
1178788,868406,2019-05-21,Assembly,"Assembly Governmental Operations Committee: Favorable refer to committee Ways and Means",10,4,0,0,14
1178788,874964,2019-05-29,Assembly,"Assembly Floor Vote - Final Passage",120,20,0,10,150
1178800,880045,2019-06-11,Senate,"Senate Rules Committee Vote",19,0,0,0,19
1178800,880558,2019-06-11,Senate,"Senate Floor Vote - Final Passage",61,0,0,1,62
1178800,886610,2019-06-21,Assembly,"Assembly Floor Vote - Final Passage",140,4,0,6,150
1178801,825350,2019-03-19,Assembly,"Assembly Governmental Employees Committee: Favorable refer to committee Ways and Means",13,1,0,0,14
1178813,885786,2019-02-04,Senate,"Senate Consumer Protection Committee Vote",7,0,0,0,7
1178813,885787,2019-04-30,Senate,"Senate Consumer Protection Committee Vote",7,0,0,0,7
1178813,886776,2019-06-20,Senate,"Senate Floor Vote - Final Passage",48,14,0,0,62
1178824,970910,2020-07-13,Assembly,"Assembly Corporations, Authorities And Commissions Committee: Favorable refer to committee Codes",24,2,0,0,26
1178824,971865,2020-07-17,Assembly,"Assembly Codes Committee: Favorable refer to committee Rules",21,0,0,1,22
1178824,972191,2020-07-20,Assembly,"Assembly Rules Committee: Favorable",27,0,0,3,30
1178826,839403,2019-04-09,Senate,"Senate Transportation Committee Vote",15,0,0,0,15
1178891,933473,2020-02-25,Assembly,"Assembly Governmental Operations Committee: Favorable refer to committee Codes",13,0,0,1,14
1178891,972059,2020-07-17,Assembly,"Assembly Codes Committee: Favorable refer to committee Rules",21,0,0,1,22
1178891,973772,2020-07-21,Assembly,"Assembly Rules Committee: Favorable",26,0,0,4,30
1178892,971939,2020-07-17,Assembly,"Assembly Codes Committee: Held for Consideration",15,6,0,1,22
1178904,971948,2020-07-17,Assembly,"Assembly Ways And Means Committee: Held for Consideration",22,10,0,2,34
1178971,810264,2019-02-27,Assembly,"Assembly Judiciary Committee: Favorable",16,5,0,0,21
1178985,810004,2019-02-27,Assembly,"Assembly Rules Committee: Favorable",27,0,0,4,31
1178985,810005,2019-02-27,Assembly,"Assembly Codes Committee: Favorable refer to committee Rules",21,0,0,1,22
1178985,810006,2019-02-27,Assembly,"Assembly Governmental Operations Committee: Favorable refer to committee Codes",13,0,0,1,14
1178985,810876,2019-02-27,Assembly,"Assembly Floor Vote - Final Passage",142,0,0,8,150
1178985,833241,2019-04-01,Senate,"Senate Floor Vote - Final Passage",61,0,0,1,62
1178998,864725,2019-05-14,Assembly,"Assembly Local Governments Committee: Favorable refer to committee Ways and Means",18,0,0,1,19
1178998,879374,2019-06-06,Assembly,"Assembly Ways And Means Committee: Favorable refer to committee Rules",25,6,0,4,35
1178998,880521,2019-06-11,Assembly,"Assembly Rules Committee: Favorable",24,1,0,6,31
1179006,809754,2019-02-27,Assembly,"Assembly Mental Health Committee: Favorable refer to committee Ways and Means",13,0,0,0,13
1179006,878587,2019-06-05,Assembly,"Assembly Ways And Means Committee: Favorable refer to committee Rules",30,1,0,4,35
1179006,880242,2019-06-11,Assembly,"Assembly Rules Committee: Favorable",25,0,0,6,31
1179006,881678,2019-06-13,Assembly,"Assembly Floor Vote - Final Passage",142,4,0,4,150
1179006,973408,2020-07-22,Senate,"Senate Floor Vote - Final Passage",60,0,0,0,60
1179052,971808,2020-07-16,Assembly,"Assembly Local Governments Committee: Held for Consideration",13,6,0,1,20
1179054,881807,2019-06-14,Assembly,"Assembly Transportation Committee: Favorable refer to committee Rules",24,0,0,1,25
1179054,884923,2019-06-19,Assembly,"Assembly Rules Committee: Favorable",27,0,0,4,31
1179054,886450,2019-06-21,Assembly,"Assembly Floor Vote - Final Passage",143,1,0,6,150
1179056,820764,2019-03-12,Assembly,"Assembly Election Law Committee: Favorable refer to committee Codes",15,0,0,1,16
1179056,838939,2019-04-09,Assembly,"Assembly Codes Committee: Favorable",17,5,0,0,22
1179073,878645,2019-06-05,Assembly,"Assembly Transportation Committee: Favorable refer to committee Codes",19,7,0,0,26
1179073,881417,2019-06-13,Assembly,"Assembly Codes Committee: Favorable refer to committee Rules",14,6,0,2,22
1179079,942064,2020-03-03,Assembly,"Assembly Children And Families Committee: Held for Consideration",11,4,0,1,16
1179084,884662,2019-02-27,Senate,"Senate Commerce, Economic Development and Small Business Committee Vote",9,0,0,0,9
1179084,886487,2019-06-19,Senate,"Senate Floor Vote - Final Passage",61,1,0,0,62
1179084,913975,2020-02-04,Senate,"Senate Commerce, Economic Development and Small Business Committee Vote",9,0,0,0,9
1179084,973071,2020-07-21,Senate,"Senate Floor Vote - Final Passage",59,1,0,0,60
1179100,823796,2019-03-18,Assembly,"Assembly Codes Committee: Favorable",21,0,0,1,22
1179100,830749,2019-03-27,Assembly,"Assembly Floor Vote - Final Passage",147,0,0,3,150
1179100,859622,2019-05-06,Senate,"Senate Floor Vote - Final Passage",61,0,0,1,62
1179102,824193,2019-03-19,Assembly,"Assembly Racing And Wagering Committee: Favorable refer to committee Ways and Means",11,0,0,0,11
1179102,868961,2019-05-21,Assembly,"Assembly Ways And Means Committee: Favorable",32,0,0,3,35
1179106,878470,2019-06-04,Assembly,"Assembly Governmental Operations Committee: Held for Consideration",8,4,0,2,14
1179121,839312,2019-04-09,Assembly,"Assembly Governmental Operations Committee: Favorable refer to committee Codes",13,0,0,1,14
1179121,857291,2019-04-30,Assembly,"Assembly Codes Committee: Favorable",20,0,0,2,22
1179121,860338,2019-05-06,Assembly,"Assembly Floor Vote - Final Passage",142,0,0,8,150
1179122,814512,2019-03-05,Assembly,"Assembly Judiciary Committee: Favorable refer to committee Codes",19,0,0,2,21
1179122,878350,2019-06-04,Assembly,"Assembly Codes Committee: Favorable refer to committee Rules",22,0,0,0,22
1179122,880539,2019-06-11,Assembly,"Assembly Rules Committee: Favorable",25,0,0,6,31
1179122,881838,2019-06-13,Assembly,"Assembly Floor Vote - Final Passage",145,1,0,4,150
1179122,882943,2019-06-17,Senate,"Senate Floor Vote - Final Passage",43,19,0,0,62
1179139,919678,2020-02-11,Assembly,"Assembly Consumer Affairs And Protection Committee: Favorable",15,1,0,0,16
1179159,881938,2019-06-12,Senate,"Senate Floor Vote - Final Passage",60,2,0,0,62
1179159,881939,2019-06-12,Senate,"Senate Rules Committee Vote",18,1,0,0,19
1179170,919858,2020-02-11,Senate,"Senate Housing, Construction and Community Development Committee Vote",11,0,0,0,11
1179170,919859,2020-02-11,Senate,"Senate Rules Committee Vote",19,0,0,0,19
1179170,921513,2020-02-12,Senate,"Senate Floor Vote - Final Passage",60,0,0,2,62
1179175,971798,2020-07-16,Assembly,"Assembly Local Governments Committee: Held for Consideration",15,4,0,1,20
1179182,857527,2019-04-30,Assembly,"Assembly Judiciary Committee: Favorable refer to committee Codes",13,6,0,2,21
1179182,859829,2019-05-07,Assembly,"Assembly Codes Committee: Favorable",13,7,0,2,22
1179210,878318,2019-06-05,Assembly,"Assembly Election Law Committee: Favorable refer to committee Rules",15,0,0,1,16
1179210,882442,2019-06-17,Assembly,"Assembly Rules Committee: Favorable",26,0,0,5,31
1179210,884123,2019-06-18,Assembly,"Assembly Floor Vote - Final Passage",146,0,0,4,150
1179210,886432,2019-06-19,Senate,"Senate Floor Vote - Final Passage",62,0,0,0,62
1179215,820800,2019-03-12,Assembly,"Assembly Environmental Conservation Committee: Favorable refer to committee Codes",29,0,0,1,30
1179215,823429,2019-03-18,Assembly,"Assembly Codes Committee: Favorable",21,0,0,1,22
1179215,829582,2019-03-26,Assembly,"Assembly Floor Vote - Final Passage",147,1,0,2,150
1179215,829892,2019-03-27,Senate,"Senate Floor Vote - Final Passage",56,5,0,1,62
1179216,886316,2019-06-19,Senate,"Senate Floor Vote - Final Passage",62,0,0,0,62
1179216,886317,2019-06-21,Assembly,"Assembly Floor Vote - Final Passage",144,0,0,6,150
1179216,887284,2019-06-19,Senate,"Senate Rules Committee Vote",19,0,0,0,19
1179226,825258,2019-03-19,Assembly,"Assembly Banks Committee: Favorable refer to committee Codes",29,0,0,2,31
1179226,840225,2019-04-09,Assembly,"Assembly Codes Committee: Favorable",22,0,0,0,22
1179226,861006,2019-05-07,Assembly,"Assembly Floor Vote - Final Passage",136,0,0,14,150
1179248,971937,2020-07-17,Assembly,"Assembly Ways And Means Committee: Held for Consideration",22,10,0,2,34
1179250,882203,2019-06-13,Assembly,"Assembly Codes Committee: Held for Consideration",14,6,0,2,22
1179252,949181,2020-03-11,Assembly,"Assembly Health Committee: Favorable",23,0,0,3,26
1179256,820802,2019-03-12,Assembly,"Assembly Codes Committee: Favorable",15,6,0,1,22
1179291,824697,2019-03-11,Senate,"Senate Insurance Committee Vote",11,0,0,0,11
1179291,824698,2019-03-19,Senate,"Senate Floor Vote - Final Passage",61,0,0,1,62
1179291,881984,2019-06-12,Senate,"Senate Floor Vote - Final Passage",62,0,0,0,62
1179334,857489,2019-04-30,Assembly,"Assembly Mental Health Committee: Favorable refer to committee Codes",11,0,0,2,13
1179347,878000,2019-06-05,Assembly,"Assembly Education Committee: Favorable refer to committee Ways and Means",29,0,0,2,31
1179347,879325,2019-06-06,Assembly,"Assembly Ways And Means Committee: Favorable refer to committee Rules",31,0,0,4,35
1179347,880472,2019-06-11,Assembly,"Assembly Rules Committee: Favorable",25,0,0,6,31
1179347,881597,2019-06-13,Assembly,"Assembly Floor Vote - Final Passage",146,0,0,4,150
1179347,882011,2019-06-13,Senate,"Senate Floor Vote - Final Passage",62,0,0,0,62
1179399,870170,2019-05-21,Assembly,"Assembly Transportation Committee: Favorable refer to committee Codes",22,3,0,0,25
1179399,875061,2019-05-30,Assembly,"Assembly Codes Committee: Favorable",15,4,0,3,22
1179412,868310,2019-05-21,Assembly,"Assembly Transportation Committee: Favorable refer to committee Codes",25,0,0,0,25
1179431,811739,2019-02-28,Assembly,"Assembly Health Committee: Favorable refer to committee Ways and Means",25,0,0,1,26
1179436,868404,2019-05-21,Assembly,"Assembly Children And Families Committee: Favorable",15,0,0,1,16
1179436,875624,2019-05-30,Assembly,"Assembly Floor Vote - Final Passage",142,1,0,7,150
1179436,882117,2019-06-14,Senate,"Senate Floor Vote - Final Passage",62,0,0,0,62
1179466,880909,2019-05-29,Senate,"Senate Commerce, Economic Development and Small Business Committee Vote",9,0,0,0,9
1179466,881924,2019-06-12,Senate,"Senate Floor Vote - Final Passage",62,0,0,0,62
1179466,914587,2020-02-04,Senate,"Senate Commerce, Economic Development and Small Business Committee Vote",9,0,0,0,9
1179466,949900,2020-03-10,Senate,"Senate Floor Vote - Final Passage",59,0,0,3,62
1179466,973679,2020-07-23,Assembly,"Assembly Floor Vote - Final Passage",141,0,0,4,145
1179498,857492,2019-04-30,Assembly,"Assembly Codes Committee: Favorable",20,0,0,2,22
1179498,859658,2019-05-06,Assembly,"Assembly Floor Vote - Final Passage",139,3,0,8,150
1179550,882102,2019-04-30,Senate,"Senate Judiciary Committee Vote",11,4,0,0,15
1179550,882103,2019-06-14,Senate,"Senate Floor Vote - Final Passage",42,20,0,0,62
1179550,883234,2019-06-17,Assembly,"Assembly Floor Vote - Final Passage",87,58,0,5,150
1179583,809740,2019-02-27,Assembly,"Assembly Governmental Employees Committee: Favorable refer to committee Ways and Means",13,0,0,1,14
1179583,934101,2020-02-25,Assembly,"Assembly Governmental Employees Committee: Favorable refer to committee Ways and Means",13,0,0,1,14
1179626,943145,2020-03-03,Assembly,"Assembly Social Services Committee: Held for Consideration",12,4,0,1,17
1179653,878473,2019-06-04,Assembly,"Assembly Governmental Operations Committee: Favorable refer to committee Ways and Means",12,0,0,2,14
1179653,882267,2019-06-14,Assembly,"Assembly Ways And Means Committee: Favorable refer to committee Rules",29,1,0,5,35
1179653,886097,2019-06-20,Assembly,"Assembly Rules Committee: Favorable",26,0,0,5,31
1179688,971620,2020-07-16,Assembly,"Assembly Governmental Operations Committee: Held for Consideration",10,4,0,0,14
1179707,857096,2019-04-30,Assembly,"Assembly Racing And Wagering Committee: Favorable refer to committee Codes",10,1,0,0,11
1179707,868569,2019-05-21,Assembly,"Assembly Codes Committee: Favorable refer to committee Ways and Means",21,0,0,1,22
1179707,878639,2019-06-05,Assembly,"Assembly Ways And Means Committee: Favorable refer to committee Rules",30,1,0,4,35
1179707,882464,2019-06-17,Assembly,"Assembly Rules Committee: Favorable",24,2,0,5,31
1179707,972550,2020-07-20,Assembly,"Assembly Floor Vote - Final Passage",141,0,0,4,145
1179741,971473,2020-07-15,Assembly,"Assembly Labor Committee: Held for Consideration",18,7,0,3,28
1179756,815573,2019-02-27,Senate,"Senate Commerce, Economic Development and Small Business Committee Vote",9,0,0,0,9
1179756,816368,2019-03-07,Senate,"Senate Floor Vote - Final Passage",58,0,0,5,63
1179756,877762,2019-06-04,Assembly,"Assembly Floor Vote - Final Passage",147,0,0,3,150
1179775,875444,2019-05-30,Senate,"Senate New York City Education Committee Vote",7,0,0,0,7
1179839,882176,2019-06-14,Assembly,"Assembly Governmental Operations Committee: Favorable refer to committee Ways and Means",12,0,0,2,14
1179839,882759,2019-06-17,Assembly,"Assembly Rules Committee: Favorable",25,0,0,6,31
1179839,882760,2019-06-17,Assembly,"Assembly Ways And Means Committee: Favorable refer to committee Rules",33,0,0,2,35
1179943,882202,2019-06-14,Assembly,"Assembly Governmental Employees Committee: Favorable refer to committee Rules",13,0,0,1,14
1179943,882433,2019-06-17,Assembly,"Assembly Rules Committee: Favorable",26,0,0,5,31
1179959,971920,2020-07-17,Assembly,"Assembly Ways And Means Committee: Held for Consideration",22,10,0,2,34
1180038,816311,2019-02-04,Senate,"Senate Energy and Telecommunications Committee Vote",9,0,0,0,9
1180038,816312,2019-03-07,Senate,"Senate Floor Vote - Final Passage",58,0,0,5,63
1180045,971330,2020-07-14,Assembly,"Assembly Higher Education Committee: Held for Consideration",18,7,0,0,25
1180061,971133,2020-07-14,Assembly,"Assembly Judiciary Committee: Held for Consideration",15,6,0,0,21
1180080,809769,2019-02-27,Assembly,"Assembly Governmental Employees Committee: Favorable refer to committee Ways and Means",13,0,0,1,14
1180080,933648,2020-02-25,Assembly,"Assembly Governmental Employees Committee: Favorable refer to committee Ways and Means",13,0,0,1,14
1180087,857024,2019-05-01,Assembly,"Assembly Education Committee: Favorable refer to committee Ways and Means",28,0,0,3,31
1180087,863623,2019-05-14,Assembly,"Assembly Ways And Means Committee: Favorable",32,0,0,3,35
1180087,867867,2019-05-20,Assembly,"Assembly Floor Vote - Final Passage",144,0,0,6,150
1180087,875510,2019-05-30,Senate,"Senate Floor Vote - Final Passage",58,0,0,4,62
1180435,882924,2019-05-30,Senate,"Senate Cultural Affairs, Tourism, Parks And Recreation Committee Vote",7,0,0,0,7
1180435,882925,2019-06-17,Senate,"Senate Floor Vote - Final Passage",62,0,0,0,62
1180435,884377,2019-06-18,Assembly,"Assembly Floor Vote - Final Passage",148,0,0,2,150
1180452,859900,2019-04-08,Senate,"Senate Local Government Committee Vote",7,0,0,0,7
1180452,859901,2019-05-06,Senate,"Senate Floor Vote - Final Passage",60,1,0,1,62
1180452,882298,2019-06-13,Assembly,"Assembly Floor Vote - Final Passage",131,15,0,4,150
1180675,860701,2019-04-30,Senate,"Senate Energy and Telecommunications Committee Vote",9,0,0,0,9
1180675,860702,2019-05-07,Senate,"Senate Floor Vote - Final Passage",50,11,0,1,62
1180675,914213,2020-02-03,Senate,"Senate Energy and Telecommunications Committee Vote",7,2,0,0,9
1180675,934857,2020-02-25,Senate,"Senate Floor Vote - Final Passage",48,12,0,2,62
1180675,972735,2020-07-21,Assembly,"Assembly Floor Vote - Final Passage",141,1,0,3,145
1180736,819966,2019-03-12,Senate,"Senate Committee Vote",6,0,0,0,6
1180772,819950,2019-03-12,Senate,"Senate Internet and Technology Committee Vote",7,0,0,0,7
1180772,921435,2020-02-11,Senate,"Senate Internet and Technology Committee Vote",6,1,0,0,7
1180820,875785,2019-03-04,Senate,"Senate Local Government Committee Vote",7,0,0,0,7
1180820,875786,2019-05-30,Senate,"Senate Floor Vote - Final Passage",58,0,0,4,62
1180820,877750,2019-06-04,Assembly,"Assembly Floor Vote - Final Passage",133,14,0,3,150
1180855,792563,2019-02-05,Assembly,"Assembly Economic Development Committee: Favorable refer to committee Ways and Means",24,1,0,1,26
1180855,823801,2019-03-18,Assembly,"Assembly Ways And Means Committee: Favorable",31,0,0,4,35
1181046,882367,2019-03-04,Senate,"Senate Local Government Committee Vote",7,0,0,0,7
1181046,882368,2019-06-14,Senate,"Senate Floor Vote - Final Passage",61,1,0,0,62
1181046,931829,2020-02-24,Senate,"Senate Local Government Committee Vote",7,0,0,0,7
1181051,863590,2019-04-30,Senate,"Senate Veterans, Homeland Security and Military Affairs Committee Vote",9,0,0,0,9
1181051,863591,2019-05-14,Senate,"Senate Floor Vote - Final Passage",59,0,0,3,62
1181051,903165,2020-01-14,Senate,"Senate Veterans, Homeland Security and Military Affairs Committee Vote",8,0,0,1,9
1181051,936207,2020-02-26,Senate,"Senate Floor Vote - Final Passage",60,0,0,2,62
1181078,818632,2019-03-05,Senate,"Senate Finance Committee Vote",21,0,0,2,23
1181078,818633,2019-03-11,Senate,"Senate Floor Vote - Final Passage",62,0,0,0,62
1181078,882373,2019-06-11,Senate,"Senate Floor Vote - Final Passage",61,0,0,1,62
1181097,796885,2019-02-11,Senate,"Senate Health Committee Vote",14,0,0,1,15
1181157,882269,2019-05-13,Senate,"Senate Transportation Committee Vote",14,0,0,1,15
1181157,882270,2019-06-13,Senate,"Senate Floor Vote - Final Passage",61,1,0,0,62
1181183,874332,2019-05-29,Senate,"Senate Insurance Committee Vote",11,0,0,0,11
1181199,877004,2019-04-30,Senate,"Senate Higher Education Committee Vote",11,0,0,0,11
1181199,877005,2019-06-03,Senate,"Senate Floor Vote - Final Passage",60,2,0,0,62
1181223,886789,2019-06-20,Senate,"Senate Floor Vote - Final Passage",62,0,0,0,62
1181223,887162,2019-06-20,Senate,"Senate Rules Committee Vote",19,0,0,0,19
1181235,878731,2019-06-05,Assembly,"Assembly Banks Committee: Favorable refer to committee Codes",21,8,0,2,31
1181235,882885,2019-06-17,Assembly,"Assembly Codes Committee: Favorable refer to committee Rules",14,6,0,2,22
1181397,881644,2019-05-29,Senate,"Senate Local Government Committee Vote",7,0,0,0,7
1181397,882070,2019-06-13,Senate,"Senate Floor Vote - Final Passage",62,0,0,0,62
1181397,931998,2020-02-24,Senate,"Senate Local Government Committee Vote",7,0,0,0,7
1181397,941047,2020-03-03,Senate,"Senate Floor Vote - Final Passage",62,0,0,0,62
1181423,869994,2019-04-30,Senate,"Senate Higher Education Committee Vote",11,0,0,0,11
1181423,869995,2019-05-22,Senate,"Senate Floor Vote - Final Passage",61,0,0,1,62
1181452,877034,2019-06-03,Senate,"Senate Floor Vote - Final Passage",61,1,0,0,62
1181452,877318,2019-06-03,Senate,"Senate Rules Committee Vote",19,0,0,0,19
1181527,837828,2019-03-26,Senate,"Senate Commerce, Economic Development and Small Business Committee Vote",9,0,0,0,9
1181527,837829,2019-04-08,Senate,"Senate Floor Vote - Final Passage",59,0,0,3,62
1181527,914186,2020-02-04,Senate,"Senate Commerce, Economic Development and Small Business Committee Vote",9,0,0,0,9
1181527,950057,2020-03-10,Senate,"Senate Floor Vote - Final Passage",59,0,0,3,62
1181555,815333,2019-02-27,Senate,"Senate Investigations and Government Operations Committee Vote",7,0,0,0,7
1181555,815334,2019-03-06,Senate,"Senate Floor Vote - Final Passage",62,0,0,1,63
1181555,877957,2019-06-04,Assembly,"Assembly Floor Vote - Final Passage",146,1,0,3,150
1181608,877025,2019-06-03,Senate,"Senate Floor Vote - Final Passage",62,0,0,0,62
1181608,877293,2019-06-03,Senate,"Senate Rules Committee Vote",19,0,0,0,19
1181608,942992,2020-03-03,Senate,"Senate Education Committee Vote",15,0,0,0,15
1181666,971928,2020-07-17,Assembly,"Assembly Ways And Means Committee: Held for Consideration",22,10,0,2,34
1181678,792275,2019-02-04,Assembly,"Assembly Insurance Committee: Favorable",23,0,0,1,24
1181706,875605,2019-05-29,Assembly,"Assembly Local Governments Committee: Favorable refer to committee Ways and Means",17,0,0,2,19
1181706,875606,2019-05-30,Assembly,"Assembly Ways And Means Committee: Favorable",30,0,1,4,35
1181816,878334,2019-06-05,Assembly,"Assembly Transportation Committee: Favorable refer to committee Codes",17,9,0,0,26
1181816,880047,2019-06-11,Assembly,"Assembly Ways And Means Committee: Favorable refer to committee Rules",21,12,0,2,35
1181816,880422,2019-06-11,Assembly,"Assembly Rules Committee: Favorable",17,8,0,6,31
1181816,880423,2019-06-11,Assembly,"Assembly Ways And Means Committee: Favorable refer to committee Rules",21,12,0,2,35
1181816,881107,2019-06-12,Assembly,"Assembly Floor Vote - Final Passage",87,61,0,2,150
1181816,882978,2019-06-17,Senate,"Senate Floor Vote - Final Passage",33,29,0,0,62
1181822,816482,2019-03-06,Assembly,"Assembly Health Committee: Favorable",25,0,0,1,26
1181822,861935,2019-05-08,Assembly,"Assembly Floor Vote - Final Passage",132,5,0,13,150
1181827,874246,2019-05-29,Assembly,"Assembly Environmental Conservation Committee: Favorable",23,6,0,1,30
1181853,971377,2020-07-14,Assembly,"Assembly Higher Education Committee: Held for Consideration",18,7,0,0,25
1181956,878723,2019-06-06,Assembly,"Assembly Environmental Conservation Committee: Favorable refer to committee Ways and Means",28,0,0,2,30
1181967,971250,2020-07-14,Assembly,"Assembly Education Committee: Held for Consideration",23,6,0,2,31
1181979,820134,2019-03-12,Assembly,"Assembly Environmental Conservation Committee: Favorable refer to committee Ways and Means",21,8,0,1,30
1181979,881282,2019-06-12,Assembly,"Assembly Ways And Means Committee: Favorable refer to committee Rules",20,10,0,5,35
1181979,881367,2019-06-13,Assembly,"Assembly Rules Committee: Favorable",20,6,0,5,31
1181998,868488,2019-05-21,Assembly,"Assembly Health Committee: Favorable",19,7,0,0,26
1181998,885270,2019-06-19,Assembly,"Assembly Floor Vote - Final Passage",149,0,0,1,150
1182010,971251,2020-07-14,Assembly,"Assembly Education Committee: Held for Consideration",23,6,0,2,31
1182023,870404,2019-05-21,Assembly,"Assembly Education Committee: Favorable",31,0,0,0,31
1182376,860704,2019-05-06,Senate,"Senate Internet and Technology Committee Vote",7,0,0,0,7
1182479,841537,2019-02-27,Senate,"Senate Investigations And Government Operations Committee Vote",7,0,0,0,7
1182479,841538,2019-04-10,Senate,"Senate Floor Vote - Final Passage",45,14,0,3,62
1182479,902782,2020-01-14,Senate,"Senate Investigations and Government Operations Committee Vote",6,1,0,0,7
1182487,971953,2020-07-17,Assembly,"Assembly Codes Committee: Held for Consideration",15,6,0,1,22
1182552,819961,2019-03-12,Senate,"Senate Corporations, Authorities and Commissions Committee Vote",7,0,0,0,7
1182565,854448,2019-03-12,Senate,"Senate Health Committee Vote",15,0,0,0,15
1182565,854449,2019-04-29,Senate,"Senate Floor Vote - Final Passage",61,0,0,1,62
1182565,886277,2019-06-21,Assembly,"Assembly Floor Vote - Final Passage",143,1,0,6,150
1182624,868587,2019-05-21,Assembly,"Assembly Libraries And Education Technology Committee: Favorable refer to committee Ways and Means",9,0,0,0,9
1182624,877152,2019-06-04,Assembly,"Assembly Ways And Means Committee: Favorable refer to committee Rules",33,0,0,2,35
1182624,877993,2019-06-05,Assembly,"Assembly Rules Committee: Favorable",27,0,0,4,31
1182624,879384,2019-06-06,Assembly,"Assembly Floor Vote - Final Passage",137,0,0,13,150
1182624,881731,2019-06-13,Senate,"Senate Floor Vote - Final Passage",61,1,0,0,62
1182638,856141,2019-04-09,Senate,"Senate Transportation Committee Vote",15,0,0,0,15
1182638,856142,2019-05-01,Senate,"Senate Floor Vote - Final Passage",62,0,0,0,62
1182638,864172,2019-05-15,Senate,"Senate Floor Vote - Final Passage",58,0,0,4,62
1182638,874481,2019-05-29,Senate,"Senate Floor Vote - Final Passage",60,0,0,2,62
1182638,874777,2019-05-29,Assembly,"Assembly Floor Vote - Final Passage",141,0,0,9,150
1182763,883022,2019-06-17,Senate,"Senate Floor Vote - Final Passage",62,0,0,0,62
1182763,883023,2019-06-17,Senate,"Senate Rules Committee Vote",19,0,0,0,19
1182781,878018,2019-06-05,Senate,"Senate Floor Vote - Final Passage",62,0,0,0,62
1182781,878019,2019-06-05,Senate,"Senate Rules Committee Vote",19,0,0,0,19
1182781,904569,2020-01-22,Senate,"Senate Aging Committee Vote",7,0,0,0,7
1182781,972488,2020-07-21,Senate,"Senate Floor Vote - Final Passage",60,0,0,0,60
1182844,878341,2019-06-04,Assembly,"Assembly Correction Committee: Favorable refer to committee Codes",10,3,0,0,13
1182856,868982,2019-05-21,Senate,"Senate Health Committee Vote",15,0,0,0,15
1182856,949118,2020-03-10,Senate,"Senate Health Committee Vote",14,0,0,1,15
1182880,875206,2019-05-30,Assembly,"Assembly Judiciary Committee: Favorable refer to committee Ways and Means",20,0,0,1,21
1182890,877908,2019-06-05,Assembly,"Assembly Health Committee: Favorable refer to committee Codes",21,4,0,1,26
1182890,880203,2019-06-11,Assembly,"Assembly Codes Committee: Favorable refer to committee Rules",15,7,0,0,22
1182897,810283,2019-02-27,Assembly,"Assembly Governmental Operations Committee: Favorable refer to committee Codes",13,0,0,1,14
1182897,813875,2019-03-05,Assembly,"Assembly Codes Committee: Favorable",22,0,0,0,22
1182897,820273,2019-03-12,Assembly,"Assembly Floor Vote - Final Passage",142,0,0,8,150
1182897,877281,2019-06-04,Senate,"Senate Floor Vote - Final Passage",47,15,0,0,62
1182944,819831,2019-03-04,Senate,"Senate Local Government Committee Vote",7,0,0,0,7
1182944,819832,2019-03-12,Senate,"Senate Floor Vote - Final Passage",61,0,0,1,62
1182944,874282,2019-05-29,Senate,"Senate Floor Vote - Final Passage",60,0,0,2,62
1182944,883976,2019-06-18,Assembly,"Assembly Floor Vote - Final Passage",146,0,0,4,150
1182997,864351,2019-02-12,Senate,"Senate Transportation Committee Vote",14,1,0,0,15
1182997,864352,2019-05-15,Senate,"Senate Floor Vote - Final Passage",58,0,0,4,62
1182997,882889,2019-06-17,Senate,"Senate Floor Vote - Final Passage",62,0,0,0,62
1182997,885393,2019-06-19,Assembly,"Assembly Floor Vote - Final Passage",146,2,0,2,150
1183017,811010,2019-02-28,Assembly,"Assembly Health Committee: Favorable refer to committee Codes",25,0,0,1,26
1183051,838374,2019-04-08,Assembly,"Assembly Judiciary Committee: Favorable",17,3,0,1,21
1183059,864505,2019-05-14,Assembly,"Assembly Health Committee: Favorable refer to committee Ways and Means",24,0,0,2,26
1183059,882131,2019-06-13,Assembly,"Assembly Ways And Means Committee: Favorable refer to committee Rules",29,0,0,6,35
1183059,882487,2019-06-17,Assembly,"Assembly Rules Committee: Favorable",26,0,0,5,31
1183074,821992,2019-03-14,Assembly,"Assembly Transportation Committee: Favorable",22,0,0,3,25
1183074,824044,2019-03-18,Assembly,"Assembly Floor Vote - Final Passage",143,0,0,7,150
1183074,882291,2019-06-13,Senate,"Senate Floor Vote - Final Passage",62,0,0,0,62
1183080,792483,2019-02-05,Assembly,"Assembly Environmental Conservation Committee: Favorable refer to committee Ways and Means",24,4,0,2,30
1183080,880185,2019-06-11,Assembly,"Assembly Ways And Means Committee: Favorable refer to committee Rules",23,10,0,2,35
1183137,857105,2019-04-30,Assembly,"Assembly Correction Committee: Favorable refer to committee Codes",9,3,0,1,13
1183137,860467,2019-05-07,Assembly,"Assembly Codes Committee: Favorable",13,7,0,2,22
1183144,839368,2019-04-09,Senate,"Senate Education Committee Vote",15,0,0,0,15
1183144,860975,2019-05-07,Senate,"Senate Finance Committee Vote",23,0,0,0,23
1183144,864106,2019-05-15,Senate,"Senate Floor Vote - Final Passage",57,1,0,4,62
1183144,877800,2019-06-04,Assembly,"Assembly Floor Vote - Final Passage",147,0,0,3,150
1183158,839437,2019-04-09,Senate,"Senate Education Committee Vote",15,0,0,0,15
1183158,860894,2019-05-07,Senate,"Senate Finance Committee Vote",23,0,0,0,23
1183158,864747,2019-05-15,Senate,"Senate Floor Vote - Final Passage",57,1,0,4,62
1183158,880677,2019-06-11,Assembly,"Assembly Floor Vote - Final Passage",142,0,0,8,150
1183166,810181,2019-02-27,Assembly,"Assembly Codes Committee: Favorable",15,6,0,1,22
1183166,813481,2019-03-04,Assembly,"Assembly Floor Vote - Final Passage",103,40,0,7,150
1183166,819636,2019-03-12,Senate,"Senate Floor Vote - Final Passage",54,7,0,1,62
1183185,867599,2019-04-30,Senate,"Senate Finance Committee Vote",23,0,0,0,23
1183185,867600,2019-05-20,Senate,"Senate Floor Vote - Final Passage",60,0,0,2,62
1183185,877218,2019-06-03,Assembly,"Assembly Floor Vote - Final Passage",142,0,0,8,150
1183187,877009,2019-06-03,Assembly,"Assembly Social Services Committee: Favorable refer to committee Codes",11,5,0,2,18
1183187,880223,2019-06-11,Assembly,"Assembly Codes Committee: Favorable refer to committee Rules",17,5,0,0,22
1183187,881303,2019-06-13,Assembly,"Assembly Rules Committee: Favorable",26,0,0,5,31
1183244,914336,2020-02-04,Assembly,"Assembly Judiciary Committee: Favorable refer to committee Ways and Means",20,0,0,1,21
1183293,810297,2019-02-27,Assembly,"Assembly Governmental Operations Committee: Favorable",10,3,0,1,14
1183293,820364,2019-03-12,Assembly,"Assembly Floor Vote - Final Passage",111,31,0,8,150
1183311,825330,2019-03-19,Assembly,"Assembly Governmental Operations Committee: Favorable refer to committee Codes",11,2,0,1,14
1183311,838889,2019-04-09,Assembly,"Assembly Codes Committee: Favorable refer to committee Ways and Means",18,4,0,0,22
1183311,868960,2019-05-21,Assembly,"Assembly Ways And Means Committee: Favorable",24,8,0,3,35
1183311,874857,2019-05-29,Assembly,"Assembly Floor Vote - Final Passage",111,29,0,10,150
1183328,876745,2019-06-03,Assembly,"Assembly Higher Education Committee: Favorable refer to committee Ways and Means",25,0,0,1,26
1183328,879380,2019-06-06,Assembly,"Assembly Ways And Means Committee: Favorable refer to committee Rules",31,0,0,4,35
1183328,880469,2019-06-11,Assembly,"Assembly Rules Committee: Favorable",25,0,0,6,31
1183328,881599,2019-06-13,Assembly,"Assembly Floor Vote - Final Passage",146,0,0,4,150
1183328,882022,2019-06-13,Senate,"Senate Floor Vote - Final Passage",62,0,0,0,62
1183342,878332,2019-06-04,Assembly,"Assembly Correction Committee: Favorable refer to committee Codes",10,3,0,0,13
1183376,838826,2019-04-09,Assembly,"Assembly Governmental Operations Committee: Held for Consideration",10,3,0,1,14
1183377,857090,2019-04-30,Assembly,"Assembly Codes Committee: Favorable",20,0,0,2,22
1183377,859652,2019-05-06,Assembly,"Assembly Floor Vote - Final Passage",139,2,0,9,150
1183377,876818,2019-06-03,Senate,"Senate Floor Vote - Final Passage",62,0,0,0,62
1183402,882692,2019-06-17,Assembly,"Assembly Higher Education Committee: Favorable refer to committee Ways and Means",26,0,0,0,26
1183402,883589,2019-06-18,Assembly,"Assembly Rules Committee: Favorable",25,0,0,6,31
1183402,883590,2019-06-18,Assembly,"Assembly Ways And Means Committee: Favorable refer to committee Rules",33,0,0,2,35
1183412,868886,2019-05-21,Assembly,"Assembly Libraries And Education Technology Committee: Favorable refer to committee Ways and Means",9,0,0,0,9
1183412,874759,2019-05-30,Assembly,"Assembly Ways And Means Committee: Favorable",31,0,0,4,35
1183412,878050,2019-06-04,Assembly,"Assembly Floor Vote - Final Passage",147,0,0,3,150
1183412,881695,2019-06-13,Senate,"Senate Floor Vote - Final Passage",62,0,0,0,62
1183424,829798,2019-03-26,Assembly,"Assembly Correction Committee: Favorable refer to committee Ways and Means",10,3,0,0,13
1183426,878314,2019-06-05,Assembly,"Assembly Election Law Committee: Favorable refer to committee Rules",15,0,0,1,16
1183448,811357,2019-02-28,Assembly,"Assembly Health Committee: Favorable",25,0,0,1,26
1183448,814759,2019-03-05,Assembly,"Assembly Floor Vote - Final Passage",147,1,0,2,150
1183448,869331,2019-05-22,Senate,"Senate Floor Vote - Final Passage",55,6,0,1,62
1183454,860688,2019-05-07,Assembly,"Assembly Higher Education Committee: Favorable",23,0,0,3,26
1183454,864284,2019-05-14,Assembly,"Assembly Floor Vote - Final Passage",141,0,0,9,150
1183454,882794,2019-06-17,Senate,"Senate Floor Vote - Final Passage",62,0,0,0,62
1183486,973118,2019-03-06,Senate,"Senate Racing, Gaming and Wagering Committee Vote",7,0,0,0,7
1183486,973119,2020-03-02,Senate,"Senate Racing, Gaming and Wagering Committee Vote",7,0,0,0,7
1183486,973120,2020-07-21,Senate,"Senate Floor Vote - Final Passage",60,0,0,0,60
1183534,813374,2019-02-11,Senate,"Senate Health Committee Vote",14,0,0,1,15
1183534,813375,2019-03-04,Senate,"Senate Floor Vote - Final Passage",59,0,0,4,63
1183534,884658,2019-06-18,Assembly,"Assembly Floor Vote - Final Passage",146,0,0,4,150
1183552,811371,2019-02-28,Assembly,"Assembly Health Committee: Favorable refer to committee Ways and Means",15,10,0,1,26
1183559,881073,2019-06-12,Assembly,"Assembly Cities Committee: Favorable refer to committee Ways and Means",14,0,0,1,15
1183559,882054,2019-06-14,Assembly,"Assembly Ways And Means Committee: Favorable refer to committee Rules",29,0,1,5,35
1183559,882508,2019-06-17,Assembly,"Assembly Rules Committee: Favorable",26,0,0,5,31
1183594,810267,2019-02-27,Assembly,"Assembly Governmental Operations Committee: Favorable",13,0,0,1,14
1183594,820370,2019-03-12,Assembly,"Assembly Floor Vote - Final Passage",142,0,0,8,150
1183652,810273,2019-02-27,Assembly,"Assembly Governmental Operations Committee: Favorable refer to committee Codes",13,0,0,1,14
1183652,813592,2019-03-05,Assembly,"Assembly Codes Committee: Favorable",22,0,0,0,22
1184137,868023,2019-05-21,Assembly,"Assembly Governmental Operations Committee: Favorable refer to committee Ways and Means",14,0,0,0,14
1184137,877825,2019-06-04,Assembly,"Assembly Ways And Means Committee: Favorable refer to committee Rules",26,7,0,2,35
1184137,881351,2019-06-13,Assembly,"Assembly Rules Committee: Favorable",26,0,0,5,31
1184161,868862,2019-05-21,Assembly,"Assembly Correction Committee: Favorable refer to committee Ways and Means",8,2,0,3,13
1184211,860720,2019-05-07,Assembly,"Assembly Higher Education Committee: Favorable",23,0,0,3,26
1184211,864020,2019-05-14,Assembly,"Assembly Floor Vote - Final Passage",141,0,0,9,150
1184211,874928,2019-05-30,Senate,"Senate Floor Vote - Final Passage",58,0,0,4,62
1184402,829763,2019-03-26,Assembly,"Assembly Correction Committee: Favorable",10,3,0,0,13
1184499,877899,2019-06-05,Assembly,"Assembly Governmental Employees Committee: Favorable refer to committee Rules",14,0,0,0,14
1184499,880514,2019-06-11,Assembly,"Assembly Rules Committee: Favorable",25,0,0,6,31
1184636,859230,2019-04-09,Senate,"Senate Cultural Affairs, Tourism, Parks and Recreation Committee Vote",7,0,0,0,7
1184636,859231,2019-05-06,Senate,"Senate Floor Vote - Final Passage",61,0,0,1,62
1184636,903135,2020-01-14,Senate,"Senate Cultural Affairs, Tourism, Parks and Recreation Committee Vote",7,0,0,0,7
1184636,904597,2020-01-22,Senate,"Senate Floor Vote - Final Passage",61,0,0,1,62
1184818,885275,2019-06-18,Senate,"Senate Floor Vote - Final Passage",62,0,0,0,62
1184818,886480,2019-06-18,Senate,"Senate Rules Committee Vote",19,0,0,0,19
1184818,942256,2020-03-03,Senate,"Senate Transportation Committee Vote",15,0,0,0,15
1184842,839356,2019-04-09,Senate,"Senate Environmental Conservation Committee Vote",11,0,0,0,11
1185154,811329,2019-02-28,Assembly,"Assembly Health Committee: Favorable",25,0,0,1,26
1185154,814699,2019-03-05,Assembly,"Assembly Floor Vote - Final Passage",111,37,0,2,150
1185154,823512,2019-03-18,Senate,"Senate Floor Vote - Final Passage",40,22,0,0,62
1185182,876042,2019-05-30,Assembly,"Assembly Agriculture Committee: Favorable",19,0,0,2,21
1185231,883066,2019-06-17,Senate,"Senate Floor Vote - Final Passage",62,0,0,0,62
1185231,883067,2019-06-17,Senate,"Senate Rules Committee Vote",19,0,0,0,19
1185262,870427,2019-05-21,Assembly,"Assembly Education Committee: Favorable refer to committee Ways and Means",31,0,0,0,31
1185262,877840,2019-06-04,Assembly,"Assembly Ways And Means Committee: Favorable refer to committee Rules",33,0,0,2,35
1185262,877988,2019-06-05,Assembly,"Assembly Rules Committee: Favorable",27,0,0,4,31
1185262,880598,2019-06-11,Assembly,"Assembly Floor Vote - Final Passage",142,0,0,8,150
1185262,882129,2019-06-14,Senate,"Senate Floor Vote - Final Passage",62,0,0,0,62
1185317,868503,2019-05-21,Assembly,"Assembly Governmental Employees Committee: Favorable refer to committee Ways and Means",14,0,0,0,14
1185317,877823,2019-06-04,Assembly,"Assembly Ways And Means Committee: Favorable refer to committee Rules",33,0,0,2,35
1185317,877987,2019-06-05,Assembly,"Assembly Rules Committee: Favorable",27,0,0,4,31
1185317,880685,2019-06-11,Assembly,"Assembly Floor Vote - Final Passage",135,7,0,8,150
1185317,886580,2019-06-19,Senate,"Senate Floor Vote - Final Passage",62,0,0,0,62
1185323,811609,2019-02-28,Assembly,"Assembly Health Committee: Favorable",25,0,0,1,26
1185323,815587,2019-03-06,Assembly,"Assembly Floor Vote - Final Passage",126,20,0,4,150
1185347,880908,2019-05-29,Senate,"Senate Social Services Committee Vote",7,0,0,0,7
1185347,882111,2019-06-12,Senate,"Senate Floor Vote - Final Passage",62,0,0,0,62
1185347,902616,2020-01-14,Senate,"Senate Social Services Committee Vote",7,0,0,0,7
1185347,919270,2020-02-10,Senate,"Senate Floor Vote - Final Passage",61,0,0,1,62
1185359,971000,2020-07-14,Assembly,"Assembly Environmental Conservation Committee: Favorable refer to committee Rules",26,1,0,1,28
1185359,972808,2020-07-21,Assembly,"Assembly Rules Committee: Favorable",26,0,0,4,30
1185359,973152,2020-07-22,Assembly,"Assembly Floor Vote - Final Passage",140,2,0,3,145
1185359,973618,2020-07-23,Senate,"Senate Floor Vote - Final Passage",51,9,0,0,60
1185441,809990,2019-02-27,Assembly,"Assembly Rules Committee: Favorable",27,0,0,4,31
1185441,809991,2019-02-27,Assembly,"Assembly Codes Committee: Favorable refer to committee Rules",21,0,0,1,22
1185441,809992,2019-02-27,Assembly,"Assembly Governmental Operations Committee: Favorable refer to committee Codes",13,0,0,1,14
1185441,811014,2019-02-27,Assembly,"Assembly Floor Vote - Final Passage",140,2,0,8,150
1185441,841696,2019-04-09,Senate,"Senate Floor Vote - Final Passage",60,0,0,2,62
1185446,970909,2020-07-13,Assembly,"Assembly Corporations, Authorities And Commissions Committee: Held for Consideration",19,7,0,0,26
1185459,971649,2020-07-16,Assembly,"Assembly Governmental Operations Committee: Held for Consideration",10,4,0,0,14
1185492,971738,2020-07-17,Assembly,"Assembly Ways And Means Committee: Held for Consideration",22,10,0,2,34
1185530,875693,2019-05-30,Senate,"Senate Environmental Conservation Committee Vote",8,2,0,1,11
1185568,970824,2020-07-13,Assembly,"Assembly Consumer Affairs And Protection Committee: Held for Consideration",12,3,0,1,16
1185574,971807,2020-07-16,Assembly,"Assembly Governmental Employees Committee: Held for Consideration",9,5,0,0,14
1185578,840736,2019-04-09,Assembly,"Assembly Transportation Committee: Held for Consideration",16,7,0,2,25
1185591,864529,2019-05-14,Assembly,"Assembly Health Committee: Favorable refer to committee Ways and Means",24,0,0,2,26
1185594,972127,2020-07-17,Assembly,"Assembly Ways And Means Committee: Held for Consideration",22,10,0,2,34
1185621,971930,2020-07-17,Assembly,"Assembly Ways And Means Committee: Held for Consideration",22,10,0,2,34
1185624,825345,2019-03-19,Assembly,"Assembly Agriculture Committee: Favorable refer to committee Ways and Means",20,0,0,1,21
1185624,972021,2020-07-17,Assembly,"Assembly Ways And Means Committee: Favorable refer to committee Rules",32,0,0,2,34
1185624,973773,2020-07-21,Assembly,"Assembly Rules Committee: Favorable",26,0,0,4,30
1185651,970813,2020-07-13,Assembly,"Assembly Economic Development Committee: Held for Consideration",17,7,0,1,25
1185653,810274,2019-02-27,Assembly,"Assembly Election Law Committee: Favorable",13,0,0,3,16
1185653,815883,2019-03-06,Assembly,"Assembly Floor Vote - Final Passage",146,0,0,4,150
1185653,839383,2019-04-09,Senate,"Senate Floor Vote - Final Passage",60,0,0,2,62
1185669,971806,2020-07-16,Assembly,"Assembly Local Governments Committee: Held for Consideration",14,5,0,1,20
1185673,877420,2019-02-28,Senate,"Senate Domestic Animal Welfare Committee Vote",7,0,0,0,7
1185673,877421,2019-06-04,Senate,"Senate Floor Vote - Final Passage",52,10,0,0,62
1185673,949368,2020-03-11,Senate,"Senate Domestic Animal Welfare Committee Vote",7,0,0,0,7
1185681,861597,2019-05-07,Assembly,"Assembly Transportation Committee: Held for Consideration",16,7,0,2,25
1185686,882901,2019-05-30,Senate,"Senate Rules Committee Vote",18,0,0,1,19
1185686,882902,2019-06-17,Senate,"Senate Floor Vote - Final Passage",60,2,0,0,62
1185686,941751,2020-03-03,Senate,"Senate Investigations and Government Operations Committee Vote",7,0,0,0,7
1185696,876052,2019-05-30,Assembly,"Assembly Social Services Committee: Favorable refer to committee Ways and Means",15,1,0,2,18
1185707,874263,2019-05-29,Assembly,"Assembly Environmental Conservation Committee: Favorable refer to committee Codes",29,0,0,1,30
1185707,877534,2019-06-04,Assembly,"Assembly Codes Committee: Favorable refer to committee Ways and Means",16,6,0,0,22
1185718,971573,2020-07-16,Assembly,"Assembly Governmental Operations Committee: Held for Consideration",10,4,0,0,14
1185721,971185,2020-07-14,Assembly,"Assembly Insurance Committee: Held for Consideration",14,6,0,2,22
1185725,857032,2019-04-30,Assembly,"Assembly Correction Committee: Favorable refer to committee Ways and Means",12,0,0,1,13
1185731,840080,2019-04-09,Assembly,"Assembly Ways And Means Committee: Held for Consideration",22,10,0,3,35
1185731,971941,2020-07-17,Assembly,"Assembly Ways And Means Committee: Held for Consideration",22,10,0,2,34
1185758,971686,2020-07-16,Assembly,"Assembly Governmental Operations Committee: Held for Consideration",10,4,0,0,14
1185825,971642,2020-07-16,Assembly,"Assembly Real Property Taxation Committee: Held for Consideration",8,2,0,0,10
1185829,934792,2020-02-25,Assembly,"Assembly Housing Committee: Favorable",18,8,0,2,28
1185829,973074,2020-07-21,Assembly,"Assembly Floor Vote - Final Passage",133,9,0,3,145
1185829,973538,2020-07-23,Senate,"Senate Floor Vote - Final Passage",58,2,0,0,60
1185833,971664,2020-07-16,Assembly,"Assembly Governmental Operations Committee: Held for Consideration",10,4,0,0,14
1185856,972102,2020-07-17,Assembly,"Assembly Ways And Means Committee: Held for Consideration",22,10,0,2,34
1185874,972113,2020-07-17,Assembly,"Assembly Ways And Means Committee: Held for Consideration",22,10,0,2,34
1185880,971168,2020-07-14,Assembly,"Assembly Election Law Committee: Held for Consideration",12,4,0,0,16
1185882,971955,2020-07-17,Assembly,"Assembly Ways And Means Committee: Held for Consideration",22,10,0,2,34
1185893,819533,2019-03-12,Senate,"Senate Committee Vote",6,0,0,0,6
1185915,971656,2020-07-16,Assembly,"Assembly Governmental Operations Committee: Held for Consideration",10,4,0,0,14
1185924,971186,2020-07-14,Assembly,"Assembly Insurance Committee: Held for Consideration",14,6,0,2,22
1185928,971333,2020-07-14,Assembly,"Assembly Higher Education Committee: Held for Consideration",18,7,0,0,25
1185931,971959,2020-07-17,Assembly,"Assembly Ways And Means Committee: Held for Consideration",22,10,0,2,34
1185938,971119,2020-07-14,Assembly,"Assembly Energy Committee: Held for Consideration",10,5,0,0,15
1185944,971633,2020-07-16,Assembly,"Assembly Governmental Operations Committee: Held for Consideration",10,4,0,0,14
1185947,971308,2020-07-14,Assembly,"Assembly Higher Education Committee: Held for Consideration",17,8,0,0,25
1185951,971972,2020-07-17,Assembly,"Assembly Ways And Means Committee: Held for Consideration",22,10,0,2,34
1185975,870263,2019-05-21,Assembly,"Assembly Governmental Employees Committee: Favorable refer to committee Ways and Means",14,0,0,0,14
1185977,970933,2020-07-13,Assembly,"Assembly Banks Committee: Held for Consideration",22,7,0,2,31
1186015,813697,2019-03-05,Assembly,"Assembly Social Services Committee: Favorable",13,5,0,0,18
1186020,971212,2020-07-14,Assembly,"Assembly Judiciary Committee: Held for Consideration",15,6,0,0,21
1186032,970765,2020-07-13,Assembly,"Assembly Economic Development Committee: Held for Consideration",16,8,0,1,25
1186039,971128,2020-07-14,Assembly,"Assembly Judiciary Committee: Held for Consideration",15,6,0,0,21
1186054,971994,2020-07-17,Assembly,"Assembly Ways And Means Committee: Held for Consideration",22,10,0,2,34
1186065,971232,2020-07-14,Assembly,"Assembly Education Committee: Held for Consideration",23,6,0,2,31
1186075,971477,2020-07-16,Assembly,"Assembly Transportation Committee: Held for Consideration",16,6,0,2,24
1186093,829802,2019-03-26,Assembly,"Assembly Correction Committee: Favorable",13,0,0,0,13
1186096,971625,2020-07-16,Assembly,"Assembly Governmental Operations Committee: Held for Consideration",10,4,0,0,14
1186117,877617,2019-05-14,Senate,"Senate Education Committee Vote",15,0,0,0,15
1186117,877618,2019-06-04,Senate,"Senate Floor Vote - Final Passage",62,0,0,0,62
1186121,970758,2020-07-13,Assembly,"Assembly Economic Development Committee: Held for Consideration",17,7,0,1,25
1186133,970897,2020-07-13,Assembly,"Assembly Corporations, Authorities And Commissions Committee: Held for Consideration",19,7,0,0,26
1186138,971667,2020-07-16,Assembly,"Assembly Governmental Operations Committee: Held for Consideration",10,4,0,0,14
1186142,857111,2019-04-30,Assembly,"Assembly Correction Committee: Favorable refer to committee Codes",9,3,0,1,13
1186142,859838,2019-05-07,Assembly,"Assembly Codes Committee: Favorable",13,7,0,2,22
1186150,971569,2020-07-16,Assembly,"Assembly Governmental Operations Committee: Held for Consideration",10,4,0,0,14
1186162,971318,2020-07-14,Assembly,"Assembly Higher Education Committee: Held for Consideration",18,7,0,0,25
1186170,819840,2019-03-04,Senate,"Senate Local Government Committee Vote",7,0,0,0,7
1186170,819841,2019-03-12,Senate,"Senate Floor Vote - Final Passage",61,0,0,1,62
1186170,901930,2020-01-13,Senate,"Senate Local Government Committee Vote",6,0,0,1,7
1186170,934834,2020-02-25,Senate,"Senate Floor Vote - Final Passage",60,0,0,2,62
1186182,857434,2019-04-29,Assembly,"Assembly Floor Vote - Final Passage",48,96,0,6,150
1186182,971996,2020-07-17,Assembly,"Assembly Ways And Means Committee: Held for Consideration",22,10,0,2,34
1186193,881108,2019-02-27,Senate,"Senate Labor Committee Vote",13,0,0,0,13
1186193,882098,2019-06-12,Senate,"Senate Floor Vote - Final Passage",62,0,0,0,62
1186200,868829,2019-04-09,Senate,"Senate Veterans, Homeland Security and Military Affairs Committee Vote",9,0,0,0,9
1186200,868830,2019-05-21,Senate,"Senate Floor Vote - Final Passage",61,0,0,1,62
1186203,971653,2020-07-16,Assembly,"Assembly Governmental Operations Committee: Held for Consideration",10,4,0,0,14
1186209,971327,2020-07-14,Assembly,"Assembly Higher Education Committee: Held for Consideration",17,8,0,0,25
1186232,868408,2019-05-21,Assembly,"Assembly Correction Committee: Favorable refer to committee Codes",9,1,0,3,13
1186232,875045,2019-05-30,Assembly,"Assembly Codes Committee: Favorable",15,4,0,3,22
1186235,857563,2019-04-30,Assembly,"Assembly Social Services Committee: Favorable refer to committee Ways and Means",13,5,0,0,18
1186235,879382,2019-06-06,Assembly,"Assembly Ways And Means Committee: Favorable refer to committee Rules",21,10,0,4,35
1186235,880477,2019-06-11,Assembly,"Assembly Rules Committee: Favorable",25,0,0,6,31
1186241,970807,2020-07-13,Assembly,"Assembly Health Committee: Held for Consideration",18,6,0,2,26
1186281,971979,2020-07-17,Assembly,"Assembly Ways And Means Committee: Held for Consideration",22,10,0,2,34
1186329,970901,2020-07-13,Assembly,"Assembly Corporations, Authorities And Commissions Committee: Held for Consideration",19,7,0,0,26
1186333,814796,2019-03-06,Assembly,"Assembly Mental Health Committee: Favorable",11,0,0,2,13
1186333,822615,2019-03-14,Assembly,"Assembly Floor Vote - Final Passage",134,0,0,16,150
1186333,886289,2019-06-19,Senate,"Senate Floor Vote - Final Passage",62,0,0,0,62
1186357,813706,2019-03-05,Assembly,"Assembly Children And Families Committee: Favorable refer to committee Codes",15,0,0,1,16
1186357,819260,2019-03-12,Assembly,"Assembly Codes Committee: Favorable",21,0,0,1,22
1186357,825273,2019-03-19,Assembly,"Assembly Floor Vote - Final Passage",147,0,0,3,150
1186357,875039,2019-05-30,Senate,"Senate Floor Vote - Final Passage",57,1,0,4,62
1186366,857205,2019-04-30,Assembly,"Assembly Children And Families Committee: Favorable refer to committee Ways and Means",14,0,0,2,16
1186366,863842,2019-05-14,Assembly,"Assembly Ways And Means Committee: Favorable",32,0,0,3,35
1186366,867875,2019-05-20,Assembly,"Assembly Floor Vote - Final Passage",143,0,0,7,150
1186366,875228,2019-05-30,Senate,"Senate Floor Vote - Final Passage",55,3,0,4,62
1186371,825394,2019-03-19,Assembly,"Assembly Aging Committee: Favorable",23,3,0,4,30
1186371,834423,2019-04-02,Assembly,"Assembly Floor Vote - Final Passage",140,2,0,8,150
1186375,971238,2020-07-14,Assembly,"Assembly Education Committee: Held for Consideration",23,6,0,2,31
1186413,934818,2020-02-25,Assembly,"Assembly Governmental Operations Committee: Held for Consideration",9,4,0,1,14
1186435,876057,2019-05-30,Assembly,"Assembly Social Services Committee: Favorable refer to committee Ways and Means",15,1,0,2,18
1186458,857526,2019-04-30,Assembly,"Assembly Housing Committee: Favorable refer to committee Codes",25,0,0,3,28
1186458,859852,2019-05-07,Assembly,"Assembly Codes Committee: Favorable",20,0,0,2,22
1186458,864235,2019-05-14,Assembly,"Assembly Floor Vote - Final Passage",136,5,0,9,150
1186458,886689,2019-06-19,Senate,"Senate Floor Vote - Final Passage",62,0,0,0,62
1186472,813691,2019-03-05,Assembly,"Assembly Consumer Affairs And Protection Committee: Favorable refer to committee Codes",16,0,0,0,16
1186472,819514,2019-03-12,Assembly,"Assembly Codes Committee: Favorable",16,5,0,1,22
1186505,970784,2020-07-13,Assembly,"Assembly Economic Development Committee: Held for Consideration",17,7,0,1,25
1186507,839395,2019-04-09,Senate,"Senate Cultural Affairs, Tourism, Parks and Recreation Committee Vote",7,0,0,0,7
1186507,877021,2019-06-03,Senate,"Senate Floor Vote - Final Passage",62,0,0,0,62
1186507,877297,2019-06-03,Senate,"Senate Rules Committee Vote",19,0,0,0,19
1186507,903196,2020-01-14,Senate,"Senate Cultural Affairs, Tourism, Parks and Recreation Committee Vote",7,0,0,0,7
1186512,881543,2019-05-20,Senate,"Senate Corporations, Authorities and Commissions Committee Vote",7,0,0,0,7
1186512,881826,2019-06-13,Senate,"Senate Floor Vote - Final Passage",62,0,0,0,62
1186514,971576,2020-07-16,Assembly,"Assembly Real Property Taxation Committee: Held for Consideration",8,2,0,0,10
1186516,970997,2020-07-14,Assembly,"Assembly Education Committee: Held for Consideration",23,6,0,2,31
1186691,971255,2020-07-14,Assembly,"Assembly Education Committee: Held for Consideration",23,6,0,2,31
1186704,814720,2019-02-26,Senate,"Senate Civil Service and Pensions Committee Vote",6,1,0,0,7
1186704,814721,2019-03-06,Senate,"Senate Floor Vote - Final Passage",61,1,0,1,63
1186704,904643,2020-01-22,Senate,"Senate Civil Service and Pensions Committee Vote",6,1,0,0,7
1186704,909242,2020-01-29,Senate,"Senate Floor Vote - Final Passage",57,1,0,4,62
1186706,811001,2019-02-28,Assembly,"Assembly Correction Committee: Favorable",9,3,0,1,13
1186706,831631,2019-03-28,Assembly,"Assembly Floor Vote - Final Passage",96,46,0,8,150
1186706,882187,2019-06-14,Senate,"Senate Floor Vote - Final Passage",47,15,0,0,62
1186707,881811,2019-06-14,Assembly,"Assembly Cities Committee: Favorable refer to committee Ways and Means",15,0,0,0,15
1186707,882653,2019-06-17,Assembly,"Assembly Rules Committee: Favorable",25,0,0,6,31
1186707,882654,2019-06-17,Assembly,"Assembly Ways And Means Committee: Favorable refer to committee Rules",31,2,0,2,35
1186712,868884,2019-05-21,Assembly,"Assembly Economic Development Committee: Favorable",24,0,0,2,26
1186719,878939,2019-06-06,Assembly,"Assembly Environmental Conservation Committee: Favorable refer to committee Codes",28,0,0,2,30
1186719,880228,2019-06-11,Assembly,"Assembly Codes Committee: Favorable refer to committee Rules",22,0,0,0,22
1186719,906885,2020-01-28,Assembly,"Assembly Codes Committee: Favorable",20,1,0,1,22
1186719,935082,2020-02-25,Assembly,"Assembly Floor Vote - Final Passage",136,2,0,9,147
1186719,973652,2020-07-23,Senate,"Senate Floor Vote - Final Passage",48,12,0,0,60
1186724,810987,2019-02-28,Assembly,"Assembly Correction Committee: Favorable refer to committee Ways and Means",9,3,0,1,13
1186726,813871,2019-03-05,Assembly,"Assembly Energy Committee: Favorable refer to committee Ways and Means",15,1,0,1,17
1186726,882695,2019-06-17,Assembly,"Assembly Ways And Means Committee: Favorable refer to committee Rules",31,2,0,2,35
1186726,885263,2019-06-20,Assembly,"Assembly Rules Committee: Favorable",27,0,0,4,31
1186734,971739,2020-07-17,Assembly,"Assembly Codes Committee: Held for Consideration",15,6,0,1,22
1186739,970926,2020-07-13,Assembly,"Assembly Consumer Affairs And Protection Committee: Held for Consideration",12,3,0,1,16
1186745,810985,2019-02-28,Assembly,"Assembly Correction Committee: Favorable refer to committee Codes",9,3,0,1,13
1186766,877232,2019-06-04,Assembly,"Assembly Correction Committee: Favorable refer to committee Codes",10,3,0,0,13
1186778,818295,2019-03-11,Senate,"Senate Women's Issues Committee Vote",6,0,0,1,7
1186778,861288,2019-05-07,Senate,"Senate Finance Committee Vote",22,1,0,0,23
1186778,940558,2020-03-02,Senate,"Senate Women's Issues Committee Vote",5,2,0,0,7
1186789,797026,2019-02-11,Senate,"Senate Alcoholism and Substance Abuse Committee Vote",5,2,0,0,7
1186789,814635,2019-03-05,Senate,"Senate Finance Committee Vote",19,2,0,2,23
1186811,971566,2020-07-15,Assembly,"Assembly Tourism, Arts And Sports Development Committee: Held for Consideration",14,6,0,0,20
1186813,814180,2019-02-25,Senate,"Senate Elections Committee Vote",7,0,0,0,7
1186813,814181,2019-03-05,Senate,"Senate Floor Vote - Final Passage",55,5,0,3,63
1186813,826331,2019-03-20,Assembly,"Assembly Floor Vote - Final Passage",110,34,0,6,150
1186845,857013,2019-04-30,Assembly,"Assembly Correction Committee: Favorable refer to committee Ways and Means",9,3,0,1,13
1186856,814154,2019-02-25,Senate,"Senate Elections Committee Vote",7,0,0,0,7
1186856,814155,2019-03-05,Senate,"Senate Floor Vote - Final Passage",58,2,0,3,63
1186856,832700,2019-04-01,Senate,"Senate Floor Vote - Final Passage",61,0,0,1,62
1186864,971140,2020-07-14,Assembly,"Assembly Judiciary Committee: Held for Consideration",15,6,0,0,21
1186892,971234,2020-07-14,Assembly,"Assembly Education Committee: Held for Consideration",23,6,0,2,31
1186900,972094,2020-07-17,Assembly,"Assembly Ways And Means Committee: Held for Consideration",22,10,0,2,34
1186903,970896,2020-07-13,Assembly,"Assembly Corporations, Authorities And Commissions Committee: Held for Consideration",19,7,0,0,26
1186905,837914,2019-03-26,Senate,"Senate Rules Committee Vote",19,0,0,0,19
1186905,837915,2019-04-08,Senate,"Senate Floor Vote - Final Passage",59,0,0,3,62
1186914,863961,2019-05-14,Senate,"Senate Elections Committee Vote",6,0,0,1,7
1186914,877976,2019-06-05,Senate,"Senate Floor Vote - Final Passage",62,0,0,0,62
1186914,877977,2019-06-05,Senate,"Senate Rules Committee Vote",19,0,0,0,19
1186938,797581,2019-02-12,Assembly,"Assembly Corporations, Authorities And Commissions Committee: Favorable",24,0,0,2,26
1186949,838812,2019-04-09,Assembly,"Assembly Small Business Committee: Favorable refer to committee Ways and Means",14,0,0,3,17
1186949,863838,2019-05-14,Assembly,"Assembly Ways And Means Committee: Favorable",32,0,0,3,35
1186965,811004,2019-02-28,Assembly,"Assembly Correction Committee: Favorable refer to committee Ways and Means",9,3,0,1,13
1186965,864839,2019-05-14,Assembly,"Assembly Ways And Means Committee: Favorable",22,10,0,3,35
1186965,886165,2019-06-20,Assembly,"Assembly Floor Vote - Final Passage",143,3,0,4,150
1186967,971231,2020-07-14,Assembly,"Assembly Education Committee: Held for Consideration",23,6,0,2,31
1186972,855335,2019-04-30,Senate,"Senate Veterans, Homeland Security and Military Affairs Committee Vote",9,0,0,0,9
1186981,971242,2020-07-14,Assembly,"Assembly Education Committee: Held for Consideration",23,6,0,2,31
1186990,840821,2019-04-09,Assembly,"Assembly Transportation Committee: Held for Consideration",16,7,0,2,25
1186996,914149,2020-02-04,Assembly,"Assembly Transportation Committee: Favorable refer to committee Codes",18,6,0,1,25
1187019,878338,2019-06-04,Assembly,"Assembly Correction Committee: Favorable refer to committee Codes",10,3,0,0,13
1187021,904477,2020-01-22,Assembly,"Assembly Social Services Committee: Favorable refer to committee Ways and Means",13,5,0,0,18
1187028,810278,2019-02-26,Senate,"Senate Mental Health and Developmental Disabilities Committee Vote",7,0,0,0,7
1187038,877522,2019-06-04,Assembly,"Assembly Labor Committee: Favorable refer to committee Rules",21,7,0,1,29
1187038,880243,2019-06-11,Assembly,"Assembly Rules Committee: Favorable",25,0,0,6,31
1187038,905120,2020-01-22,Assembly,"Assembly Floor Vote - Final Passage",142,0,0,6,148
1187051,825618,2019-03-19,Assembly,"Assembly Real Property Taxation Committee: Favorable refer to committee Codes",9,0,0,1,10
1187051,838918,2019-04-09,Assembly,"Assembly Codes Committee: Favorable refer to committee Ways and Means",22,0,0,0,22
1187051,868956,2019-05-21,Assembly,"Assembly Ways And Means Committee: Favorable",32,0,0,3,35
1187053,884926,2019-06-19,Assembly,"Assembly Rules Committee: Favorable",28,0,0,3,31
1187053,884927,2019-06-19,Assembly,"Assembly Ways And Means Committee: Favorable refer to committee Rules",33,0,0,2,35
1187057,971441,2020-07-15,Assembly,"Assembly Veterans' Affairs Committee: Held for Consideration",13,4,0,2,19
1187068,971103,2020-07-14,Assembly,"Assembly Environmental Conservation Committee: Held for Consideration",19,8,0,1,28
1187075,815325,2019-02-27,Senate,"Senate Investigations and Government Operations Committee Vote",7,0,0,0,7
1187075,815326,2019-03-06,Senate,"Senate Floor Vote - Final Passage",62,0,0,1,63
1187075,884959,2019-06-18,Assembly,"Assembly Floor Vote - Final Passage",145,1,0,4,150
1187111,970789,2020-07-13,Assembly,"Assembly Economic Development Committee: Held for Consideration",17,7,0,1,25
1187112,886522,2019-06-20,Senate,"Senate Floor Vote - Final Passage",60,2,0,0,62
1187112,886523,2019-06-21,Assembly,"Assembly Floor Vote - Final Passage",131,9,0,10,150
1187112,887351,2019-06-20,Senate,"Senate Rules Committee Vote",18,1,0,0,19
1187119,881969,2019-06-12,Senate,"Senate Floor Vote - Final Passage",61,1,0,0,62
1187119,881970,2019-06-12,Senate,"Senate Rules Committee Vote",18,1,0,0,19
1187119,883176,2019-06-17,Assembly,"Assembly Floor Vote - Final Passage",142,6,0,2,150
1187120,935580,2020-02-26,Assembly,"Assembly Children And Families Committee: Favorable refer to committee Ways and Means",15,0,0,1,16
1187173,855534,2019-04-30,Senate,"Senate Transportation Committee Vote",15,0,0,0,15
1187174,815513,2019-03-06,Assembly,"Assembly Mental Health Committee: Favorable refer to committee Ways and Means",11,0,0,2,13
1187174,868966,2019-05-21,Assembly,"Assembly Ways And Means Committee: Favorable",32,0,0,3,35
1187174,875682,2019-05-30,Assembly,"Assembly Floor Vote - Final Passage",142,0,0,8,150
1187174,882036,2019-06-14,Senate,"Senate Floor Vote - Final Passage",62,0,0,0,62
1187196,971357,2020-07-15,Assembly,"Assembly Veterans' Affairs Committee: Held for Consideration",13,4,0,2,19
1187202,971331,2020-07-14,Assembly,"Assembly Higher Education Committee: Held for Consideration",18,7,0,0,25
1187214,971479,2020-07-15,Assembly,"Assembly Labor Committee: Held for Consideration",18,7,0,3,28
1187219,814656,2019-03-05,Senate,"Senate Civil Service and Pensions Committee Vote",7,0,0,0,7
1187219,937341,2020-02-26,Senate,"Senate Civil Service and Pensions Committee Vote",5,2,0,0,7
1187244,935185,2020-02-26,Assembly,"Assembly Racing And Wagering Committee: Favorable",11,0,0,0,11
1187244,940630,2020-03-02,Assembly,"Assembly Floor Vote - Final Passage",138,1,0,8,147
1187248,861612,2019-05-07,Assembly,"Assembly Transportation Committee: Held for Consideration",16,7,0,2,25
1187255,971312,2020-07-14,Assembly,"Assembly Higher Education Committee: Held for Consideration",18,7,0,0,25
1187288,970767,2020-07-13,Assembly,"Assembly Economic Development Committee: Held for Consideration",17,7,0,1,25
1187293,815636,2019-02-27,Senate,"Senate Investigations and Government Operations Committee Vote",7,0,0,0,7
1187293,816184,2019-03-07,Senate,"Senate Floor Vote - Final Passage",58,0,0,5,63
1187293,902599,2020-01-14,Senate,"Senate Investigations and Government Operations Committee Vote",7,0,0,0,7
1187296,860875,2019-05-06,Assembly,"Assembly Ways And Means Committee: Favorable",23,9,0,3,35
1187296,868035,2019-05-20,Assembly,"Assembly Floor Vote - Final Passage",105,39,0,6,150
1187296,884598,2019-06-18,Senate,"Senate Floor Vote - Final Passage",47,15,0,0,62
1187311,857101,2019-04-30,Assembly,"Assembly Labor Committee: Favorable refer to committee Codes",27,0,0,2,29
1187311,860515,2019-05-07,Assembly,"Assembly Codes Committee: Favorable refer to committee Ways and Means",20,0,0,2,22
1187311,882113,2019-06-14,Assembly,"Assembly Ways And Means Committee: Favorable refer to committee Rules",29,1,0,5,35
1187311,882423,2019-06-17,Assembly,"Assembly Rules Committee: Favorable",26,0,0,5,31
1187337,878472,2019-06-04,Assembly,"Assembly Labor Committee: Favorable refer to committee Codes",28,0,0,1,29
1187337,882661,2019-06-17,Assembly,"Assembly Codes Committee: Favorable refer to committee Ways and Means",20,0,0,2,22
1187337,883594,2019-06-18,Assembly,"Assembly Rules Committee: Favorable",25,0,0,6,31
1187337,883595,2019-06-18,Assembly,"Assembly Ways And Means Committee: Favorable refer to committee Rules",33,0,0,2,35
1187344,970893,2020-07-13,Assembly,"Assembly Corporations, Authorities And Commissions Committee: Held for Consideration",19,7,0,0,26
1187356,811388,2019-02-28,Assembly,"Assembly Health Committee: Favorable refer to committee Codes",25,0,0,1,26
1187374,857470,2019-04-30,Assembly,"Assembly Judiciary Committee: Favorable refer to committee Codes",14,5,0,2,21
1187374,859828,2019-05-07,Assembly,"Assembly Codes Committee: Favorable",19,1,0,2,22
1187387,875795,2019-05-30,Senate,"Senate Consumer Protection Committee Vote",7,0,0,0,7
1187413,970906,2020-07-13,Assembly,"Assembly Corporations, Authorities And Commissions Committee: Held for Consideration",19,7,0,0,26
1187416,879273,2019-06-06,Assembly,"Assembly Environmental Conservation Committee: Favorable refer to committee Ways and Means",28,0,0,2,30
1187416,879274,2019-06-06,Assembly,"Assembly Ways And Means Committee: Favorable refer to committee Rules",28,3,0,4,35
1187416,880546,2019-06-11,Assembly,"Assembly Rules Committee: Favorable",25,0,0,6,31
1187416,881611,2019-06-13,Assembly,"Assembly Floor Vote - Final Passage",128,17,0,5,150
1187422,813605,2019-03-05,Assembly,"Assembly Consumer Affairs And Protection Committee: Favorable refer to committee Codes",16,0,0,0,16
1187422,819566,2019-03-12,Assembly,"Assembly Codes Committee: Favorable",21,0,0,1,22
1187422,875238,2019-05-30,Senate,"Senate Floor Vote - Final Passage",52,6,0,4,62
1187422,875623,2019-05-30,Assembly,"Assembly Floor Vote - Final Passage",142,1,0,7,150
1187423,859235,2019-04-29,Senate,"Senate Insurance Committee Vote",11,0,0,0,11
1187423,859236,2019-05-06,Senate,"Senate Floor Vote - Final Passage",61,0,0,1,62
1187423,902181,2020-01-13,Senate,"Senate Insurance Committee Vote",11,0,0,0,11
1187423,915049,2020-02-04,Senate,"Senate Floor Vote - Final Passage",61,0,0,1,62
1187423,972530,2020-07-20,Assembly,"Assembly Floor Vote - Final Passage",139,2,0,4,145
1187427,971206,2020-07-14,Assembly,"Assembly Election Law Committee: Held for Consideration",12,4,0,0,16
1187433,971236,2020-07-14,Assembly,"Assembly Education Committee: Held for Consideration",23,6,0,2,31
1187437,814332,2019-02-25,Senate,"Senate Elections Committee Vote",7,0,0,0,7
1187437,814333,2019-03-05,Senate,"Senate Floor Vote - Final Passage",60,0,0,3,63
1187443,810549,2019-02-27,Assembly,"Assembly Governmental Employees Committee: Favorable refer to committee Ways and Means",13,0,0,1,14
1187443,884817,2019-06-19,Assembly,"Assembly Ways And Means Committee: Favorable refer to committee Rules",32,1,0,2,35
1187443,885266,2019-06-20,Assembly,"Assembly Rules Committee: Favorable",27,0,0,4,31
1187456,971218,2020-07-14,Assembly,"Assembly Judiciary Committee: Held for Consideration",15,6,0,0,21
1187465,874025,2019-05-29,Senate,"Senate Elections Committee Vote",5,2,0,0,7
1187473,971926,2020-07-17,Assembly,"Assembly Codes Committee: Held for Consideration",15,6,0,1,22
1187478,971337,2020-07-15,Assembly,"Assembly Veterans' Affairs Committee: Held for Consideration",12,5,0,2,19
1187481,822313,2019-03-14,Assembly,"Assembly Transportation Committee: Favorable",21,1,0,3,25
1187481,829721,2019-03-26,Assembly,"Assembly Floor Vote - Final Passage",103,44,0,3,150
1187495,856062,2019-04-30,Senate,"Senate Health Committee Vote",15,0,0,0,15
1187495,882142,2019-06-14,Senate,"Senate Floor Vote - Final Passage",62,0,0,0,62
1187495,882143,2019-06-14,Senate,"Senate Rules Committee Vote",19,0,0,0,19
1187502,970806,2020-07-13,Assembly,"Assembly Economic Development Committee: Held for Consideration",17,7,0,1,25
1187504,868307,2019-05-21,Assembly,"Assembly Governmental Operations Committee: Favorable refer to committee Codes",14,0,0,0,14
1187504,875020,2019-05-30,Assembly,"Assembly Codes Committee: Favorable",19,0,0,3,22
1187504,877757,2019-06-04,Assembly,"Assembly Floor Vote - Final Passage",147,0,0,3,150
1187504,880260,2019-06-11,Senate,"Senate Floor Vote - Final Passage",61,0,0,1,62
1187514,818463,2019-02-12,Senate,"Senate Transportation Committee Vote",15,0,0,0,15
1187514,818464,2019-03-11,Senate,"Senate Floor Vote - Final Passage",62,0,0,0,62
1187514,861152,2019-05-07,Assembly,"Assembly Floor Vote - Final Passage",132,1,0,17,150
1187519,971927,2020-07-17,Assembly,"Assembly Codes Committee: Held for Consideration",15,6,0,1,22
1187534,970923,2020-07-13,Assembly,"Assembly Consumer Affairs And Protection Committee: Held for Consideration",12,3,0,1,16
1187536,972052,2020-07-17,Assembly,"Assembly Ways And Means Committee: Held for Consideration",22,10,0,2,34
1187537,971169,2020-07-14,Assembly,"Assembly Correction Committee: Held for Consideration",10,2,0,1,13
1187550,797122,2019-02-11,Assembly,"Assembly Codes Committee: Favorable",22,0,0,0,22
1187571,809762,2019-02-27,Assembly,"Assembly Governmental Employees Committee: Favorable refer to committee Ways and Means",13,0,0,1,14
1187571,878586,2019-06-05,Assembly,"Assembly Ways And Means Committee: Favorable refer to committee Rules",29,2,0,4,35
1187571,880237,2019-06-11,Assembly,"Assembly Rules Committee: Favorable",25,0,0,6,31
1187571,884232,2019-06-18,Assembly,"Assembly Floor Vote - Final Passage",146,2,0,2,150
1187571,886314,2019-06-19,Senate,"Senate Floor Vote - Final Passage",62,0,0,0,62
1187581,883793,2019-05-06,Senate,"Senate Codes Committee Vote",13,0,0,0,13
1187581,885550,2019-06-18,Senate,"Senate Floor Vote - Final Passage",60,2,0,0,62
1187588,876663,2019-05-21,Senate,"Senate Housing, Construction and Community Development Committee Vote",10,1,0,0,11
1187588,876664,2019-06-03,Senate,"Senate Floor Vote - Final Passage",62,0,0,0,62
1187591,881791,2019-06-14,Assembly,"Assembly Transportation Committee: Favorable refer to committee Codes",22,2,0,1,25
1187591,882626,2019-06-17,Assembly,"Assembly Rules Committee: Favorable",25,0,0,6,31
1187591,882627,2019-06-17,Assembly,"Assembly Codes Committee: Favorable refer to committee Rules",20,0,0,2,22
1187595,881891,2019-06-12,Senate,"Senate Floor Vote - Final Passage",62,0,0,0,62
1187595,881893,2019-06-12,Senate,"Senate Rules Committee Vote",19,0,0,0,19
1187595,906468,2020-01-27,Senate,"Senate Codes Committee Vote",12,0,0,0,12
1187607,971571,2020-07-15,Assembly,"Assembly Tourism, Arts And Sports Development Committee: Held for Consideration",14,6,0,0,20
1187618,971278,2020-07-14,Assembly,"Assembly Education Committee: Held for Consideration",23,6,0,2,31
1187633,886464,2019-06-19,Senate,"Senate Floor Vote - Final Passage",42,20,0,0,62
1187633,887308,2019-06-19,Senate,"Senate Rules Committee Vote",16,3,0,0,19
1187635,840882,2019-04-09,Assembly,"Assembly Higher Education Committee: Favorable",25,1,0,0,26
1187646,971987,2020-07-17,Assembly,"Assembly Ways And Means Committee: Held for Consideration",22,10,0,2,34
1187657,970757,2020-07-13,Assembly,"Assembly Economic Development Committee: Held for Consideration",17,7,0,1,25
1187662,874742,2019-05-30,Senate,"Senate Veterans, Homeland Security and Military Affairs Committee Vote",9,0,0,0,9
1187662,882079,2019-06-14,Senate,"Senate Floor Vote - Final Passage",62,0,0,0,62
1187662,882080,2019-06-14,Senate,"Senate Rules Committee Vote",19,0,0,0,19
1187666,808926,2019-02-26,Senate,"Senate Civil Service and Pensions Committee Vote",7,0,0,0,7
1187666,887096,2019-06-19,Senate,"Senate Floor Vote - Final Passage",62,0,0,0,62
1187666,887097,2019-06-19,Senate,"Senate Rules Committee Vote",19,0,0,0,19
1187672,868879,2019-05-21,Assembly,"Assembly Economic Development Committee: Favorable refer to committee Codes",17,7,0,2,26
1187672,875060,2019-05-30,Assembly,"Assembly Codes Committee: Favorable",15,4,0,3,22
1187676,971801,2020-07-16,Assembly,"Assembly Local Governments Committee: Held for Consideration",15,4,0,1,20
1187677,809776,2019-02-27,Assembly,"Assembly Real Property Taxation Committee: Favorable refer to committee Ways and Means",9,0,0,1,10
1187677,864840,2019-05-14,Assembly,"Assembly Ways And Means Committee: Favorable",32,0,0,3,35
1187677,869430,2019-05-21,Assembly,"Assembly Floor Vote - Final Passage",147,0,0,3,150
1187677,881809,2019-06-12,Senate,"Senate Floor Vote - Final Passage",62,0,0,0,62
1187686,820791,2019-03-12,Assembly,"Assembly Veterans' Affairs Committee: Favorable",19,0,0,0,19
1187686,826210,2019-03-20,Assembly,"Assembly Floor Vote - Final Passage",144,0,0,6,150
1187686,856701,2019-05-01,Senate,"Senate Floor Vote - Final Passage",62,0,0,0,62
1187690,972041,2020-07-17,Assembly,"Assembly Ways And Means Committee: Held for Consideration",22,10,0,2,34
1187708,970836,2020-07-13,Assembly,"Assembly Health Committee: Favorable refer to committee Codes",15,9,0,2,26
1187718,970865,2020-07-13,Assembly,"Assembly Agriculture Committee: Held for Consideration",13,6,0,2,21
1187720,971610,2020-07-16,Assembly,"Assembly Governmental Operations Committee: Held for Consideration",10,4,0,0,14
1187724,869909,2019-04-30,Senate,"Senate Children and Families Committee Vote",7,0,0,0,7
1187724,869910,2019-05-22,Senate,"Senate Floor Vote - Final Passage",55,6,0,1,62
1187724,881897,2019-06-12,Senate,"Senate Floor Vote - Final Passage",57,5,0,0,62
1187724,904391,2020-01-21,Senate,"Senate Children and Families Committee Vote",7,0,0,0,7
1187726,877026,2019-06-03,Senate,"Senate Floor Vote - Final Passage",62,0,0,0,62
1187726,877313,2019-06-03,Senate,"Senate Rules Committee Vote",19,0,0,0,19
1187726,885017,2019-06-19,Assembly,"Assembly Floor Vote - Final Passage",148,0,0,2,150
1187728,971673,2020-07-16,Assembly,"Assembly Governmental Operations Committee: Held for Consideration",10,4,0,0,14
1187752,971609,2020-07-16,Assembly,"Assembly Governmental Operations Committee: Held for Consideration",10,4,0,0,14
1187759,971732,2020-07-17,Assembly,"Assembly Ways And Means Committee: Held for Consideration",22,10,0,2,34
1187771,883973,2019-03-12,Senate,"Senate Cities Committee Vote",7,0,0,0,7
1187771,884989,2019-06-18,Senate,"Senate Floor Vote - Final Passage",61,1,0,0,62
1187777,972057,2020-07-17,Assembly,"Assembly Ways And Means Committee: Held for Consideration",22,10,0,2,34
1187789,919817,2020-02-11,Assembly,"Assembly Social Services Committee: Held for Consideration",12,5,0,0,17
1187796,857042,2019-04-30,Assembly,"Assembly Correction Committee: Favorable refer to committee Ways and Means",12,0,0,1,13
1187796,869055,2019-05-21,Assembly,"Assembly Ways And Means Committee: Favorable",32,0,0,3,35
1187796,875771,2019-05-30,Assembly,"Assembly Floor Vote - Final Passage",131,11,0,8,150
1187799,875794,2019-05-29,Senate,"Senate Banks Committee Vote",7,4,0,0,11
1187804,876051,2019-05-30,Assembly,"Assembly Consumer Affairs And Protection Committee: Favorable refer to committee Codes",15,0,0,1,16
1187804,880285,2019-06-11,Assembly,"Assembly Codes Committee: Favorable refer to committee Rules",22,0,0,0,22
1187804,881339,2019-06-13,Assembly,"Assembly Rules Committee: Favorable",26,0,0,5,31
1187810,972012,2020-07-17,Assembly,"Assembly Codes Committee: Held for Consideration",15,6,0,1,22
1187819,811337,2019-02-28,Assembly,"Assembly Health Committee: Favorable refer to committee Ways and Means",24,1,0,1,26
1187819,875602,2019-05-30,Assembly,"Assembly Ways And Means Committee: Favorable",31,0,0,4,35
1187819,877756,2019-06-04,Assembly,"Assembly Floor Vote - Final Passage",140,7,0,3,150
1187819,886688,2019-06-19,Senate,"Senate Floor Vote - Final Passage",62,0,0,0,62
1187825,856165,2019-04-30,Senate,"Senate Judiciary Committee Vote",14,1,0,0,15
1187825,882158,2019-06-14,Senate,"Senate Floor Vote - Final Passage",62,0,0,0,62
1187825,882159,2019-06-14,Senate,"Senate Rules Committee Vote",19,0,0,0,19
1187827,877845,2019-06-05,Assembly,"Assembly Local Governments Committee: Favorable refer to committee Ways and Means",18,0,0,1,19
1187827,881591,2019-06-13,Assembly,"Assembly Ways And Means Committee: Favorable refer to committee Rules",29,0,0,6,35
1187827,882431,2019-06-17,Assembly,"Assembly Rules Committee: Favorable",26,0,0,5,31
1187836,809750,2019-02-27,Assembly,"Assembly Governmental Employees Committee: Favorable refer to committee Ways and Means",13,0,0,1,14
1187836,877735,2019-06-04,Assembly,"Assembly Ways And Means Committee: Favorable refer to committee Rules",32,1,0,2,35
1187836,877971,2019-06-05,Assembly,"Assembly Rules Committee: Favorable",27,0,0,4,31
1187840,880977,2019-05-30,Senate,"Senate Transportation Committee Vote",14,1,0,0,15
1187840,881742,2019-06-12,Senate,"Senate Floor Vote - Final Passage",62,0,0,0,62
1187846,971998,2020-07-17,Assembly,"Assembly Codes Committee: Held for Consideration",15,6,0,1,22
1187847,881463,2019-05-08,Senate,"Senate Banks Committee Vote",7,4,0,0,11
1187847,881721,2019-06-13,Senate,"Senate Floor Vote - Final Passage",43,19,0,0,62
1187847,885392,2019-06-19,Assembly,"Assembly Floor Vote - Final Passage",109,40,0,1,150
1187871,972037,2020-07-17,Assembly,"Assembly Ways And Means Committee: Held for Consideration",22,10,0,2,34
1187875,809766,2019-02-27,Assembly,"Assembly Higher Education Committee: Favorable refer to committee Codes",25,0,0,1,26
1187875,882198,2019-06-13,Assembly,"Assembly Codes Committee: Favorable refer to committee Rules",20,0,0,2,22
1187875,882472,2019-06-17,Assembly,"Assembly Rules Committee: Favorable",26,0,0,5,31
1187908,971669,2020-07-16,Assembly,"Assembly Housing Committee: Held for Consideration",18,8,0,2,28
1187931,971638,2020-07-16,Assembly,"Assembly Governmental Operations Committee: Held for Consideration",10,4,0,0,14
1187946,809775,2019-02-27,Assembly,"Assembly Racing And Wagering Committee: Favorable refer to committee Codes",11,0,0,0,11
1187946,814297,2019-03-05,Assembly,"Assembly Codes Committee: Favorable",22,0,0,0,22
1187946,822639,2019-03-14,Assembly,"Assembly Floor Vote - Final Passage",129,5,0,16,150
1187946,880420,2019-06-11,Senate,"Senate Floor Vote - Final Passage",58,3,0,1,62
1187955,971596,2020-07-16,Assembly,"Assembly Real Property Taxation Committee: Held for Consideration",8,2,0,0,10
1187974,971476,2020-07-15,Assembly,"Assembly Labor Committee: Held for Consideration",18,7,0,3,28
1188014,857037,2019-05-01,Assembly,"Assembly Election Law Committee: Favorable refer to committee Ways and Means",16,0,0,0,16
1188014,882329,2019-06-14,Assembly,"Assembly Ways And Means Committee: Favorable refer to committee Rules",22,8,0,5,35
1188014,882514,2019-06-17,Assembly,"Assembly Rules Committee: Favorable",26,0,0,5,31
1188019,971500,2020-07-15,Assembly,"Assembly Labor Committee: Held for Consideration",18,7,0,3,28
1188034,936945,2020-02-26,Assembly,"Assembly Children And Families Committee: Held for Consideration",10,5,0,1,16
1188038,970925,2020-07-13,Assembly,"Assembly Agriculture Committee: Held for Consideration",13,6,0,2,21
1188047,857479,2019-04-30,Assembly,"Assembly Codes Committee: Favorable",13,7,0,2,22
1188047,963676,2020-06-08,Assembly,"Assembly Floor Vote - Final Passage",105,39,0,3,147
1188056,820145,2019-03-12,Assembly,"Assembly Environmental Conservation Committee: Favorable refer to committee Codes",25,4,0,1,30
1188056,823408,2019-03-18,Assembly,"Assembly Codes Committee: Favorable",17,4,0,1,22
1188116,971482,2020-07-15,Assembly,"Assembly Labor Committee: Held for Consideration",18,7,0,3,28
1188174,971092,2020-07-14,Assembly,"Assembly Higher Education Committee: Held for Consideration",18,7,0,0,25
1188182,971957,2020-07-17,Assembly,"Assembly Ways And Means Committee: Held for Consideration",22,10,0,2,34
1188192,971793,2020-07-17,Assembly,"Assembly Ways And Means Committee: Held for Consideration",22,10,0,2,34
1188199,797684,2019-02-12,Assembly,"Assembly Corporations, Authorities And Commissions Committee: Favorable refer to committee Ways and Means",24,0,0,2,26
1188209,970943,2020-07-13,Assembly,"Assembly Consumer Affairs And Protection Committee: Held for Consideration",12,3,0,1,16
1188241,970942,2020-07-13,Assembly,"Assembly Agriculture Committee: Held for Consideration",13,6,0,2,21
1188247,971113,2020-07-14,Assembly,"Assembly Environmental Conservation Committee: Held for Consideration",19,8,0,1,28
1188262,868969,2019-05-22,Assembly,"Assembly Election Law Committee: Favorable refer to committee Codes",14,0,0,2,16
1188262,875044,2019-05-30,Assembly,"Assembly Codes Committee: Favorable refer to committee Ways and Means",19,0,0,3,22
1188293,971655,2020-07-16,Assembly,"Assembly Governmental Operations Committee: Held for Consideration",10,4,0,0,14
1188312,868622,2019-05-21,Assembly,"Assembly Transportation Committee: Held for Consideration",17,8,0,0,25
1188325,870081,2019-05-21,Assembly,"Assembly Corporations, Authorities And Commissions Committee: Favorable refer to committee Codes",20,5,0,1,26
1188325,874805,2019-05-30,Assembly,"Assembly Codes Committee: Favorable",19,0,0,3,22
1188325,881815,2019-06-13,Assembly,"Assembly Floor Vote - Final Passage",129,11,0,10,150
1188354,864855,2019-05-14,Assembly,"Assembly Ways And Means Committee: Favorable",32,0,0,3,35
1188354,869059,2019-05-21,Assembly,"Assembly Floor Vote - Final Passage",139,8,0,3,150
1188354,881783,2019-06-13,Senate,"Senate Floor Vote - Final Passage",62,0,0,0,62
1188371,879264,2019-06-06,Assembly,"Assembly Ways And Means Committee: Favorable refer to committee Rules",31,0,0,4,35
1188371,880492,2019-06-11,Assembly,"Assembly Rules Committee: Favorable",25,0,0,6,31
1188371,881601,2019-06-13,Assembly,"Assembly Floor Vote - Final Passage",133,12,0,5,150
1188422,878981,2019-06-06,Assembly,"Assembly Environmental Conservation Committee: Favorable refer to committee Rules",21,7,0,2,30
1189030,883993,2019-06-18,Assembly,"Assembly Local Governments Committee: Favorable refer to committee Ways and Means",16,1,0,2,19
1189030,884820,2019-06-19,Assembly,"Assembly Ways And Means Committee: Favorable refer to committee Rules",27,6,0,2,35
1189030,885252,2019-06-20,Assembly,"Assembly Rules Committee: Favorable",27,0,0,4,31
1189033,971967,2020-07-17,Assembly,"Assembly Ways And Means Committee: Held for Consideration",22,10,0,2,34
1189047,971252,2020-07-14,Assembly,"Assembly Education Committee: Held for Consideration",23,6,0,2,31
1189062,824292,2019-03-19,Assembly,"Assembly Judiciary Committee: Favorable",14,6,0,1,21
1189069,971647,2020-07-16,Assembly,"Assembly Governmental Operations Committee: Favorable refer to committee Ways and Means",14,0,0,0,14
1189073,971260,2020-07-14,Assembly,"Assembly Education Committee: Held for Consideration",23,6,0,2,31
1189086,878114,2019-06-05,Assembly,"Assembly Transportation Committee: Favorable refer to committee Codes",25,1,0,0,26
1189086,880224,2019-06-11,Assembly,"Assembly Codes Committee: Favorable refer to committee Rules",22,0,0,0,22
1189086,881336,2019-06-13,Assembly,"Assembly Rules Committee: Favorable",26,0,0,5,31
1189091,972020,2020-07-17,Assembly,"Assembly Codes Committee: Held for Consideration",15,6,0,1,22
1189098,868377,2019-05-21,Assembly,"Assembly Health Committee: Favorable refer to committee Codes",19,7,0,0,26
1189098,886779,2019-06-19,Assembly,"Assembly Codes Committee: Favorable refer to committee Rules",16,6,0,0,22
1189098,886780,2019-06-20,Assembly,"Assembly Rules Committee: Favorable",27,0,0,4,31
1189108,867313,2019-02-11,Senate,"Senate Health Committee Vote",14,0,0,1,15
1189108,867836,2019-05-20,Senate,"Senate Floor Vote - Final Passage",60,0,0,2,62
1189108,882254,2019-06-14,Senate,"Senate Floor Vote - Final Passage",62,0,0,0,62
1189108,884036,2019-06-18,Assembly,"Assembly Floor Vote - Final Passage",148,0,0,2,150
1189125,825696,2019-02-27,Senate,"Senate Investigations and Government Operations Committee Vote",7,0,0,0,7
1189125,825697,2019-03-20,Senate,"Senate Floor Vote - Final Passage",55,7,0,0,62
1189131,971309,2020-07-14,Assembly,"Assembly Higher Education Committee: Held for Consideration",16,9,0,0,25
1189135,879157,2019-06-05,Assembly,"Assembly Transportation Committee: Held for Consideration",19,7,0,0,26
1189142,970938,2020-07-13,Assembly,"Assembly Agriculture Committee: Held for Consideration",14,5,0,2,21
1189143,971990,2020-07-17,Assembly,"Assembly Codes Committee: Held for Consideration",15,6,0,1,22
1189145,880744,2019-06-12,Assembly,"Assembly Local Governments Committee: Favorable refer to committee Ways and Means",17,0,0,2,19
1189145,881585,2019-06-13,Assembly,"Assembly Ways And Means Committee: Favorable refer to committee Rules",29,0,0,6,35
1189145,882480,2019-06-17,Assembly,"Assembly Rules Committee: Favorable",26,0,0,5,31
1189156,970755,2020-07-13,Assembly,"Assembly Health Committee: Held for Consideration",18,6,0,2,26
1189158,972079,2020-07-17,Assembly,"Assembly Ways And Means Committee: Held for Consideration",22,10,0,2,34
1189174,820777,2019-03-12,Assembly,"Assembly Tourism, Arts And Sports Development Committee: Favorable refer to committee Codes",19,0,0,1,20
1189185,819328,2019-03-12,Assembly,"Assembly Election Law Committee: Favorable refer to committee Codes",15,0,0,1,16
1189185,819329,2019-03-12,Assembly,"Assembly Codes Committee: Favorable refer to committee Rules",21,0,0,1,22
1189185,820211,2019-03-12,Assembly,"Assembly Floor Vote - Final Passage",142,0,0,8,150
1189185,820897,2019-03-12,Assembly,"Assembly Rules Committee: Favorable",27,0,0,4,31
1189185,882109,2019-06-13,Senate,"Senate Floor Vote - Final Passage",61,1,0,0,62
1189191,870180,2019-05-21,Assembly,"Assembly Transportation Committee: Held for Consideration",17,8,0,0,25
1189193,879164,2019-06-05,Assembly,"Assembly Transportation Committee: Held for Consideration",19,7,0,0,26
1189213,971101,2020-07-14,Assembly,"Assembly Environmental Conservation Committee: Held for Consideration",19,8,0,1,28
1189219,971974,2020-07-17,Assembly,"Assembly Ways And Means Committee: Held for Consideration",22,10,0,2,34
1189220,874633,2019-05-29,Assembly,"Assembly Environmental Conservation Committee: Favorable refer to committee Ways and Means",29,0,0,1,30
1189229,882212,2019-06-13,Assembly,"Assembly Codes Committee: Held for Consideration",14,6,0,2,22
1189232,811246,2019-02-28,Assembly,"Assembly Health Committee: Favorable refer to committee Codes",18,7,0,1,26
1189236,971180,2020-07-14,Assembly,"Assembly Correction Committee: Held for Consideration",10,2,0,1,13
1189252,878932,2019-06-06,Assembly,"Assembly Environmental Conservation Committee: Favorable refer to committee Codes",26,2,0,2,30
1189252,881425,2019-06-13,Assembly,"Assembly Codes Committee: Favorable refer to committee Rules",19,1,0,2,22
1189252,883990,2019-06-18,Assembly,"Assembly Rules Committee: Favorable",24,1,0,6,31
1189252,974077,2020-07-23,Assembly,"Assembly Floor Vote - Final Passage",118,23,0,4,145
1189257,881771,2019-05-07,Senate,"Senate Commerce, Economic Development And Small Business Committee Vote",9,0,0,0,9
1189257,882239,2019-06-14,Senate,"Senate Floor Vote - Final Passage",62,0,0,0,62
1189257,884184,2019-06-18,Assembly,"Assembly Floor Vote - Final Passage",142,4,0,4,150
1189271,880869,2019-06-12,Assembly,"Assembly Real Property Taxation Committee: Favorable refer to committee Ways and Means",9,0,0,1,10
1189271,882053,2019-06-14,Assembly,"Assembly Ways And Means Committee: Favorable refer to committee Rules",29,1,0,5,35
1189271,882507,2019-06-17,Assembly,"Assembly Rules Committee: Favorable",26,0,0,5,31
1189278,857044,2019-04-30,Assembly,"Assembly Real Property Taxation Committee: Favorable refer to committee Ways and Means",9,0,0,1,10
1189278,874753,2019-05-30,Assembly,"Assembly Ways And Means Committee: Favorable",31,0,0,4,35
1189278,878049,2019-06-04,Assembly,"Assembly Floor Vote - Final Passage",147,0,0,3,150
1189297,885705,2019-06-18,Senate,"Senate Floor Vote - Final Passage",62,0,0,0,62
1189297,886281,2019-06-18,Senate,"Senate Rules Committee Vote",19,0,0,0,19
1189344,874727,2019-05-29,Assembly,"Assembly Environmental Conservation Committee: Favorable refer to committee Ways and Means",21,8,0,1,30
1189344,879342,2019-06-06,Assembly,"Assembly Ways And Means Committee: Favorable refer to committee Rules",21,10,0,4,35
1189344,880259,2019-06-11,Assembly,"Assembly Rules Committee: Favorable",25,0,0,6,31
1189362,864512,2019-05-14,Assembly,"Assembly Health Committee: Favorable",24,0,0,2,26
1189367,972126,2020-07-17,Assembly,"Assembly Codes Committee: Held for Consideration",15,6,0,1,22
1189393,868882,2019-05-21,Assembly,"Assembly Real Property Taxation Committee: Favorable refer to committee Ways and Means",10,0,0,0,10
1189393,880646,2019-06-11,Assembly,"Assembly Ways And Means Committee: Favorable refer to committee Rules",33,0,0,2,35
1189393,881362,2019-06-13,Assembly,"Assembly Rules Committee: Favorable",26,0,0,5,31
1189395,825322,2019-03-19,Assembly,"Assembly Judiciary Committee: Favorable",20,0,0,1,21
1189395,831662,2019-03-28,Assembly,"Assembly Floor Vote - Final Passage",139,4,0,7,150
1189395,879028,2019-06-06,Senate,"Senate Floor Vote - Final Passage",59,2,0,1,62
1189412,811969,2019-02-28,Senate,"Senate Ethics and Internal Governance Committee Vote",7,0,0,0,7
1189412,911358,2020-01-29,Senate,"Senate Ethics and Internal Governance Committee Vote",7,0,0,0,7
1189435,882869,2019-06-17,Assembly,"Assembly Ways And Means Committee: Favorable refer to committee Rules",33,0,0,2,35
1189435,882870,2019-06-17,Assembly,"Assembly Local Governments Committee: Favorable refer to committee Ways and Means",18,0,0,1,19
1189435,883625,2019-06-18,Assembly,"Assembly Rules Committee: Favorable",25,0,0,6,31
1189445,883006,2019-06-17,Senate,"Senate Floor Vote - Final Passage",62,0,0,0,62
1189445,883007,2019-06-17,Senate,"Senate Rules Committee Vote",19,0,0,0,19
1189462,878744,2019-06-06,Assembly,"Assembly Environmental Conservation Committee: Favorable refer to committee Rules",27,1,0,2,30
1189462,881354,2019-06-13,Assembly,"Assembly Rules Committee: Favorable",26,0,0,5,31
1189464,963466,2020-06-08,Senate,"Senate Floor Vote - Final Passage",59,3,0,0,62
1189464,963852,2020-06-08,Assembly,"Assembly Floor Vote - Final Passage",128,16,0,3,147
1189464,966226,2020-05-28,Senate,"Senate Rules Committee Vote",18,1,0,0,19
1189474,870549,2019-05-21,Assembly,"Assembly Education Committee: Favorable refer to committee Ways and Means",31,0,0,0,31
1189474,874750,2019-05-30,Assembly,"Assembly Ways And Means Committee: Favorable",31,0,0,4,35
1189474,877844,2019-06-04,Assembly,"Assembly Floor Vote - Final Passage",147,0,0,3,150
1189474,879133,2019-06-06,Senate,"Senate Floor Vote - Final Passage",61,0,0,1,62
1189490,971139,2020-07-14,Assembly,"Assembly Judiciary Committee: Held for Consideration",15,6,0,0,21
1189501,971719,2020-07-17,Assembly,"Assembly Codes Committee: Held for Consideration",15,6,0,1,22
1189514,970949,2020-07-13,Assembly,"Assembly Agriculture Committee: Held for Consideration",14,5,0,2,21
1189517,809747,2019-02-27,Assembly,"Assembly Racing And Wagering Committee: Favorable refer to committee Ways and Means",11,0,0,0,11
1189517,857198,2019-04-30,Assembly,"Assembly Ways And Means Committee: Favorable",33,0,0,2,35
1189525,882200,2019-06-13,Assembly,"Assembly Codes Committee: Held for Consideration",14,6,0,2,22
1189531,825353,2019-03-19,Assembly,"Assembly Governmental Operations Committee: Favorable refer to committee Ways and Means",13,0,0,1,14
1189531,868970,2019-05-21,Assembly,"Assembly Ways And Means Committee: Favorable",32,0,0,3,35
1189543,970814,2020-07-13,Assembly,"Assembly Economic Development Committee: Held for Consideration",17,7,0,1,25
1189554,874483,2019-05-29,Senate,"Senate Energy and Telecommunications Committee Vote",6,3,0,0,9
1189575,857015,2019-04-30,Assembly,"Assembly Judiciary Committee: Favorable refer to committee Ways and Means",19,0,0,2,21
1189604,971724,2020-07-17,Assembly,"Assembly Codes Committee: Held for Consideration",15,6,0,1,22
1189606,971681,2020-07-16,Assembly,"Assembly Governmental Operations Committee: Held for Consideration",10,4,0,0,14
1189642,972014,2020-07-17,Assembly,"Assembly Codes Committee: Held for Consideration",15,6,0,1,22
1189656,870430,2019-05-21,Assembly,"Assembly Education Committee: Favorable refer to committee Ways and Means",31,0,0,0,31
1189662,877589,2019-06-04,Assembly,"Assembly Veterans' Affairs Committee: Held for Consideration",10,8,0,1,19
1189667,878935,2019-06-06,Assembly,"Assembly Environmental Conservation Committee: Favorable refer to committee Rules",28,0,0,2,30
1189667,880244,2019-06-11,Assembly,"Assembly Rules Committee: Favorable",25,0,0,6,31
1189667,881732,2019-06-13,Assembly,"Assembly Floor Vote - Final Passage",144,1,0,5,150
1189669,882208,2019-03-26,Senate,"Senate Energy And Telecommunications Committee Vote",7,2,0,0,9
1189669,882209,2019-06-14,Senate,"Senate Floor Vote - Final Passage",62,0,0,0,62
1189669,904851,2020-01-22,Senate,"Senate Energy and Telecommunications Committee Vote",9,0,0,0,9
1189690,878042,2019-06-04,Assembly,"Assembly Real Property Taxation Committee: Favorable refer to committee Ways and Means",10,0,0,0,10
1189690,879329,2019-06-06,Assembly,"Assembly Ways And Means Committee: Favorable refer to committee Rules",30,1,0,4,35
1189690,880511,2019-06-11,Assembly,"Assembly Rules Committee: Favorable",25,0,0,6,31
1189690,881645,2019-06-13,Assembly,"Assembly Floor Vote - Final Passage",144,1,0,5,150
1189690,885394,2019-06-18,Senate,"Senate Floor Vote - Final Passage",61,1,0,0,62
1189693,879170,2019-06-05,Assembly,"Assembly Transportation Committee: Held for Consideration",19,7,0,0,26
1189715,972066,2020-07-17,Assembly,"Assembly Codes Committee: Held for Consideration",15,6,0,1,22
1189730,868525,2019-05-21,Assembly,"Assembly Higher Education Committee: Favorable",26,0,0,0,26
1189730,875722,2019-05-30,Assembly,"Assembly Floor Vote - Final Passage",141,1,0,8,150
1189730,880161,2019-06-11,Senate,"Senate Floor Vote - Final Passage",61,0,0,1,62
1189743,971675,2020-07-16,Assembly,"Assembly Real Property Taxation Committee: Held for Consideration",8,2,0,0,10
1189745,878722,2019-06-06,Assembly,"Assembly Environmental Conservation Committee: Held for Consideration",21,7,0,2,30
1189776,970787,2020-07-13,Assembly,"Assembly Health Committee: Held for Consideration",18,6,0,2,26
1189778,882323,2019-06-14,Assembly,"Assembly Ways And Means Committee: Favorable refer to committee Rules",30,0,0,5,35
1189778,971760,2020-07-17,Assembly,"Assembly Ways And Means Committee: Favorable refer to committee Rules",32,0,0,2,34
1189778,973769,2020-07-21,Assembly,"Assembly Rules Committee: Favorable",26,0,0,4,30
1189790,971934,2020-07-17,Assembly,"Assembly Ways And Means Committee: Held for Consideration",22,10,0,2,34
1189793,884435,2019-06-18,Senate,"Senate Rules Committee Vote",13,6,0,0,19
1189793,885486,2019-06-18,Senate,"Senate Floor Vote - Final Passage",41,21,0,0,62
1189793,973426,2020-07-22,Senate,"Senate Rules Committee Vote",12,7,0,0,19
1189793,973710,2020-07-23,Senate,"Senate Floor Vote - Final Passage",41,19,0,0,60
1189813,878745,2019-06-06,Assembly,"Assembly Environmental Conservation Committee: Held for Consideration",20,8,0,2,30
1189820,813854,2019-03-05,Assembly,"Assembly Judiciary Committee: Favorable refer to committee Ways and Means",14,5,0,2,21
1189828,878329,2019-06-04,Assembly,"Assembly Cities Committee: Favorable refer to committee Rules",15,0,0,0,15
1189828,881371,2019-06-13,Assembly,"Assembly Rules Committee: Favorable",26,0,0,5,31
1189831,861605,2019-05-07,Assembly,"Assembly Transportation Committee: Favorable refer to committee Ways and Means",21,2,0,2,25
1189831,863524,2019-05-14,Assembly,"Assembly Ways And Means Committee: Favorable",32,0,0,3,35
1189831,868938,2019-05-21,Assembly,"Assembly Floor Vote - Final Passage",146,1,0,3,150
1189831,880189,2019-06-11,Senate,"Senate Floor Vote - Final Passage",61,0,0,1,62
1189836,874652,2019-05-29,Assembly,"Assembly Housing Committee: Favorable",27,0,0,1,28
1189836,877879,2019-06-04,Assembly,"Assembly Floor Vote - Final Passage",147,0,0,3,150
1189836,881998,2019-06-12,Senate,"Senate Floor Vote - Final Passage",62,0,0,0,62
1189843,882854,2019-06-17,Assembly,"Assembly Ways And Means Committee: Favorable refer to committee Rules",33,0,0,2,35
1189843,882855,2019-06-17,Assembly,"Assembly Real Property Taxation Committee: Favorable refer to committee Ways and Means",10,0,0,0,10
1189843,884978,2019-06-19,Assembly,"Assembly Rules Committee: Favorable",27,0,0,4,31
1189843,886470,2019-06-20,Assembly,"Assembly Floor Vote - Final Passage",146,0,0,4,150
1189843,886797,2019-06-20,Senate,"Senate Floor Vote - Final Passage",62,0,0,0,62
1189849,870409,2019-05-21,Assembly,"Assembly Education Committee: Favorable refer to committee Ways and Means",31,0,0,0,31
1189849,877842,2019-06-04,Assembly,"Assembly Ways And Means Committee: Favorable refer to committee Rules",33,0,0,2,35
1189849,877986,2019-06-05,Assembly,"Assembly Rules Committee: Favorable",27,0,0,4,31
1189854,811340,2019-02-28,Assembly,"Assembly Health Committee: Favorable refer to committee Ways and Means",25,0,0,1,26
1189854,864077,2019-05-14,Assembly,"Assembly Ways And Means Committee: Favorable",32,0,0,3,35
1189854,869265,2019-05-21,Assembly,"Assembly Floor Vote - Final Passage",146,1,0,3,150
1189868,884388,2019-06-18,Senate,"Senate Rules Committee Vote",13,6,0,0,19
1189868,885446,2019-06-18,Senate,"Senate Floor Vote - Final Passage",41,21,0,0,62
1189870,854288,2019-04-08,Senate,"Senate Racing, Gaming and Wagering Committee Vote",7,0,0,0,7
1189870,854289,2019-04-29,Senate,"Senate Floor Vote - Final Passage",58,3,0,1,62
1189870,918466,2020-02-10,Senate,"Senate Racing, Gaming and Wagering Committee Vote",6,0,0,1,7
1189870,972467,2020-07-21,Senate,"Senate Floor Vote - Final Passage",58,2,0,0,60
1189895,971640,2020-07-16,Assembly,"Assembly Governmental Operations Committee: Held for Consideration",10,4,0,0,14
1189898,970801,2020-07-13,Assembly,"Assembly Health Committee: Held for Consideration",18,6,0,2,26
1189909,877962,2019-06-04,Assembly,"Assembly Codes Committee: Favorable refer to committee Rules",22,0,0,0,22
1189909,877963,2019-06-05,Assembly,"Assembly Rules Committee: Favorable",21,6,0,4,31
1189921,970785,2020-07-13,Assembly,"Assembly Health Committee: Held for Consideration",18,6,0,2,26
1189949,840889,2019-04-09,Assembly,"Assembly Transportation Committee: Held for Consideration",16,7,0,2,25
1189969,856112,2019-04-09,Senate,"Senate Veterans, Homeland Security and Military Affairs Committee Vote",9,0,0,0,9
1189969,856113,2019-05-01,Senate,"Senate Floor Vote - Final Passage",62,0,0,0,62
1189969,864999,2019-05-15,Assembly,"Assembly Floor Vote - Final Passage",141,0,0,9,150
1189971,811201,2019-02-12,Senate,"Senate Aging Committee Vote",6,0,0,1,7
1189971,811202,2019-02-28,Senate,"Senate Floor Vote - Final Passage",62,0,0,1,63
1189971,867868,2019-05-20,Assembly,"Assembly Floor Vote - Final Passage",143,0,0,7,150
1189976,970771,2020-07-13,Assembly,"Assembly Economic Development Committee: Held for Consideration",17,7,0,1,25
1189994,971193,2020-07-14,Assembly,"Assembly Correction Committee: Held for Consideration",10,2,0,1,13
1190028,971082,2020-07-14,Assembly,"Assembly Higher Education Committee: Held for Consideration",18,7,0,0,25
1190033,880708,2019-06-12,Assembly,"Assembly Local Governments Committee: Favorable refer to committee Ways and Means",17,0,0,2,19
1190033,881581,2019-06-13,Assembly,"Assembly Ways And Means Committee: Favorable refer to committee Rules",26,3,0,6,35
1190033,882479,2019-06-17,Assembly,"Assembly Rules Committee: Favorable",26,0,0,5,31
1190033,884505,2019-06-18,Assembly,"Assembly Floor Vote - Final Passage",122,24,0,4,150
1190033,886703,2019-06-19,Senate,"Senate Floor Vote - Final Passage",44,18,0,0,62
1190037,878357,2019-06-05,Assembly,"Assembly Alcoholism And Drug Abuse Committee: Favorable refer to committee Rules",14,0,0,0,14
1190037,880519,2019-06-11,Assembly,"Assembly Rules Committee: Favorable",25,0,0,6,31
1190037,881738,2019-06-13,Assembly,"Assembly Floor Vote - Final Passage",145,0,0,5,150
1190043,878685,2019-06-06,Assembly,"Assembly Corporations, Authorities And Commissions Committee: Favorable refer to committee Rules",25,0,0,1,26
1190043,881352,2019-06-13,Assembly,"Assembly Rules Committee: Favorable",26,0,0,5,31
1190048,971577,2020-07-16,Assembly,"Assembly Real Property Taxation Committee: Held for Consideration",8,2,0,0,10
1190057,971158,2020-07-14,Assembly,"Assembly Judiciary Committee: Held for Consideration",15,6,0,0,21
1190071,919835,2019-03-26,Senate,"Senate Housing, Construction and Community Development Committee Vote",9,2,0,0,11
1190071,919836,2020-02-11,Senate,"Senate Housing, Construction and Community Development Committee Vote",8,3,0,0,11
1190071,919837,2020-02-11,Senate,"Senate Rules Committee Vote",15,4,0,0,19
1190071,921505,2020-02-12,Senate,"Senate Floor Vote - Final Passage",44,16,0,2,62
1190093,859850,2019-05-07,Assembly,"Assembly Transportation Committee: Held for Consideration",16,7,0,2,25
1190105,971475,2020-07-15,Assembly,"Assembly Labor Committee: Held for Consideration",18,7,0,3,28
1190115,870418,2019-05-21,Assembly,"Assembly Education Committee: Favorable refer to committee Ways and Means",31,0,0,0,31
1190115,874767,2019-05-30,Assembly,"Assembly Ways And Means Committee: Favorable",31,0,0,4,35
1190119,882913,2019-06-17,Assembly,"Assembly Judiciary Committee: Favorable refer to committee Codes",18,0,0,3,21
1190119,883794,2019-06-18,Assembly,"Assembly Codes Committee: Favorable refer to committee Rules",22,0,0,0,22
1190119,884841,2019-06-19,Assembly,"Assembly Rules Committee: Favorable",27,0,0,4,31
1190123,950553,2020-03-10,Assembly,"Assembly Transportation Committee: Held for Consideration",18,7,0,0,25
1190131,971305,2020-07-15,Assembly,"Assembly Small Business Committee: Favorable refer to committee Rules",13,0,0,3,16
1190131,972156,2020-07-20,Assembly,"Assembly Rules Committee: Favorable",27,0,0,3,30
1190160,868706,2019-05-21,Assembly,"Assembly Tourism, Arts And Sports Development Committee: Favorable refer to committee Codes",20,0,0,0,20
1190160,875152,2019-05-30,Assembly,"Assembly Codes Committee: Favorable",19,0,0,3,22
1190182,855615,2019-04-30,Senate,"Senate Education Committee Vote",15,0,0,0,15
1190182,868636,2019-05-21,Senate,"Senate Finance Committee Vote",23,0,0,0,23
1190182,877341,2019-06-04,Senate,"Senate Floor Vote - Final Passage",62,0,0,0,62
1190182,906934,2020-01-28,Senate,"Senate Education Committee Vote",15,0,0,0,15
1190191,972112,2020-07-17,Assembly,"Assembly Ways And Means Committee: Held for Consideration",22,10,0,2,34
1190215,877921,2019-06-05,Assembly,"Assembly Health Committee: Favorable refer to committee Rules",25,0,0,1,26
1190215,880246,2019-06-11,Assembly,"Assembly Rules Committee: Favorable",25,0,0,6,31
1190224,950518,2020-03-10,Assembly,"Assembly Governmental Operations Committee: Held for Consideration",10,4,0,0,14
1190230,874628,2019-05-29,Assembly,"Assembly Environmental Conservation Committee: Favorable refer to committee Ways and Means",29,0,0,1,30
1190230,880656,2019-06-11,Assembly,"Assembly Ways And Means Committee: Favorable refer to committee Rules",33,0,0,2,35
1190230,881341,2019-06-13,Assembly,"Assembly Rules Committee: Favorable",26,0,0,5,31
1190253,972098,2020-07-17,Assembly,"Assembly Ways And Means Committee: Held for Consideration",22,10,0,2,34
1190278,971721,2020-07-17,Assembly,"Assembly Codes Committee: Held for Consideration",15,6,0,1,22
1190285,971627,2020-07-16,Assembly,"Assembly Governmental Operations Committee: Held for Consideration",10,4,0,0,14
1190290,971594,2020-07-16,Assembly,"Assembly Governmental Operations Committee: Held for Consideration",10,4,0,0,14
1190293,877741,2019-06-04,Assembly,"Assembly Ways And Means Committee: Favorable refer to committee Rules",33,0,0,2,35
1190293,877883,2019-06-05,Assembly,"Assembly Rules Committee: Favorable",27,0,0,4,31
1190293,880767,2019-06-11,Assembly,"Assembly Floor Vote - Final Passage",140,2,0,8,150
1190303,861602,2019-05-07,Assembly,"Assembly Transportation Committee: Held for Consideration",16,7,0,2,25
1190316,813884,2019-03-05,Assembly,"Assembly Judiciary Committee: Favorable refer to committee Codes",14,5,0,2,21
1190316,819246,2019-03-12,Assembly,"Assembly Codes Committee: Favorable",20,1,0,1,22
1190331,811368,2019-02-28,Assembly,"Assembly Health Committee: Favorable refer to committee Ways and Means",18,7,0,1,26
1190338,971780,2020-07-16,Assembly,"Assembly Local Governments Committee: Held for Consideration",14,5,0,1,20
1190348,971110,2020-07-14,Assembly,"Assembly Environmental Conservation Committee: Held for Consideration",19,8,0,1,28
1190359,971779,2020-07-16,Assembly,"Assembly Governmental Employees Committee: Held for Consideration",10,4,0,0,14
1190366,878490,2019-06-05,Assembly,"Assembly Education Committee: Favorable refer to committee Ways and Means",29,0,0,2,31
1190366,880344,2019-06-11,Assembly,"Assembly Ways And Means Committee: Favorable refer to committee Rules",31,2,0,2,35
1190375,880036,2019-06-11,Senate,"Senate Rules Committee Vote",19,0,0,0,19
1190375,880543,2019-06-11,Senate,"Senate Floor Vote - Final Passage",61,0,0,1,62
1190380,837730,2019-04-08,Assembly,"Assembly Judiciary Committee: Favorable",20,0,0,1,21
1190380,857490,2019-04-29,Assembly,"Assembly Floor Vote - Final Passage",144,0,0,6,150
1190380,882318,2019-06-14,Senate,"Senate Floor Vote - Final Passage",62,0,0,0,62
1190382,860703,2019-05-07,Assembly,"Assembly Environmental Conservation Committee: Favorable refer to committee Ways and Means",28,0,0,2,30
1190382,869043,2019-05-21,Assembly,"Assembly Ways And Means Committee: Favorable",32,0,0,3,35
1190382,875625,2019-05-30,Assembly,"Assembly Floor Vote - Final Passage",142,0,0,8,150
1190382,885508,2019-06-18,Senate,"Senate Floor Vote - Final Passage",62,0,0,0,62
1190387,971980,2020-07-17,Assembly,"Assembly Codes Committee: Held for Consideration",15,6,0,1,22
1190389,884254,2019-02-12,Senate,"Senate Labor Committee Vote",13,0,0,0,13
1190389,886491,2019-06-19,Senate,"Senate Floor Vote - Final Passage",62,0,0,0,62
1190389,915829,2020-02-04,Senate,"Senate Labor Committee Vote",13,0,0,0,13
1190395,970802,2020-07-13,Assembly,"Assembly Mental Health Committee: Held for Consideration",10,3,0,0,13
1190414,874736,2019-05-30,Assembly,"Assembly Judiciary Committee: Favorable",14,6,0,1,21
1190414,972334,2020-07-20,Assembly,"Assembly Floor Vote - Final Passage",138,3,0,4,145
1190419,811369,2019-02-28,Assembly,"Assembly Health Committee: Favorable refer to committee Ways and Means",21,4,0,1,26
1190437,840721,2019-04-09,Assembly,"Assembly Transportation Committee: Held for Consideration",16,7,0,2,25
1190447,809765,2019-02-27,Assembly,"Assembly Small Business Committee: Favorable refer to committee Ways and Means",17,0,0,0,17
1190447,875604,2019-05-30,Assembly,"Assembly Ways And Means Committee: Favorable",24,7,0,4,35
1190447,877798,2019-06-04,Assembly,"Assembly Floor Vote - Final Passage",135,12,0,3,150
1190478,876065,2019-05-30,Assembly,"Assembly Governmental Operations Committee: Favorable",12,0,0,2,14
1190482,971190,2020-07-14,Assembly,"Assembly Judiciary Committee: Held for Consideration",15,6,0,0,21
1190508,864717,2019-05-14,Assembly,"Assembly Local Governments Committee: Favorable refer to committee Ways and Means",17,1,0,1,19
1190508,868776,2019-05-21,Assembly,"Assembly Ways And Means Committee: Favorable",28,4,0,3,35
1190530,860682,2019-03-19,Senate,"Senate Judiciary Committee Vote",15,0,0,0,15
1190530,860683,2019-05-07,Senate,"Senate Floor Vote - Final Passage",61,0,0,1,62
1190530,875162,2019-05-30,Senate,"Senate Floor Vote - Final Passage",58,0,0,4,62
1190530,877785,2019-06-04,Assembly,"Assembly Floor Vote - Final Passage",147,0,0,3,150
1190631,864756,2019-03-11,Senate,"Senate Women's Issues Committee Vote",6,0,0,0,6
1190631,864757,2019-05-15,Senate,"Senate Floor Vote - Final Passage",58,0,0,4,62
1190631,883795,2019-06-18,Senate,"Senate Floor Vote - Final Passage",62,0,0,0,62
1190647,823302,2019-03-12,Senate,"Senate Health Committee Vote",15,0,0,0,15
1190647,823303,2019-03-18,Senate,"Senate Floor Vote - Final Passage",62,0,0,0,62
1190647,904561,2020-01-22,Senate,"Senate Health Committee Vote",15,0,0,0,15
1190693,854150,2019-03-12,Senate,"Senate Corporations, Authorities and Commissions Committee Vote",7,0,0,0,7
1190693,854151,2019-04-29,Senate,"Senate Floor Vote - Final Passage",46,15,0,1,62
1190693,921762,2020-02-12,Senate,"Senate Corporations, Authorities and Commissions Committee Vote",6,0,0,1,7
1190693,972412,2020-07-21,Senate,"Senate Floor Vote - Final Passage",46,14,0,0,60
1190725,799943,2019-02-12,Assembly,"Assembly Aging Committee: Favorable refer to committee Ways and Means",25,0,0,5,30
1190725,864847,2019-05-14,Assembly,"Assembly Ways And Means Committee: Favorable",32,0,0,3,35
1190725,868277,2019-05-21,Senate,"Senate Floor Vote - Final Passage",61,0,0,1,62
1190725,869401,2019-05-21,Assembly,"Assembly Floor Vote - Final Passage",146,1,0,3,150
1190788,859754,2019-05-06,Assembly,"Assembly Insurance Committee: Favorable",22,0,0,2,24
1190855,971823,2020-07-16,Assembly,"Assembly Local Governments Committee: Held for Consideration",14,5,0,1,20
1191595,823701,2019-03-11,Senate,"Senate Women's Issues Committee Vote",6,0,0,0,6
1191595,823702,2019-03-18,Senate,"Senate Floor Vote - Final Passage",62,0,0,0,62
1191595,868590,2019-05-20,Assembly,"Assembly Floor Vote - Final Passage",143,0,0,7,150
1191655,828982,2019-03-26,Senate,"Senate Committee Vote",7,0,0,0,7
1191790,882950,2019-06-17,Senate,"Senate Floor Vote - Final Passage",62,0,0,0,62
1191790,882951,2019-06-17,Senate,"Senate Rules Committee Vote",19,0,0,0,19
1191790,885316,2019-06-19,Assembly,"Assembly Floor Vote - Final Passage",148,0,0,2,150
1191970,856406,2019-04-08,Senate,"Senate Housing, Construction and Community Development Committee Vote",7,4,0,0,11
1191970,856407,2019-05-01,Senate,"Senate Floor Vote - Final Passage",41,21,0,0,62
1192149,855635,2019-04-30,Senate,"Senate Committee Vote",7,0,0,0,7
1192149,884582,2019-06-18,Senate,"Senate Rules Committee Vote",19,0,0,0,19
1192149,885068,2019-06-18,Senate,"Senate Floor Vote - Final Passage",62,0,0,0,62
1192174,819971,2019-03-12,Senate,"Senate Internet and Technology Committee Vote",7,0,0,0,7
1192231,824534,2019-03-19,Senate,"Senate Civil Service and Pensions Committee Vote",6,1,0,0,7
1192231,881964,2019-06-12,Senate,"Senate Rules Committee Vote",19,0,0,0,19
1192256,875732,2019-05-30,Senate,"Senate Environmental Conservation Committee Vote",8,2,0,1,11
1192256,876795,2019-06-03,Senate,"Senate Floor Vote - Final Passage",45,17,0,0,62
1192256,877079,2019-06-03,Senate,"Senate Rules Committee Vote",15,4,0,0,19
1192256,941730,2020-03-03,Senate,"Senate Environmental Conservation Committee Vote",10,1,0,0,11
1192256,972749,2020-07-21,Senate,"Senate Finance Committee Vote",17,6,0,0,23
1192256,973798,2020-07-21,Senate,"Senate Finance Committee Vote",17,6,0,0,23
1192256,973799,2020-07-22,Senate,"Senate Floor Vote - Final Passage",46,14,0,0,60
1192299,828943,2019-03-26,Senate,"Senate Investigations and Government Operations Committee Vote",7,0,0,0,7
1192299,863977,2019-05-14,Senate,"Senate Finance Committee Vote",21,1,0,1,23
1192299,882248,2019-06-14,Senate,"Senate Floor Vote - Final Passage",53,9,0,0,62
1192312,857469,2019-04-30,Assembly,"Assembly Social Services Committee: Favorable refer to committee Ways and Means",18,0,0,0,18
1192312,863850,2019-05-14,Assembly,"Assembly Ways And Means Committee: Favorable",22,10,0,3,35
1192325,856467,2019-04-09,Senate,"Senate Domestic Animal Welfare Committee Vote",7,0,0,0,7
1192340,878145,2019-06-05,Assembly,"Assembly Education Committee: Favorable refer to committee Rules",27,2,0,2,31
1192340,880527,2019-06-11,Assembly,"Assembly Rules Committee: Favorable",25,0,0,6,31
1192340,881739,2019-06-13,Assembly,"Assembly Floor Vote - Final Passage",122,23,0,5,150
1192356,882317,2019-06-13,Assembly,"Assembly Codes Committee: Held for Consideration",14,6,0,2,22
1192439,870189,2019-05-21,Assembly,"Assembly Transportation Committee: Held for Consideration",18,7,0,0,25
1192458,881955,2019-06-12,Senate,"Senate Floor Vote - Final Passage",57,5,0,0,62
1192458,881956,2019-06-12,Senate,"Senate Rules Committee Vote",18,1,0,0,19
1192495,882230,2019-06-13,Assembly,"Assembly Codes Committee: Held for Consideration",14,6,0,2,22
1192510,840778,2019-04-09,Assembly,"Assembly Transportation Committee: Held for Consideration",16,7,0,2,25
1192519,813544,2019-03-05,Assembly,"Assembly Education Committee: Favorable refer to committee Ways and Means",24,0,0,7,31
1192519,857225,2019-04-30,Assembly,"Assembly Ways And Means Committee: Favorable",33,0,0,2,35
1192537,936247,2020-02-26,Assembly,"Assembly Children And Families Committee: Held for Consideration",10,5,0,1,16
1192560,972001,2020-07-17,Assembly,"Assembly Codes Committee: Held for Consideration",15,6,0,1,22
1192604,820767,2019-03-12,Assembly,"Assembly Environmental Conservation Committee: Favorable",24,5,0,1,30
1192604,829560,2019-03-26,Assembly,"Assembly Floor Vote - Final Passage",112,36,0,2,150
1192604,830114,2019-03-27,Senate,"Senate Floor Vote - Final Passage",58,3,0,1,62
1192660,859306,2019-04-08,Senate,"Senate Local Government Committee Vote",7,0,0,0,7
1192660,859307,2019-05-06,Senate,"Senate Floor Vote - Final Passage",61,0,0,1,62
1192660,882268,2019-06-13,Assembly,"Assembly Floor Vote - Final Passage",145,1,0,4,150
1192705,971378,2020-07-14,Assembly,"Assembly Election Law Committee: Held for Consideration",12,4,0,0,16
1192751,971918,2020-07-17,Assembly,"Assembly Codes Committee: Held for Consideration",15,6,0,1,22
1192824,861598,2019-05-07,Assembly,"Assembly Transportation Committee: Held for Consideration",21,2,0,2,25
1192831,972007,2020-07-17,Assembly,"Assembly Codes Committee: Held for Consideration",15,6,0,1,22
1192856,971997,2020-07-17,Assembly,"Assembly Ways And Means Committee: Held for Consideration",22,10,0,2,34
1192870,875597,2019-05-30,Assembly,"Assembly Ways And Means Committee: Favorable",25,6,0,4,35
1192890,880218,2019-05-22,Senate,"Senate Domestic Animal Welfare Committee Vote",7,0,0,0,7
1192890,880219,2019-06-11,Senate,"Senate Floor Vote - Final Passage",60,1,0,1,62
1192890,903133,2020-01-15,Senate,"Senate Domestic Animal Welfare Committee Vote",7,0,0,0,7
1192890,910639,2020-01-29,Senate,"Senate Floor Vote - Final Passage",56,2,0,4,62
1192904,861470,2019-05-07,Senate,"Senate Committee Vote",5,2,0,0,7
1192904,868254,2019-05-21,Senate,"Senate Finance Committee Vote",16,7,0,0,23
1192914,970799,2020-07-13,Assembly,"Assembly Health Committee: Held for Consideration",18,6,0,2,26
1192923,875616,2019-05-30,Assembly,"Assembly Ways And Means Committee: Favorable",24,7,0,4,35
1192985,971300,2020-07-14,Assembly,"Assembly Higher Education Committee: Held for Consideration",18,7,0,0,25
1193042,876837,2019-05-14,Senate,"Senate Health Committee Vote",15,0,0,0,15
1193042,876838,2019-06-03,Senate,"Senate Floor Vote - Final Passage",56,6,0,0,62
1193042,886233,2019-06-20,Assembly,"Assembly Floor Vote - Final Passage",140,6,0,4,150
1193059,971804,2020-07-16,Assembly,"Assembly Local Governments Committee: Held for Consideration",14,5,0,1,20
1193104,797523,2019-02-12,Assembly,"Assembly Transportation Committee: Favorable refer to committee Codes",23,0,0,2,25
1193104,823338,2019-03-18,Assembly,"Assembly Rules Committee: Favorable",24,0,0,7,31
1193104,823339,2019-03-18,Assembly,"Assembly Codes Committee: Favorable refer to committee Ways and Means",20,1,0,1,22
1193104,823340,2019-03-18,Assembly,"Assembly Ways And Means Committee: Favorable refer to committee Rules",30,1,0,4,35
1193104,825515,2019-03-19,Assembly,"Assembly Floor Vote - Final Passage",146,0,0,4,150
1193104,864606,2019-05-15,Senate,"Senate Floor Vote - Final Passage",58,0,0,4,62
1193135,863794,2019-05-14,Senate,"Senate Health Committee Vote",15,0,0,0,15
1193135,868063,2019-05-21,Senate,"Senate Finance Committee Vote",23,0,0,0,23
1193135,869166,2019-05-21,Senate,"Senate Finance Committee Vote",23,0,0,0,23
1193135,882939,2019-06-17,Senate,"Senate Floor Vote - Final Passage",61,1,0,0,62
1193135,884023,2019-06-18,Assembly,"Assembly Floor Vote - Final Passage",133,15,0,2,150
1193145,857436,2019-04-30,Assembly,"Assembly Consumer Affairs And Protection Committee: Favorable refer to committee Codes",16,0,0,0,16
1193145,860499,2019-05-07,Assembly,"Assembly Codes Committee: Favorable",20,0,0,2,22
1193145,864928,2019-05-15,Assembly,"Assembly Floor Vote - Final Passage",139,2,0,9,150
1193177,922048,2020-02-11,Assembly,"Assembly Social Services Committee: Held for Consideration",12,5,0,0,17
1193209,877370,2019-05-22,Senate,"Senate Domestic Animal Welfare Committee Vote",7,0,0,0,7
1193209,877371,2019-06-04,Senate,"Senate Floor Vote - Final Passage",60,2,0,0,62
1193209,950221,2020-03-11,Senate,"Senate Domestic Animal Welfare Committee Vote",7,0,0,0,7
1193209,972794,2020-07-21,Senate,"Senate Floor Vote - Final Passage",59,1,0,0,60
1193232,971583,2020-07-16,Assembly,"Assembly Real Property Taxation Committee: Held for Consideration",8,2,0,0,10
1193250,972032,2020-07-17,Assembly,"Assembly Codes Committee: Held for Consideration",15,6,0,1,22
1193307,855607,2019-04-30,Senate,"Senate Children and Families Committee Vote",7,0,0,0,7
1193307,875438,2019-05-30,Senate,"Senate Floor Vote - Final Passage",58,0,0,4,62
1193307,875439,2019-05-30,Senate,"Senate Rules Committee Vote",18,0,0,1,19
1193307,880444,2019-06-11,Senate,"Senate Floor Vote - Final Passage",61,0,0,1,62
1193307,883156,2019-06-17,Assembly,"Assembly Floor Vote - Final Passage",104,44,0,2,150
1193324,877588,2019-06-04,Assembly,"Assembly Veterans' Affairs Committee: Held for Consideration",10,8,0,1,19
1193331,829728,2019-03-26,Senate,"Senate Energy and Telecommunications Committee Vote",9,0,0,0,9
1193331,914107,2020-02-03,Senate,"Senate Energy and Telecommunications Committee Vote",9,0,0,0,9
1193341,880354,2019-05-20,Senate,"Senate Local Government Committee Vote",7,0,0,0,7
1193341,880355,2019-06-11,Senate,"Senate Floor Vote - Final Passage",61,0,0,1,62
1193341,883987,2019-06-18,Assembly,"Assembly Floor Vote - Final Passage",102,43,0,5,150
1193366,825348,2019-03-19,Assembly,"Assembly Governmental Employees Committee: Favorable refer to committee Ways and Means",14,0,0,0,14
1193405,949111,2020-03-11,Assembly,"Assembly Insurance Committee: Favorable refer to committee Codes",17,3,0,2,22
1193405,972008,2020-07-17,Assembly,"Assembly Codes Committee: Favorable refer to committee Rules",21,0,0,1,22
1193405,972206,2020-07-20,Assembly,"Assembly Rules Committee: Favorable",20,7,0,3,30
1193405,972726,2020-07-21,Assembly,"Assembly Floor Vote - Final Passage",142,0,0,3,145
1193446,814879,2019-03-06,Assembly,"Assembly Health Committee: Favorable",25,0,0,1,26
1193446,822628,2019-03-14,Assembly,"Assembly Floor Vote - Final Passage",134,0,0,16,150
1193446,860852,2019-05-06,Senate,"Senate Floor Vote - Final Passage",61,0,0,1,62
1193453,971271,2020-07-14,Assembly,"Assembly Education Committee: Held for Consideration",23,6,0,2,31
1193537,819457,2019-03-12,Assembly,"Assembly Environmental Conservation Committee: Favorable refer to committee Codes",28,1,0,1,30
1193537,874733,2019-05-30,Assembly,"Assembly Codes Committee: Favorable refer to committee Ways and Means",12,7,0,3,22
1193571,882201,2019-06-14,Assembly,"Assembly Governmental Employees Committee: Favorable refer to committee Ways and Means",13,0,0,1,14
1193571,882637,2019-06-17,Assembly,"Assembly Rules Committee: Favorable",25,0,0,6,31
1193571,882638,2019-06-17,Assembly,"Assembly Ways And Means Committee: Favorable refer to committee Rules",32,1,0,2,35
1193640,878487,2019-06-04,Assembly,"Assembly Economic Development Committee: Favorable refer to committee Ways and Means",18,6,0,2,26
1193640,883262,2019-06-17,Assembly,"Assembly Ways And Means Committee: Favorable refer to committee Rules",33,0,0,2,35
1193640,884858,2019-06-19,Assembly,"Assembly Rules Committee: Favorable",27,0,0,4,31
1193858,840817,2019-04-09,Assembly,"Assembly Transportation Committee: Held for Consideration",16,7,0,2,25
1193994,814506,2019-03-05,Assembly,"Assembly Energy Committee: Favorable",16,0,0,1,17
1193994,822719,2019-03-14,Assembly,"Assembly Floor Vote - Final Passage",134,0,0,16,150
1193994,825360,2019-03-20,Senate,"Senate Floor Vote - Final Passage",62,0,0,0,62
1194319,884748,2019-05-06,Senate,"Senate Local Government Committee Vote",5,2,0,0,7
1194319,886437,2019-06-19,Senate,"Senate Floor Vote - Final Passage",45,17,0,0,62
1194319,906164,2020-01-27,Senate,"Senate Local Government Committee Vote",5,2,0,0,7
1194319,919808,2020-02-11,Senate,"Senate Floor Vote - Final Passage",44,18,0,0,62
1194334,885872,2019-05-30,Senate,"Senate Higher Education Committee Vote",10,0,0,1,11
1194334,886785,2019-06-20,Senate,"Senate Floor Vote - Final Passage",62,0,0,0,62
1194351,825123,2019-03-12,Senate,"Senate Finance Committee Vote",22,0,0,0,22
1194351,825124,2019-03-19,Senate,"Senate Floor Vote - Final Passage",61,0,0,1,62
1194351,882078,2019-06-14,Senate,"Senate Floor Vote - Final Passage",62,0,0,0,62
1194351,884320,2019-06-18,Assembly,"Assembly Floor Vote - Final Passage",146,0,0,4,150
1194445,863018,2019-05-13,Senate,"Senate Transportation Committee Vote",14,0,0,1,15
1194445,863538,2019-05-14,Senate,"Senate Rules Committee Vote",18,0,0,1,19
1194445,864277,2019-05-15,Senate,"Senate Floor Vote - Final Passage",57,1,0,4,62
1194445,935078,2020-02-25,Senate,"Senate Transportation Committee Vote",15,0,0,0,15
1194445,941018,2020-03-03,Senate,"Senate Floor Vote - Final Passage",61,1,0,0,62
1194463,875796,2019-05-30,Senate,"Senate Higher Education Committee Vote",10,0,0,1,11
1194608,881726,2019-06-12,Senate,"Senate Floor Vote - Final Passage",62,0,0,0,62
1194608,881727,2019-06-12,Senate,"Senate Rules Committee Vote",19,0,0,0,19
1194608,919933,2020-02-10,Senate,"Senate Elections Committee Vote",7,0,0,0,7
1194608,972516,2020-07-21,Senate,"Senate Floor Vote - Final Passage",59,1,0,0,60
1194720,885117,2019-06-19,Assembly,"Assembly Floor Vote - Final Passage",147,1,0,2,150
1194720,885917,2019-06-19,Senate,"Senate Rules Committee Vote",18,1,0,0,19
1194720,886414,2019-06-19,Senate,"Senate Floor Vote - Final Passage",62,0,0,0,62
1194874,878308,2019-05-20,Senate,"Senate Local Government Committee Vote",7,0,0,0,7
1194874,878309,2019-06-05,Senate,"Senate Floor Vote - Final Passage",62,0,0,0,62
1194874,885057,2019-06-19,Assembly,"Assembly Floor Vote - Final Passage",148,0,0,2,150
1194928,839404,2019-04-08,Senate,"Senate Corporations, Authorities and Commissions Committee Vote",7,0,0,0,7
1194928,860882,2019-05-07,Senate,"Senate Finance Committee Vote",23,0,0,0,23
1194928,874371,2019-05-29,Senate,"Senate Floor Vote - Final Passage",60,0,0,2,62
1194928,884061,2019-06-18,Assembly,"Assembly Floor Vote - Final Passage",146,0,0,4,150
1194930,880392,2019-05-30,Senate,"Senate Veterans, Homeland Security and Military Affairs Committee Vote",9,0,0,0,9
1194930,880393,2019-06-11,Senate,"Senate Floor Vote - Final Passage",61,0,0,1,62
1194930,921337,2020-02-11,Senate,"Senate Veterans, Homeland Security and Military Affairs Committee Vote",9,0,0,0,9
1194930,935876,2020-02-26,Senate,"Senate Floor Vote - Final Passage",60,0,0,2,62
1194936,821237,2019-03-12,Senate,"Senate Health Committee Vote",14,1,0,0,15
1194936,949129,2020-03-10,Senate,"Senate Health Committee Vote",13,1,0,1,15
1194940,839376,2019-04-08,Senate,"Senate Codes Committee Vote",11,1,0,1,13
1194940,885109,2019-06-19,Senate,"Senate Rules Committee Vote",13,6,0,0,19
1194940,886400,2019-06-19,Senate,"Senate Floor Vote - Final Passage",41,21,0,0,62
1194940,972754,2020-07-21,Senate,"Senate Finance Committee Vote",15,8,0,0,23
1194940,973804,2020-07-21,Senate,"Senate Finance Committee Vote",15,8,0,0,23
1194940,973805,2020-07-22,Senate,"Senate Floor Vote - Final Passage",41,19,0,0,60
1194990,840850,2019-04-09,Assembly,"Assembly Codes Committee: Favorable refer to committee Ways and Means",16,6,0,0,22
1194990,879267,2019-06-06,Assembly,"Assembly Ways And Means Committee: Favorable refer to committee Rules",21,10,0,4,35
1194990,880485,2019-06-11,Assembly,"Assembly Rules Committee: Favorable",25,0,0,6,31
1194990,972250,2020-07-20,Assembly,"Assembly Floor Vote - Final Passage",97,44,0,4,145
1194990,973447,2020-07-22,Senate,"Senate Floor Vote - Final Passage",41,19,0,0,60
1195106,870260,2019-05-21,Assembly,"Assembly Governmental Employees Committee: Favorable refer to committee Ways and Means",14,0,0,0,14
1195166,870171,2019-05-21,Assembly,"Assembly Transportation Committee: Held for Consideration",18,7,0,0,25
1195191,877198,2019-06-04,Assembly,"Assembly Economic Development Committee: Favorable refer to committee Codes",23,1,0,2,26
1195191,880460,2019-06-11,Assembly,"Assembly Codes Committee: Favorable refer to committee Rules",22,0,0,0,22
1195191,882455,2019-06-17,Assembly,"Assembly Rules Committee: Favorable",26,0,0,5,31
1195204,860998,2019-05-07,Senate,"Senate Social Services Committee Vote",7,0,0,0,7
1195204,863494,2019-05-14,Senate,"Senate Finance Committee Vote",22,0,0,1,23
1195204,879541,2019-06-03,Senate,"Senate Floor Vote - Final Passage",62,0,0,0,62
1195367,855650,2019-04-30,Senate,"Senate Transportation Committee Vote",15,0,0,0,15
1195367,881762,2019-06-12,Senate,"Senate Floor Vote - Final Passage",62,0,0,0,62
1195367,881763,2019-06-12,Senate,"Senate Rules Committee Vote",19,0,0,0,19
1195367,965113,2020-06-10,Senate,"Senate Floor Vote - Final Passage",61,1,0,0,62
1195367,966231,2020-06-09,Senate,"Senate Rules Committee Vote",19,0,0,0,19
1195404,882860,2019-06-17,Assembly,"Assembly Ways And Means Committee: Favorable refer to committee Rules",33,0,0,2,35
1195404,882861,2019-06-17,Assembly,"Assembly Real Property Taxation Committee: Favorable refer to committee Ways and Means",10,0,0,0,10
1195404,883550,2019-06-18,Assembly,"Assembly Rules Committee: Favorable",25,0,0,6,31
1195404,885021,2019-06-19,Assembly,"Assembly Floor Vote - Final Passage",148,0,0,2,150
1195417,972080,2020-07-17,Assembly,"Assembly Ways And Means Committee: Held for Consideration",22,10,0,2,34
1195427,972064,2020-07-17,Assembly,"Assembly Codes Committee: Held for Consideration",15,6,0,1,22
1195472,972071,2020-07-17,Assembly,"Assembly Codes Committee: Held for Consideration",15,6,0,1,22
1195534,970898,2020-07-13,Assembly,"Assembly Corporations, Authorities And Commissions Committee: Held for Consideration",19,7,0,0,26
1195610,971643,2020-07-16,Assembly,"Assembly Governmental Operations Committee: Held for Consideration",10,4,0,0,14
1195659,970797,2020-07-13,Assembly,"Assembly Health Committee: Held for Consideration",18,6,0,2,26
1195660,878697,2019-06-06,Assembly,"Assembly Environmental Conservation Committee: Held for Consideration",21,7,0,2,30
1195680,970796,2020-07-13,Assembly,"Assembly Health Committee: Held for Consideration",18,6,0,2,26
1195693,857475,2019-04-30,Assembly,"Assembly Agriculture Committee: Favorable",15,6,0,0,21
1195695,971784,2020-07-16,Assembly,"Assembly Local Governments Committee: Held for Consideration",15,4,0,1,20
1195698,972031,2020-07-17,Assembly,"Assembly Codes Committee: Held for Consideration",15,6,0,1,22
1195712,971105,2020-07-14,Assembly,"Assembly Environmental Conservation Committee: Held for Consideration",19,8,0,1,28
1195727,971174,2020-07-14,Assembly,"Assembly Correction Committee: Held for Consideration",10,2,0,1,13
1195728,971195,2020-07-14,Assembly,"Assembly Insurance Committee: Held for Consideration",14,6,0,2,22
1195753,857636,2019-04-30,Assembly,"Assembly Judiciary Committee: Favorable refer to committee Codes",13,6,0,2,21
1195753,877981,2019-06-04,Assembly,"Assembly Codes Committee: Favorable refer to committee Rules",13,9,0,0,22
1195753,877982,2019-06-05,Assembly,"Assembly Rules Committee: Favorable",27,0,0,4,31
1195760,882227,2019-06-13,Assembly,"Assembly Codes Committee: Held for Consideration",14,6,0,2,22
1195780,876045,2019-05-30,Assembly,"Assembly Governmental Operations Committee: Favorable refer to committee Codes",12,0,0,2,14
1195780,881408,2019-06-13,Assembly,"Assembly Codes Committee: Favorable refer to committee Rules",20,0,0,2,22
1195780,882534,2019-06-17,Assembly,"Assembly Rules Committee: Favorable",26,0,0,5,31
1195781,881072,2019-06-12,Assembly,"Assembly Local Governments Committee: Favorable refer to committee Codes",13,4,0,2,19
1195781,883153,2019-06-17,Assembly,"Assembly Codes Committee: Favorable refer to committee Ways and Means",14,6,0,2,22
1195790,971157,2020-07-14,Assembly,"Assembly Correction Committee: Favorable refer to committee Rules",12,0,0,1,13
1195790,972186,2020-07-20,Assembly,"Assembly Rules Committee: Favorable",27,0,0,3,30
1195795,810578,2019-02-27,Assembly,"Assembly Real Property Taxation Committee: Favorable refer to committee Ways and Means",9,0,0,1,10
1195795,878581,2019-06-05,Assembly,"Assembly Ways And Means Committee: Favorable refer to committee Rules",31,0,0,4,35
1195795,882491,2019-06-17,Assembly,"Assembly Rules Committee: Favorable",26,0,0,5,31
1195795,884396,2019-06-18,Assembly,"Assembly Floor Vote - Final Passage",146,0,0,4,150
1195795,886658,2019-06-20,Senate,"Senate Floor Vote - Final Passage",62,0,0,0,62
1195797,857498,2019-04-30,Assembly,"Assembly Codes Committee: Favorable",14,6,0,2,22
1195807,971945,2020-07-17,Assembly,"Assembly Codes Committee: Held for Consideration",15,6,0,1,22
1195814,972047,2020-07-17,Assembly,"Assembly Codes Committee: Held for Consideration",15,6,0,1,22
1195823,882196,2019-06-13,Assembly,"Assembly Codes Committee: Held for Consideration",14,6,0,2,22
1195827,840712,2019-04-09,Assembly,"Assembly Transportation Committee: Held for Consideration",16,7,0,2,25
1195836,829112,2019-03-26,Assembly,"Assembly Economic Development Committee: Favorable refer to committee Codes",14,10,0,2,26
1195836,839060,2019-04-09,Assembly,"Assembly Codes Committee: Favorable",19,3,0,0,22
1195836,877090,2019-06-03,Assembly,"Assembly Floor Vote - Final Passage",121,21,0,8,150
1195843,882000,2019-06-12,Senate,"Senate Floor Vote - Final Passage",62,0,0,0,62
1195843,882001,2019-06-12,Senate,"Senate Rules Committee Vote",19,0,0,0,19
1195844,874944,2019-05-30,Assembly,"Assembly Consumer Affairs And Protection Committee: Favorable refer to committee Codes",12,3,0,1,16
1195844,877432,2019-06-04,Assembly,"Assembly Codes Committee: Favorable refer to committee Rules",16,6,0,0,22
1195844,878045,2019-06-05,Assembly,"Assembly Rules Committee: Favorable",19,8,0,4,31
1195844,881671,2019-06-13,Assembly,"Assembly Floor Vote - Final Passage",105,35,0,10,150
1195846,971984,2020-07-17,Assembly,"Assembly Ways And Means Committee: Held for Consideration",22,10,0,2,34
1195861,971820,2020-07-16,Assembly,"Assembly Local Governments Committee: Held for Consideration",15,4,0,1,20
1195865,972023,2020-07-17,Assembly,"Assembly Codes Committee: Held for Consideration",15,6,0,1,22
1195870,972006,2020-07-17,Assembly,"Assembly Codes Committee: Held for Consideration",15,6,0,1,22
1195878,874640,2019-05-29,Assembly,"Assembly Local Governments Committee: Favorable refer to committee Ways and Means",17,0,0,2,19
1195878,882021,2019-06-14,Assembly,"Assembly Ways And Means Committee: Favorable refer to committee Rules",23,7,0,5,35
1195878,882410,2019-06-17,Assembly,"Assembly Rules Committee: Favorable",26,0,0,5,31
1195890,857532,2019-04-30,Assembly,"Assembly Housing Committee: Favorable",23,2,0,3,28
1195890,861161,2019-05-07,Assembly,"Assembly Floor Vote - Final Passage",134,0,0,16,150
1195890,886704,2019-06-19,Senate,"Senate Floor Vote - Final Passage",62,0,0,0,62
1195894,971200,2020-07-14,Assembly,"Assembly Insurance Committee: Favorable refer to committee Rules",20,0,0,2,22
1195894,973107,2020-07-22,Assembly,"Assembly Rules Committee: Favorable",29,0,0,1,30
1195894,973554,2020-07-23,Assembly,"Assembly Floor Vote - Final Passage",141,0,0,4,145
1195895,971688,2020-07-16,Assembly,"Assembly Real Property Taxation Committee: Held for Consideration",8,2,0,0,10
1195906,882306,2019-06-13,Assembly,"Assembly Codes Committee: Held for Consideration",14,6,0,2,22
1195910,882210,2019-06-13,Assembly,"Assembly Codes Committee: Held for Consideration",14,6,0,2,22
1195914,971389,2020-07-16,Assembly,"Assembly Governmental Operations Committee: Favorable refer to committee Ways and Means",14,0,0,0,14
1195920,971465,2020-07-16,Assembly,"Assembly Transportation Committee: Held for Consideration",16,6,0,2,24
1195923,971116,2020-07-14,Assembly,"Assembly Energy Committee: Held for Consideration",11,4,0,0,15
1195935,876062,2019-05-30,Assembly,"Assembly Social Services Committee: Held for Consideration",11,5,0,2,18
1195941,971954,2020-07-17,Assembly,"Assembly Codes Committee: Held for Consideration",15,6,0,1,22
1195943,840077,2019-04-09,Assembly,"Assembly Ways And Means Committee: Favorable",27,5,0,3,35
1195943,856163,2019-05-01,Senate,"Senate Floor Vote - Final Passage",45,17,0,0,62
1195943,857367,2019-04-29,Assembly,"Assembly Floor Vote - Final Passage",99,45,0,6,150
1195963,971281,2020-07-15,Assembly,"Assembly Racing And Wagering Committee: Held for Consideration",7,4,0,0,11
1195986,840734,2019-04-09,Assembly,"Assembly Small Business Committee: Favorable refer to committee Ways and Means",14,0,0,3,17
1195996,880709,2019-06-12,Assembly,"Assembly Cities Committee: Favorable refer to committee Ways and Means",14,0,0,1,15
1195996,881582,2019-06-13,Assembly,"Assembly Ways And Means Committee: Favorable refer to committee Rules",28,0,1,6,35
1195996,882497,2019-06-17,Assembly,"Assembly Rules Committee: Favorable",26,0,0,5,31
1196003,971995,2020-07-17,Assembly,"Assembly Codes Committee: Held for Consideration",15,6,0,1,22
1196033,874611,2019-04-08,Senate,"Senate Local Government Committee Vote",7,0,0,0,7
1196033,874612,2019-05-29,Senate,"Senate Floor Vote - Final Passage",60,0,0,2,62
1196033,886801,2019-06-21,Assembly,"Assembly Floor Vote - Final Passage",134,1,0,15,150
1196037,948229,2020-03-10,Assembly,"Assembly Governmental Operations Committee: Favorable",14,0,0,0,14
1196037,972816,2020-07-21,Assembly,"Assembly Floor Vote - Final Passage",142,0,0,3,145
1196037,973592,2020-07-22,Senate,"Senate Floor Vote - Final Passage",52,8,0,0,60
1196045,971114,2020-07-14,Assembly,"Assembly Environmental Conservation Committee: Favorable refer to committee Rules",25,2,0,1,28
1196045,972197,2020-07-20,Assembly,"Assembly Rules Committee: Favorable",27,0,0,3,30
1196045,972263,2020-07-20,Assembly,"Assembly Floor Vote - Final Passage",138,3,0,4,145
1196045,973518,2020-07-23,Senate,"Senate Floor Vote - Final Passage",55,5,0,0,60
1196060,922203,2020-02-11,Assembly,"Assembly Small Business Committee: Favorable refer to committee Ways and Means",15,0,0,1,16
1196072,810150,2019-02-27,Assembly,"Assembly Real Property Taxation Committee: Favorable refer to committee Ways and Means",9,0,0,1,10
1196072,971884,2020-07-17,Assembly,"Assembly Ways And Means Committee: Favorable refer to committee Rules",28,4,0,2,34
1196072,972590,2020-07-21,Assembly,"Assembly Rules Committee: Favorable",26,0,0,4,30
1196077,882234,2019-06-13,Assembly,"Assembly Codes Committee: Held for Consideration",14,6,0,2,22
1196089,971302,2020-07-14,Assembly,"Assembly Higher Education Committee: Held for Consideration",18,7,0,0,25
1196090,882220,2019-06-13,Assembly,"Assembly Codes Committee: Held for Consideration",14,6,0,2,22
1196099,864716,2019-05-14,Assembly,"Assembly Consumer Affairs And Protection Committee: Favorable refer to committee Codes",14,1,0,1,16
1196099,868409,2019-05-21,Assembly,"Assembly Codes Committee: Favorable",15,6,0,1,22
1196099,878907,2019-06-05,Assembly,"Assembly Floor Vote - Final Passage",136,7,0,7,150
1196113,840809,2019-04-09,Assembly,"Assembly Transportation Committee: Held for Consideration",16,7,0,2,25
1196116,820401,2019-03-12,Assembly,"Assembly Election Law Committee: Favorable",15,0,0,1,16
1196116,829645,2019-03-26,Assembly,"Assembly Floor Vote - Final Passage",120,28,0,2,150
1196116,886731,2019-06-19,Senate,"Senate Floor Vote - Final Passage",61,1,0,0,62
1196122,971639,2020-07-16,Assembly,"Assembly Governmental Operations Committee: Held for Consideration",10,4,0,0,14
1196126,971608,2020-07-16,Assembly,"Assembly Governmental Operations Committee: Held for Consideration",10,4,0,0,14
1196131,882228,2019-06-13,Assembly,"Assembly Codes Committee: Held for Consideration",14,6,0,2,22
1196135,877991,2019-06-04,Assembly,"Assembly Correction Committee: Favorable refer to committee Rules",13,0,0,0,13
1196135,877992,2019-06-05,Assembly,"Assembly Rules Committee: Favorable",25,2,0,4,31
1196135,880897,2019-06-11,Assembly,"Assembly Floor Vote - Final Passage",141,1,0,8,150
1196139,876048,2019-05-30,Assembly,"Assembly Governmental Operations Committee: Favorable",12,0,0,2,14
1197159,832087,2019-03-26,Senate,"Senate Rules Committee Vote",19,0,0,0,19
1197159,832088,2019-03-29,Senate,"Senate Floor Vote - Final Passage",60,0,0,2,62
1197315,875248,2019-05-14,Senate,"Senate Higher Education Committee Vote",11,0,0,0,11
1197315,875249,2019-05-30,Senate,"Senate Floor Vote - Final Passage",58,0,0,4,62
1197438,825214,2019-03-19,Senate,"Senate Aging Committee Vote",7,0,0,0,7
1197506,830240,2019-03-26,Assembly,"Assembly Correction Committee: Favorable",10,3,0,0,13
1197514,868115,2019-05-14,Senate,"Senate Finance Committee Vote",22,0,0,1,23
1197514,868116,2019-05-21,Senate,"Senate Floor Vote - Final Passage",61,0,0,1,62
1197514,904446,2020-01-22,Senate,"Senate Finance Committee Vote",23,0,0,0,23
1197514,913261,2020-02-03,Senate,"Senate Floor Vote - Final Passage",59,0,0,3,62
1197517,971715,2020-07-16,Assembly,"Assembly Housing Committee: Held for Consideration",18,8,0,2,28
1197550,971244,2020-07-14,Assembly,"Assembly Education Committee: Held for Consideration",23,6,0,2,31
1197589,861565,2019-03-11,Senate,"Senate Crime Victims, Crime and Correction Committee Vote",6,1,0,0,7
1197589,861566,2019-05-07,Senate,"Senate Floor Vote - Final Passage",61,0,0,1,62
1197589,879072,2019-06-05,Assembly,"Assembly Floor Vote - Final Passage",139,6,0,5,150
1197608,838825,2019-04-09,Senate,"Senate Transportation Committee Vote",15,0,0,0,15
1197608,855162,2019-04-30,Senate,"Senate Finance Committee Vote",23,0,0,0,23
1197608,856272,2019-04-30,Senate,"Senate Finance Committee Vote",23,0,0,0,23
1197608,856273,2019-05-01,Senate,"Senate Floor Vote - Final Passage",62,0,0,0,62
1197654,811408,2019-02-28,Assembly,"Assembly Health Committee: Favorable refer to committee Codes",17,8,0,1,26
1197665,822463,2019-03-14,Assembly,"Assembly Transportation Committee: Favorable refer to committee Ways and Means",22,0,0,3,25
1197665,857241,2019-04-30,Assembly,"Assembly Ways And Means Committee: Favorable",33,0,0,2,35
1197742,971249,2020-07-14,Assembly,"Assembly Education Committee: Held for Consideration",23,6,0,2,31
1197767,877360,2019-05-22,Senate,"Senate Domestic Animal Welfare Committee Vote",7,0,0,0,7
1197767,877361,2019-06-04,Senate,"Senate Floor Vote - Final Passage",62,0,0,0,62
1197767,902949,2020-01-15,Senate,"Senate Domestic Animal Welfare Committee Vote",7,0,0,0,7
1197795,877854,2019-05-29,Senate,"Senate Civil Service and Pensions Committee Vote",7,0,0,0,7
1197795,878412,2019-06-05,Senate,"Senate Floor Vote - Final Passage",62,0,0,0,62
1197795,886693,2019-06-21,Assembly,"Assembly Floor Vote - Final Passage",139,2,0,9,150
1197808,885867,2019-06-18,Senate,"Senate Floor Vote - Final Passage",62,0,0,0,62
1197808,886351,2019-06-18,Senate,"Senate Rules Committee Vote",19,0,0,0,19
1197808,904728,2020-01-22,Senate,"Senate Finance Committee Vote",23,0,0,0,23
1197808,936639,2020-02-26,Senate,"Senate Floor Vote - Final Passage",60,0,0,2,62
1197829,972005,2020-07-17,Assembly,"Assembly Codes Committee: Held for Consideration",15,6,0,1,22
1197853,863542,2019-05-13,Senate,"Senate Transportation Committee Vote",14,0,0,1,15
1197853,863543,2019-05-14,Senate,"Senate Rules Committee Vote",18,0,0,1,19
1197853,864291,2019-05-15,Senate,"Senate Floor Vote - Final Passage",57,1,0,4,62
1197853,935450,2020-02-25,Senate,"Senate Transportation Committee Vote",15,0,0,0,15
1197853,941012,2020-03-03,Senate,"Senate Floor Vote - Final Passage",61,1,0,0,62
1197856,971447,2020-07-16,Assembly,"Assembly Governmental Operations Committee: Held for Consideration",10,4,0,0,14
1197861,971605,2020-07-16,Assembly,"Assembly Governmental Operations Committee: Held for Consideration",10,4,0,0,14
1197864,868275,2019-05-21,Assembly,"Assembly Cities Committee: Favorable refer to committee Codes",14,1,0,0,15
1197864,875056,2019-05-30,Assembly,"Assembly Codes Committee: Favorable",17,2,0,3,22
1197889,821488,2019-03-11,Senate,"Senate Women's Issues Committee Vote",6,0,0,1,7
1197889,821489,2019-03-14,Senate,"Senate Floor Vote - Final Passage",50,11,0,1,62
1197892,971968,2020-07-17,Assembly,"Assembly Ways And Means Committee: Held for Consideration",22,10,0,2,34
1197899,877738,2019-06-04,Assembly,"Assembly Ways And Means Committee: Favorable refer to committee Rules",26,7,0,2,35
1197899,882470,2019-06-17,Assembly,"Assembly Rules Committee: Favorable",26,0,0,5,31
1197931,971192,2020-07-14,Assembly,"Assembly Judiciary Committee: Held for Consideration",15,6,0,0,21
1197956,970766,2020-07-13,Assembly,"Assembly Economic Development Committee: Held for Consideration",17,7,0,1,25
1197978,860945,2019-05-07,Assembly,"Assembly Governmental Employees Committee: Favorable refer to committee Ways and Means",14,0,0,0,14
1197978,877837,2019-06-04,Assembly,"Assembly Ways And Means Committee: Favorable refer to committee Rules",31,2,0,2,35
1197978,877985,2019-06-05,Assembly,"Assembly Rules Committee: Favorable",27,0,0,4,31
1197997,971648,2020-07-16,Assembly,"Assembly Governmental Operations Committee: Held for Consideration",10,4,0,0,14
1197998,971960,2020-07-17,Assembly,"Assembly Codes Committee: Held for Consideration",15,6,0,1,22
1198002,809763,2019-02-27,Assembly,"Assembly Agriculture Committee: Favorable",20,0,0,1,21
1198037,839084,2019-03-12,Senate,"Senate Committee Vote",6,0,0,0,6
1198037,839906,2019-04-09,Senate,"Senate Floor Vote - Final Passage",58,2,0,2,62
1198037,884329,2019-06-18,Assembly,"Assembly Floor Vote - Final Passage",139,9,0,2,150
1198039,882235,2019-06-14,Assembly,"Assembly Governmental Employees Committee: Favorable refer to committee Ways and Means",13,0,0,1,14
1198039,882698,2019-06-17,Assembly,"Assembly Rules Committee: Favorable",25,0,0,6,31
1198039,882699,2019-06-17,Assembly,"Assembly Ways And Means Committee: Favorable refer to committee Rules",32,1,0,2,35
1198051,868067,2019-05-21,Senate,"Senate Children and Families Committee Vote",7,0,0,0,7
1198051,869185,2019-05-21,Senate,"Senate Children and Families Committee Vote",7,0,0,0,7
1198051,869186,2019-05-22,Senate,"Senate Floor Vote - Final Passage",49,12,0,1,62
1198056,885211,2019-06-18,Senate,"Senate Floor Vote - Final Passage",56,6,0,0,62
1198056,886505,2019-06-18,Senate,"Senate Rules Committee Vote",19,0,0,0,19
1198059,971942,2020-07-17,Assembly,"Assembly Ways And Means Committee: Held for Consideration",22,10,0,2,34
1198068,934594,2020-02-25,Assembly,"Assembly Governmental Operations Committee: Held for Consideration",9,4,0,1,14
1198075,824115,2019-03-19,Assembly,"Assembly Governmental Operations Committee: Favorable refer to committee Codes",10,3,0,1,14
1198075,882217,2019-06-13,Assembly,"Assembly Codes Committee: Favorable refer to committee Rules",17,3,0,2,22
1198075,882444,2019-06-17,Assembly,"Assembly Rules Committee: Favorable",26,0,0,5,31
1198096,857120,2019-04-30,Assembly,"Assembly Consumer Affairs And Protection Committee: Favorable refer to committee Codes",16,0,0,0,16
1198096,868639,2019-05-21,Assembly,"Assembly Codes Committee: Favorable",20,1,0,1,22
1198096,881766,2019-06-13,Assembly,"Assembly Floor Vote - Final Passage",138,1,0,11,150
1198103,829768,2019-03-26,Assembly,"Assembly Correction Committee: Favorable",10,3,0,0,13
1198106,971456,2020-07-15,Assembly,"Assembly Veterans' Affairs Committee: Held for Consideration",10,7,0,2,19
1198115,971632,2020-07-16,Assembly,"Assembly Governmental Operations Committee: Held for Consideration",10,4,0,0,14
1198117,863727,2019-05-14,Assembly,"Assembly Consumer Affairs And Protection Committee: Favorable refer to committee Codes",14,1,0,1,16
1198117,868759,2019-05-21,Assembly,"Assembly Codes Committee: Favorable",20,1,0,1,22
1198117,875706,2019-05-30,Assembly,"Assembly Floor Vote - Final Passage",138,3,0,9,150
1198117,886777,2019-06-20,Senate,"Senate Floor Vote - Final Passage",61,1,0,0,62
1198122,814679,2019-03-06,Assembly,"Assembly Corporations, Authorities And Commissions Committee: Favorable refer to committee Codes",21,3,0,2,26
1198122,819285,2019-03-12,Assembly,"Assembly Codes Committee: Favorable",20,1,0,1,22
1198122,864809,2019-05-14,Senate,"Senate Floor Vote - Final Passage",59,0,0,3,62
1198122,864810,2019-05-14,Assembly,"Assembly Floor Vote - Final Passage",134,7,0,9,150
1198329,874990,2019-03-12,Senate,"Senate Energy and Telecommunications Committee Vote",7,2,0,0,9
1198329,874991,2019-05-29,Senate,"Senate Floor Vote - Final Passage",55,5,0,2,62
1198329,904629,2020-01-22,Senate,"Senate Energy and Telecommunications Committee Vote",7,2,0,0,9
1198335,860545,2019-05-06,Senate,"Senate Internet and Technology Committee Vote",7,0,0,0,7
1198373,837719,2019-03-26,Senate,"Senate Rules Committee Vote",19,0,0,0,19
1198373,838576,2019-04-08,Senate,"Senate Floor Vote - Final Passage",59,0,0,3,62
1198379,861000,2019-05-07,Senate,"Senate Housing, Construction and Community Development Committee Vote",11,0,0,0,11
1198406,971683,2020-07-16,Assembly,"Assembly Real Property Taxation Committee: Held for Consideration",8,2,0,0,10
1198418,971450,2020-07-15,Assembly,"Assembly Veterans' Affairs Committee: Held for Consideration",12,5,0,2,19
1198422,829671,2019-03-12,Senate,"Senate Energy and Telecommunications Committee Vote",8,1,0,0,9
1198422,829672,2019-03-26,Senate,"Senate Floor Vote - Final Passage",44,17,0,1,62
1198422,831108,2019-03-27,Assembly,"Assembly Floor Vote - Final Passage",123,25,0,2,150
1198444,971448,2020-07-15,Assembly,"Assembly Veterans' Affairs Committee: Held for Consideration",10,7,0,2,19
1198448,874060,2019-05-29,Senate,"Senate Energy and Telecommunications Committee Vote",7,2,0,0,9
1198461,841168,2019-04-09,Senate,"Senate Cities Committee Vote",7,0,0,0,7
1198472,964963,2020-06-10,Senate,"Senate Floor Vote - Final Passage",41,21,0,0,62
1198472,965308,2020-06-10,Assembly,"Assembly Floor Vote - Final Passage",100,44,0,3,147
1198472,966351,2020-05-28,Senate,"Senate Rules Committee Vote",14,5,0,0,19
1198472,966352,2020-06-08,Senate,"Senate Finance Committee Vote",18,5,0,0,23
1198508,878746,2019-06-06,Assembly,"Assembly Environmental Conservation Committee: Held for Consideration",21,7,0,2,30
1198538,825338,2019-03-19,Assembly,"Assembly Governmental Employees Committee: Favorable refer to committee Codes",14,0,0,0,14
1198538,838935,2019-04-09,Assembly,"Assembly Codes Committee: Favorable",21,1,0,0,22
1198541,972075,2020-07-17,Assembly,"Assembly Ways And Means Committee: Held for Consideration",22,10,0,2,34
1198571,878553,2019-06-04,Assembly,"Assembly Housing Committee: Favorable refer to committee Rules",26,0,0,2,28
1198571,880501,2019-06-11,Assembly,"Assembly Rules Committee: Favorable",25,0,0,6,31
1198590,971687,2020-07-16,Assembly,"Assembly Real Property Taxation Committee: Held for Consideration",8,2,0,0,10
1198592,972074,2020-07-17,Assembly,"Assembly Codes Committee: Held for Consideration",15,6,0,1,22
1198620,971160,2020-07-14,Assembly,"Assembly Judiciary Committee: Held for Consideration",15,6,0,0,21
1198621,839428,2019-04-09,Senate,"Senate Energy and Telecommunications Committee Vote",7,2,0,0,9
1198621,950586,2020-03-10,Senate,"Senate Energy and Telecommunications Committee Vote",6,3,0,0,9
1198624,877960,2019-06-04,Assembly,"Assembly Housing Committee: Favorable refer to committee Rules",23,3,0,2,28
1198624,877961,2019-06-05,Assembly,"Assembly Rules Committee: Favorable",27,0,0,4,31
1198645,883694,2019-06-12,Senate,"Senate Rules Committee Vote",19,0,0,0,19
1198645,885104,2019-06-18,Senate,"Senate Floor Vote - Final Passage",62,0,0,0,62
1198660,971679,2020-07-16,Assembly,"Assembly Governmental Operations Committee: Held for Consideration",10,4,0,0,14
1198665,878652,2019-06-06,Assembly,"Assembly Environmental Conservation Committee: Held for Consideration",21,7,0,2,30
1198675,971949,2020-07-17,Assembly,"Assembly Codes Committee: Held for Consideration",15,6,0,1,22
1198690,970838,2020-07-13,Assembly,"Assembly Health Committee: Held for Consideration",18,6,0,2,26
1198695,824985,2019-03-11,Senate,"Senate Transportation Committee Vote",14,0,0,0,14
1198695,824986,2019-03-19,Senate,"Senate Floor Vote - Final Passage",61,0,0,1,62
1198695,943388,2020-03-03,Senate,"Senate Transportation Committee Vote",15,0,0,0,15
1198709,950509,2020-03-10,Assembly,"Assembly Governmental Operations Committee: Held for Consideration",10,4,0,0,14
1198720,971989,2020-07-17,Assembly,"Assembly Ways And Means Committee: Held for Consideration",22,10,0,2,34
1198727,971259,2020-07-14,Assembly,"Assembly Education Committee: Held for Consideration",23,6,0,2,31
1198736,875378,2019-05-30,Senate,"Senate Floor Vote - Final Passage",39,19,0,4,62
1198736,875379,2019-05-30,Senate,"Senate Housing, Construction and Community Development Committee Vote",6,4,0,1,11
1198736,875380,2019-05-30,Senate,"Senate Rules Committee Vote",13,5,0,1,19
1198741,971597,2020-07-16,Assembly,"Assembly Governmental Operations Committee: Held for Consideration",10,4,0,0,14
1198794,824490,2019-03-19,Senate,"Senate Aging Committee Vote",7,0,0,0,7
1198794,829804,2019-03-26,Senate,"Senate Rules Committee Vote",19,0,0,0,19
1198794,854378,2019-04-29,Senate,"Senate Floor Vote - Final Passage",60,1,0,1,62
1198849,971480,2020-07-15,Assembly,"Assembly Labor Committee: Held for Consideration",18,7,0,3,28
1198853,971565,2020-07-16,Assembly,"Assembly Governmental Employees Committee: Held for Consideration",14,0,0,0,14
1198860,972109,2020-07-17,Assembly,"Assembly Ways And Means Committee: Held for Consideration",22,10,0,2,34
1198868,972033,2020-07-17,Assembly,"Assembly Codes Committee: Held for Consideration",15,6,0,1,22
1198875,970763,2020-07-13,Assembly,"Assembly Health Committee: Held for Consideration",20,4,0,2,26
1198886,971952,2020-07-17,Assembly,"Assembly Codes Committee: Held for Consideration",15,6,0,1,22
1198900,971390,2020-07-16,Assembly,"Assembly Governmental Operations Committee: Held for Consideration",10,4,0,0,14
1198904,971499,2020-07-15,Assembly,"Assembly Labor Committee: Held for Consideration",18,7,0,3,28
1198911,972063,2020-07-17,Assembly,"Assembly Codes Committee: Held for Consideration",15,6,0,1,22
1198921,971270,2020-07-14,Assembly,"Assembly Education Committee: Held for Consideration",23,6,0,2,31
1198940,971654,2020-07-16,Assembly,"Assembly Real Property Taxation Committee: Held for Consideration",8,2,0,0,10
1198950,878399,2019-06-05,Assembly,"Assembly Transportation Committee: Favorable refer to committee Ways and Means",20,6,0,0,26
1198957,971611,2020-07-16,Assembly,"Assembly Real Property Taxation Committee: Held for Consideration",8,2,0,0,10
1198962,971765,2020-07-17,Assembly,"Assembly Codes Committee: Held for Consideration",15,6,0,1,22
1198977,884382,2019-05-13,Senate,"Senate Insurance Committee Vote",11,0,0,0,11
1198977,884383,2019-06-17,Senate,"Senate Floor Vote - Final Passage",61,1,0,0,62
1198977,884384,2019-06-18,Assembly,"Assembly Floor Vote - Final Passage",148,0,0,2,150
1198982,876061,2019-05-30,Assembly,"Assembly Governmental Operations Committee: Favorable refer to committee Ways and Means",12,0,0,2,14
1198982,877493,2019-06-04,Assembly,"Assembly Ways And Means Committee: Favorable refer to committee Rules",33,0,0,2,35
1198982,877990,2019-06-05,Assembly,"Assembly Rules Committee: Favorable",27,0,0,4,31
1198994,821484,2019-03-11,Senate,"Senate Insurance Committee Vote",11,0,0,0,11
1198994,821485,2019-03-14,Senate,"Senate Floor Vote - Final Passage",61,0,0,1,62
1198994,879317,2019-06-06,Assembly,"Assembly Floor Vote - Final Passage",137,0,0,13,150
1199008,971617,2020-07-16,Assembly,"Assembly Governmental Operations Committee: Held for Consideration",10,4,0,0,14
1199012,970928,2020-07-13,Assembly,"Assembly Agriculture Committee: Held for Consideration",13,6,0,2,21
1199023,815027,2019-03-05,Senate,"Senate Civil Service and Pensions Committee Vote",7,0,0,0,7
1199057,971613,2020-07-16,Assembly,"Assembly Governmental Operations Committee: Held for Consideration",10,4,0,0,14
1199062,906871,2020-01-28,Assembly,"Assembly Housing Committee: Favorable",27,0,0,1,28
1199062,914339,2020-02-03,Assembly,"Assembly Floor Vote - Final Passage",141,1,0,6,148
1199062,973507,2020-07-22,Senate,"Senate Floor Vote - Final Passage",60,0,0,0,60
1199084,878408,2019-06-05,Assembly,"Assembly Transportation Committee: Favorable refer to committee Codes",26,0,0,0,26
1199084,880212,2019-06-11,Assembly,"Assembly Codes Committee: Favorable refer to committee Rules",22,0,0,0,22
1199084,881347,2019-06-13,Assembly,"Assembly Rules Committee: Favorable",26,0,0,5,31
1199084,883984,2019-06-18,Assembly,"Assembly Floor Vote - Final Passage",146,0,0,4,150
1199084,973555,2020-07-23,Senate,"Senate Floor Vote - Final Passage",58,2,0,0,60
1199093,882819,2019-05-29,Senate,"Senate Insurance Committee Vote",11,0,0,0,11
1199093,882820,2019-06-17,Senate,"Senate Floor Vote - Final Passage",62,0,0,0,62
1199105,810143,2019-02-27,Assembly,"Assembly Real Property Taxation Committee: Favorable refer to committee Ways and Means",9,0,0,1,10
1199113,878104,2019-05-29,Senate,"Senate Insurance Committee Vote",11,0,0,0,11
1199113,878105,2019-06-05,Senate,"Senate Floor Vote - Final Passage",62,0,0,0,62
1199113,883311,2019-06-17,Assembly,"Assembly Floor Vote - Final Passage",145,0,0,5,150
1199123,881769,2019-06-12,Senate,"Senate Floor Vote - Final Passage",61,1,0,0,62
1199123,881770,2019-06-12,Senate,"Senate Rules Committee Vote",19,0,0,0,19
1199123,922185,2020-02-12,Senate,"Senate Consumer Protection Committee Vote",7,0,0,0,7
1199123,934036,2020-02-25,Senate,"Senate Floor Vote - Final Passage",59,1,0,2,62
1199132,971391,2020-07-16,Assembly,"Assembly Governmental Employees Committee: Held for Consideration",9,5,0,0,14
1199136,825328,2019-03-19,Assembly,"Assembly Governmental Employees Committee: Favorable",14,0,0,0,14
1199136,831663,2019-03-28,Assembly,"Assembly Floor Vote - Final Passage",134,9,0,7,150
1199136,860842,2019-05-07,Senate,"Senate Floor Vote - Final Passage",61,0,0,1,62
1199170,882205,2019-06-13,Senate,"Senate Rules Committee Vote",19,0,0,0,19
1199170,882206,2019-06-14,Senate,"Senate Floor Vote - Final Passage",62,0,0,0,62
1199170,884904,2019-06-19,Assembly,"Assembly Floor Vote - Final Passage",147,1,0,2,150
1199175,863953,2019-04-30,Senate,"Senate Judiciary Committee Vote",15,0,0,0,15
1199175,863954,2019-05-14,Senate,"Senate Floor Vote - Final Passage",59,0,0,3,62
1199175,906928,2020-01-28,Senate,"Senate Judiciary Committee Vote",15,0,0,0,15
1199175,935507,2020-02-26,Senate,"Senate Floor Vote - Final Passage",60,0,0,2,62
1199186,863964,2019-05-14,Senate,"Senate Judiciary Committee Vote",14,1,0,0,15
1199186,868338,2019-05-21,Senate,"Senate Finance Committee Vote",22,1,0,0,23
1199186,882125,2019-06-13,Senate,"Senate Floor Vote - Final Passage",52,10,0,0,62
1199186,903029,2020-01-14,Senate,"Senate Judiciary Committee Vote",14,1,0,0,15
1199186,935272,2020-02-25,Senate,"Senate Finance Committee Vote",21,1,0,1,23
1199186,941399,2020-03-03,Senate,"Senate Floor Vote - Final Passage",49,13,0,0,62
1199201,878003,2019-06-05,Assembly,"Assembly Health Committee: Favorable refer to committee Ways and Means",25,0,0,1,26
1199201,879338,2019-06-06,Assembly,"Assembly Ways And Means Committee: Favorable refer to committee Rules",31,0,0,4,35
1199201,881337,2019-06-13,Assembly,"Assembly Rules Committee: Favorable",26,0,0,5,31
1199201,883972,2019-06-18,Assembly,"Assembly Floor Vote - Final Passage",146,0,0,4,150
1199201,972446,2020-07-21,Senate,"Senate Floor Vote - Final Passage",60,0,0,0,60
1199205,948197,2020-03-10,Assembly,"Assembly Governmental Operations Committee: Held for Consideration",10,4,0,0,14
1199219,971379,2020-07-14,Assembly,"Assembly Insurance Committee: Held for Consideration",17,3,0,2,22
1199285,875278,2019-05-14,Senate,"Senate Higher Education Committee Vote",11,0,0,0,11
1199285,875279,2019-05-30,Senate,"Senate Floor Vote - Final Passage",58,0,0,4,62
1199285,902568,2020-01-14,Senate,"Senate Higher Education Committee Vote",10,0,0,1,11
1199422,808512,2019-02-26,Senate,"Senate Civil Service and Pensions Committee Vote",7,0,0,0,7
1199422,887743,2019-06-19,Senate,"Senate Floor Vote - Final Passage",62,0,0,0,62
1199422,887744,2019-06-19,Senate,"Senate Rules Committee Vote",18,1,0,0,19
1199718,970809,2020-07-13,Assembly,"Assembly Health Committee: Held for Consideration",18,6,0,2,26
1199726,971917,2020-07-17,Assembly,"Assembly Codes Committee: Held for Consideration",15,6,0,1,22
1199729,876090,2019-05-30,Assembly,"Assembly Judiciary Committee: Favorable",20,0,0,1,21
1199733,971964,2020-07-17,Assembly,"Assembly Ways And Means Committee: Held for Consideration",22,10,0,2,34
1199751,868902,2019-05-21,Assembly,"Assembly Health Committee: Favorable",26,0,0,0,26
1199761,971277,2020-07-14,Assembly,"Assembly Education Committee: Held for Consideration",23,6,0,2,31
1199780,971245,2020-07-14,Assembly,"Assembly Education Committee: Held for Consideration",23,6,0,2,31
1199797,972068,2020-07-17,Assembly,"Assembly Ways And Means Committee: Held for Consideration",22,10,0,2,34
1199801,882226,2019-06-13,Assembly,"Assembly Codes Committee: Favorable refer to committee Rules",20,0,0,2,22
1199801,886249,2019-06-20,Assembly,"Assembly Rules Committee: Favorable",27,0,0,4,31
1199801,886250,2019-06-21,Assembly,"Assembly Floor Vote - Final Passage",129,6,0,15,150
1199805,971096,2020-07-14,Assembly,"Assembly Energy Committee: Held for Consideration",11,4,0,0,15
1199810,881944,2019-05-06,Senate,"Senate Local Government Committee Vote",7,0,0,0,7
1199810,881945,2019-06-14,Senate,"Senate Floor Vote - Final Passage",55,7,0,0,62
1199810,901933,2020-01-13,Senate,"Senate Local Government Committee Vote",6,0,0,1,7
1199810,972473,2020-07-21,Senate,"Senate Floor Vote - Final Passage",58,2,0,0,60
1199815,869045,2019-05-20,Senate,"Senate Rules Committee Vote",16,2,0,1,19
1199815,869046,2019-05-22,Senate,"Senate Floor Vote - Final Passage",43,18,0,1,62
1199815,942937,2020-03-03,Senate,"Senate Labor Committee Vote",10,3,0,0,13
1199829,971081,2020-07-14,Assembly,"Assembly Environmental Conservation Committee: Held for Consideration",19,8,0,1,28
1199834,825346,2019-03-19,Assembly,"Assembly Governmental Operations Committee: Favorable refer to committee Ways and Means",11,2,0,1,14
1199834,877736,2019-06-04,Assembly,"Assembly Ways And Means Committee: Favorable refer to committee Rules",29,4,0,2,35
1199834,877966,2019-06-05,Assembly,"Assembly Rules Committee: Favorable",24,3,0,4,31
1199841,971713,2020-07-17,Assembly,"Assembly Ways And Means Committee: Held for Consideration",24,8,0,2,34
1199847,882214,2019-06-13,Assembly,"Assembly Codes Committee: Held for Consideration",14,6,0,2,22
1199850,971628,2020-07-16,Assembly,"Assembly Governmental Operations Committee: Held for Consideration",10,4,0,0,14
1199861,971944,2020-07-17,Assembly,"Assembly Ways And Means Committee: Held for Consideration",22,10,0,2,34
1199887,881527,2019-05-13,Senate,"Senate Insurance Committee Vote",11,0,0,0,11
1199887,881792,2019-06-13,Senate,"Senate Floor Vote - Final Passage",61,1,0,0,62
1199887,906529,2020-01-27,Senate,"Senate Insurance Committee Vote",11,0,0,0,11
1199887,940576,2020-03-02,Senate,"Senate Floor Vote - Final Passage",60,1,0,1,62
1199903,971248,2020-07-14,Assembly,"Assembly Education Committee: Held for Consideration",23,6,0,2,31
1199905,972053,2020-07-17,Assembly,"Assembly Codes Committee: Held for Consideration",15,6,0,1,22
1199916,972038,2020-07-17,Assembly,"Assembly Ways And Means Committee: Held for Consideration",22,10,0,2,34
1199925,971491,2020-07-15,Assembly,"Assembly Labor Committee: Held for Consideration",18,7,0,3,28
1199932,972344,2020-07-20,Senate,"Senate Insurance Committee Vote",11,0,0,0,11
1199932,973477,2020-07-22,Senate,"Senate Floor Vote - Final Passage",59,1,0,0,60
1199932,973478,2020-07-23,Assembly,"Assembly Floor Vote - Final Passage",137,4,0,4,145
1199932,973796,2020-07-21,Senate,"Senate Rules Committee Vote",19,0,0,0,19
1199936,860745,2019-05-06,Senate,"Senate Corporations, Authorities and Commissions Committee Vote",6,1,0,0,7
1199936,875419,2019-05-30,Senate,"Senate Floor Vote - Final Passage",42,16,0,4,62
1199936,875420,2019-05-30,Senate,"Senate Rules Committee Vote",13,5,0,1,19
1199936,904006,2020-01-21,Senate,"Senate Corporations, Authorities and Commissions Committee Vote",6,1,0,0,7
1199936,942177,2020-03-03,Senate,"Senate Finance Committee Vote",19,4,0,0,23
1199936,972777,2020-07-21,Senate,"Senate Floor Vote - Final Passage",41,19,0,0,60
1199951,972119,2020-07-17,Assembly,"Assembly Codes Committee: Held for Consideration",15,6,0,1,22
1199953,857041,2019-04-30,Assembly,"Assembly Health Committee: Favorable refer to committee Ways and Means",25,0,0,1,26
1199953,875603,2019-05-30,Assembly,"Assembly Ways And Means Committee: Favorable",28,3,0,4,35
1199953,884165,2019-06-18,Assembly,"Assembly Floor Vote - Final Passage",123,24,0,3,150
1199953,973535,2020-07-22,Senate,"Senate Floor Vote - Final Passage",57,3,0,0,60
1199958,834112,2019-04-02,Assembly,"Assembly Health Committee: Favorable refer to committee Ways and Means",23,1,0,2,26
1199958,875599,2019-05-30,Assembly,"Assembly Ways And Means Committee: Favorable",28,3,0,4,35
1199958,884533,2019-06-18,Assembly,"Assembly Floor Vote - Final Passage",124,23,0,3,150
1199978,870431,2019-05-21,Assembly,"Assembly Education Committee: Favorable refer to committee Ways and Means",31,0,0,0,31
1199978,877846,2019-06-04,Assembly,"Assembly Ways And Means Committee: Favorable refer to committee Rules",33,0,0,2,35
1199978,877996,2019-06-05,Assembly,"Assembly Rules Committee: Favorable",27,0,0,4,31
1199978,880885,2019-06-11,Assembly,"Assembly Floor Vote - Final Passage",142,0,0,8,150
1199978,885415,2019-06-18,Senate,"Senate Floor Vote - Final Passage",62,0,0,0,62
1199980,971940,2020-07-17,Assembly,"Assembly Ways And Means Committee: Held for Consideration",22,10,0,2,34
1199995,919703,2020-02-11,Assembly,"Assembly Social Services Committee: Held for Consideration",12,5,0,0,17
1200000,971567,2020-07-15,Assembly,"Assembly Tourism, Arts And Sports Development Committee: Held for Consideration",14,6,0,0,20
1200009,971933,2020-07-17,Assembly,"Assembly Ways And Means Committee: Held for Consideration",22,10,0,2,34
1200014,971495,2020-07-15,Assembly,"Assembly Labor Committee: Held for Consideration",18,7,0,3,28
1200017,972085,2020-07-17,Assembly,"Assembly Codes Committee: Held for Consideration",15,6,0,1,22
1200023,902548,2020-01-14,Assembly,"Assembly Judiciary Committee: Favorable",20,1,0,0,21
1200023,913982,2020-01-14,Assembly,"Assembly Judiciary Committee: Favorable",20,1,0,0,21
1200023,972626,2020-07-21,Assembly,"Assembly Floor Vote - Final Passage",142,0,0,3,145
1200035,839580,2019-04-09,Assembly,"Assembly Transportation Committee: Held for Consideration",16,7,0,2,25
1200052,886547,2019-06-19,Senate,"Senate Floor Vote - Final Passage",62,0,0,0,62
1200052,886548,2019-06-21,Assembly,"Assembly Floor Vote - Final Passage",134,10,0,6,150
1200052,887357,2019-06-19,Senate,"Senate Rules Committee Vote",19,0,0,0,19
1200063,971803,2020-07-16,Assembly,"Assembly Governmental Employees Committee: Held for Consideration",10,4,0,0,14
1200074,874337,2019-05-14,Senate,"Senate Civil Service and Pensions Committee Vote",6,0,0,1,7
1200074,874338,2019-05-29,Senate,"Senate Floor Vote - Final Passage",60,0,0,2,62
1200074,881828,2019-06-13,Assembly,"Assembly Floor Vote - Final Passage",138,2,0,10,150
1200082,877815,2019-06-05,Assembly,"Assembly Insurance Committee: Favorable refer to committee Codes",24,0,0,0,24
1200082,880131,2019-06-11,Assembly,"Assembly Codes Committee: Favorable refer to committee Rules",22,0,0,0,22
1200082,881357,2019-06-13,Assembly,"Assembly Rules Committee: Favorable",26,0,0,5,31
1200082,884493,2019-06-18,Assembly,"Assembly Floor Vote - Final Passage",146,0,0,4,150
1200086,971135,2020-07-14,Assembly,"Assembly Judiciary Committee: Held for Consideration",15,6,0,0,21
1200109,971459,2020-07-15,Assembly,"Assembly Labor Committee: Held for Consideration",18,7,0,3,28
1200130,920056,2020-01-27,Senate,"Senate Local Government Committee Vote",5,2,0,0,7
1200130,920057,2020-02-11,Senate,"Senate Floor Vote - Final Passage",43,19,0,0,62
1200130,973629,2020-07-23,Assembly,"Assembly Floor Vote - Final Passage",140,1,0,4,145
1200149,971768,2020-07-17,Assembly,"Assembly Codes Committee: Held for Consideration",15,6,0,1,22
1200155,878711,2019-06-06,Assembly,"Assembly Environmental Conservation Committee: Held for Consideration",21,7,0,2,30
1200158,942126,2020-03-03,Assembly,"Assembly Social Services Committee: Held for Consideration",12,4,0,1,17
1200165,971474,2020-07-15,Assembly,"Assembly Labor Committee: Held for Consideration",18,7,0,3,28
1200262,970994,2020-07-14,Assembly,"Assembly Education Committee: Held for Consideration",23,6,0,2,31
1200285,970835,2020-07-13,Assembly,"Assembly Economic Development Committee: Held for Consideration",17,7,0,1,25
1200316,867974,2019-05-21,Assembly,"Assembly Judiciary Committee: Favorable refer to committee Codes",21,0,0,0,21
1200316,875004,2019-05-30,Assembly,"Assembly Codes Committee: Favorable",19,0,0,3,22
1200334,809771,2019-02-27,Assembly,"Assembly Higher Education Committee: Favorable",25,0,0,1,26
1200334,815737,2019-03-06,Assembly,"Assembly Floor Vote - Final Passage",146,0,0,4,150
1200334,839319,2019-04-09,Senate,"Senate Floor Vote - Final Passage",60,0,0,2,62
1200366,868726,2019-05-21,Assembly,"Assembly Codes Committee: Favorable refer to committee Ways and Means",15,6,0,1,22
1200366,875140,2019-05-30,Assembly,"Assembly Ways And Means Committee: Favorable",22,9,0,4,35
1200366,886462,2019-06-20,Assembly,"Assembly Floor Vote - Final Passage",102,44,0,4,150
1200428,948960,2020-03-11,Assembly,"Assembly Local Governments Committee: Held for Consideration",11,5,0,2,18
1200483,971274,2020-07-14,Assembly,"Assembly Education Committee: Held for Consideration",23,6,0,2,31
1200492,819509,2019-03-12,Assembly,"Assembly Labor Committee: Favorable refer to committee Codes",21,7,0,1,29
1200492,839784,2019-04-09,Assembly,"Assembly Codes Committee: Favorable",17,5,0,0,22
1200507,857008,2019-04-30,Assembly,"Assembly Health Committee: Favorable refer to committee Codes",22,3,0,1,26
1200507,884551,2019-06-19,Assembly,"Assembly Codes Committee: Favorable refer to committee Rules",20,2,0,0,22
1200507,885159,2019-06-20,Assembly,"Assembly Rules Committee: Favorable",27,0,0,4,31
1200514,877848,2019-06-05,Assembly,"Assembly Local Governments Committee: Favorable refer to committee Ways and Means",18,0,0,1,19
1200514,880343,2019-06-11,Assembly,"Assembly Ways And Means Committee: Favorable refer to committee Rules",33,0,0,2,35
1200514,881353,2019-06-13,Assembly,"Assembly Rules Committee: Favorable",26,0,0,5,31
1200569,971181,2020-07-14,Assembly,"Assembly Election Law Committee: Held for Consideration",12,4,0,0,16
1200625,884391,2019-06-18,Senate,"Senate Rules Committee Vote",17,2,0,0,19
1200625,885433,2019-06-18,Senate,"Senate Floor Vote - Final Passage",59,3,0,0,62
1201095,870225,2019-05-21,Assembly,"Assembly Insurance Committee: Favorable refer to committee Codes",23,0,0,1,24
1201095,877729,2019-06-04,Assembly,"Assembly Codes Committee: Favorable refer to committee Ways and Means",22,0,0,0,22
1201095,880335,2019-06-11,Assembly,"Assembly Ways And Means Committee: Favorable refer to committee Rules",33,0,0,2,35
1201095,881332,2019-06-13,Assembly,"Assembly Rules Committee: Favorable",26,0,0,5,31
1201187,828935,2019-03-26,Senate,"Senate Investigations and Government Operations Committee Vote",7,0,0,0,7
1201187,863974,2019-05-14,Senate,"Senate Finance Committee Vote",20,2,0,1,23
1201187,882244,2019-06-14,Senate,"Senate Floor Vote - Final Passage",53,9,0,0,62
1201187,884420,2019-06-18,Assembly,"Assembly Floor Vote - Final Passage",113,33,0,4,150
1201323,829275,2019-02-28,Senate,"Senate Domestic Animal Welfare Committee Vote",7,0,0,0,7
1201323,829276,2019-03-26,Senate,"Senate Floor Vote - Final Passage",61,0,0,1,62
1201385,941557,2020-03-03,Senate,"Senate Committee Vote",7,0,0,0,7
1201427,972105,2020-07-17,Assembly,"Assembly Codes Committee: Held for Consideration",15,6,0,1,22
1201430,856168,2019-04-30,Senate,"Senate Judiciary Committee Vote",15,0,0,0,15
1201430,878025,2019-06-05,Senate,"Senate Floor Vote - Final Passage",62,0,0,0,62
1201430,878026,2019-06-05,Senate,"Senate Rules Committee Vote",19,0,0,0,19
1201430,884217,2019-06-18,Assembly,"Assembly Floor Vote - Final Passage",145,1,0,4,150
1201437,972120,2020-07-17,Assembly,"Assembly Ways And Means Committee: Held for Consideration",22,10,0,2,34
1201442,972087,2020-07-17,Assembly,"Assembly Codes Committee: Held for Consideration",15,6,0,1,22
1201447,971646,2020-07-16,Assembly,"Assembly Real Property Taxation Committee: Held for Consideration",8,2,0,0,10
1201462,971496,2020-07-15,Assembly,"Assembly Labor Committee: Held for Consideration",18,7,0,3,28
1201476,933697,2020-02-25,Assembly,"Assembly Governmental Operations Committee: Held for Consideration",9,4,0,1,14
1201483,861600,2019-05-07,Assembly,"Assembly Transportation Committee: Favorable refer to committee Ways and Means",23,0,0,2,25
1201483,869051,2019-05-21,Assembly,"Assembly Ways And Means Committee: Favorable",32,0,0,3,35
1201483,875790,2019-05-30,Assembly,"Assembly Floor Vote - Final Passage",140,1,0,9,150
1201483,885353,2019-06-18,Senate,"Senate Floor Vote - Final Passage",62,0,0,0,62
1201486,971319,2020-07-15,Assembly,"Assembly Social Services Committee: Held for Consideration",12,5,0,0,17
1201508,971818,2020-07-16,Assembly,"Assembly Governmental Employees Committee: Held for Consideration",10,4,0,0,14
1201512,972118,2020-07-17,Assembly,"Assembly Ways And Means Committee: Held for Consideration",22,10,0,2,34
1201528,867560,2019-04-08,Senate,"Senate Local Government Committee Vote",7,0,0,0,7
1201528,867561,2019-05-20,Senate,"Senate Floor Vote - Final Passage",59,1,0,2,62
1201540,970905,2020-07-13,Assembly,"Assembly Corporations, Authorities And Commissions Committee: Held for Consideration",19,7,0,0,26
1201545,971975,2020-07-17,Assembly,"Assembly Codes Committee: Held for Consideration",15,6,0,1,22
1201558,971267,2020-07-14,Assembly,"Assembly Education Committee: Held for Consideration",23,6,0,2,31
1201578,870184,2019-05-21,Assembly,"Assembly Transportation Committee: Held for Consideration",18,7,0,0,25
1201581,971253,2020-07-14,Assembly,"Assembly Education Committee: Held for Consideration",23,6,0,2,31
1201587,972034,2020-07-17,Assembly,"Assembly Codes Committee: Held for Consideration",15,6,0,1,22
1201602,840833,2019-04-09,Assembly,"Assembly Transportation Committee: Held for Consideration",15,8,0,2,25
1201613,971985,2020-07-17,Assembly,"Assembly Codes Committee: Held for Consideration",15,6,0,1,22
1201626,970904,2020-07-13,Assembly,"Assembly Corporations, Authorities And Commissions Committee: Held for Consideration",18,8,0,0,26
1201631,971809,2020-07-16,Assembly,"Assembly Local Governments Committee: Held for Consideration",15,4,0,1,20
1201634,971182,2020-07-14,Assembly,"Assembly Judiciary Committee: Held for Consideration",15,6,0,0,21
1201641,840786,2019-04-09,Assembly,"Assembly Transportation Committee: Held for Consideration",16,7,0,2,25
1201647,879167,2019-06-05,Assembly,"Assembly Transportation Committee: Favorable refer to committee Ways and Means",26,0,0,0,26
1201653,970837,2020-07-13,Assembly,"Assembly Health Committee: Held for Consideration",18,6,0,2,26
1201661,859832,2019-05-07,Assembly,"Assembly Transportation Committee: Held for Consideration",16,7,0,2,25
1201667,971489,2020-07-15,Assembly,"Assembly Labor Committee: Held for Consideration",18,7,0,3,28
1201673,972072,2020-07-17,Assembly,"Assembly Ways And Means Committee: Held for Consideration",22,10,0,2,34
1201679,810257,2019-02-26,Senate,"Senate Mental Health and Developmental Disabilities Committee Vote",7,0,0,0,7
1201683,972050,2020-07-17,Assembly,"Assembly Ways And Means Committee: Held for Consideration",22,10,0,2,34
1201723,971662,2020-07-16,Assembly,"Assembly Real Property Taxation Committee: Held for Consideration",8,2,0,0,10
1201744,971444,2020-07-15,Assembly,"Assembly Veterans' Affairs Committee: Held for Consideration",12,5,0,2,19
1201790,971663,2020-07-16,Assembly,"Assembly Real Property Taxation Committee: Held for Consideration",8,2,0,0,10
1201796,971315,2020-07-14,Assembly,"Assembly Higher Education Committee: Held for Consideration",18,7,0,0,25
1201808,971636,2020-07-16,Assembly,"Assembly Governmental Operations Committee: Held for Consideration",10,4,0,0,14
1201873,971209,2020-07-14,Assembly,"Assembly Judiciary Committee: Held for Consideration",15,6,0,0,21
1201893,878656,2019-06-06,Assembly,"Assembly Environmental Conservation Committee: Held for Consideration",21,7,0,2,30
1201905,971280,2020-07-14,Assembly,"Assembly Education Committee: Held for Consideration",23,6,0,2,31
1201915,971819,2020-07-16,Assembly,"Assembly Governmental Employees Committee: Held for Consideration",10,4,0,0,14
1201936,870176,2019-05-21,Assembly,"Assembly Transportation Committee: Held for Consideration",18,7,0,0,25
1201939,971714,2020-07-17,Assembly,"Assembly Codes Committee: Held for Consideration",15,6,0,1,22
1201954,971618,2020-07-16,Assembly,"Assembly Real Property Taxation Committee: Held for Consideration",8,2,0,0,10
1201973,971645,2020-07-16,Assembly,"Assembly Governmental Operations Committee: Held for Consideration",10,4,0,0,14
1202020,971805,2020-07-16,Assembly,"Assembly Governmental Employees Committee: Held for Consideration",9,5,0,0,14
1202034,882259,2019-05-29,Senate,"Senate Investigations and Government Operations Committee Vote",6,1,0,0,7
1202034,882260,2019-06-14,Senate,"Senate Floor Vote - Final Passage",53,9,0,0,62
1202034,884236,2019-06-18,Assembly,"Assembly Floor Vote - Final Passage",115,32,0,3,150
1202055,859853,2019-05-07,Assembly,"Assembly Transportation Committee: Held for Consideration",16,7,0,2,25
1202076,971791,2020-07-16,Assembly,"Assembly Local Governments Committee: Held for Consideration",15,4,0,1,20
1202104,971962,2020-07-17,Assembly,"Assembly Ways And Means Committee: Held for Consideration",22,10,0,2,34
1202119,971336,2020-07-15,Assembly,"Assembly Social Services Committee: Held for Consideration",12,5,0,0,17
1202131,971352,2020-07-15,Assembly,"Assembly Tourism, Arts And Sports Development Committee: Held for Consideration",14,6,0,0,20
1202136,971155,2020-07-14,Assembly,"Assembly Judiciary Committee: Held for Consideration",15,6,0,0,21
1202160,881141,2019-06-13,Assembly,"Assembly Health Committee: Favorable refer to committee Ways and Means",26,0,0,0,26
1202168,971268,2020-07-14,Assembly,"Assembly Education Committee: Held for Consideration",23,6,0,2,31
1202171,971107,2020-07-14,Assembly,"Assembly Environmental Conservation Committee: Held for Consideration",19,8,0,1,28
1202182,886730,2019-06-19,Senate,"Senate Floor Vote - Final Passage",62,0,0,0,62
1202182,887181,2019-06-19,Senate,"Senate Rules Committee Vote",19,0,0,0,19
1202201,972078,2020-07-17,Assembly,"Assembly Codes Committee: Held for Consideration",15,6,0,1,22
1202211,878701,2019-06-06,Assembly,"Assembly Environmental Conservation Committee: Held for Consideration",21,7,0,2,30
1202225,933636,2020-02-25,Assembly,"Assembly Governmental Operations Committee: Held for Consideration",9,4,0,1,14
1202236,971785,2020-07-16,Assembly,"Assembly Local Governments Committee: Held for Consideration",15,4,0,1,20
1202248,881801,2019-06-14,Assembly,"Assembly Transportation Committee: Favorable refer to committee Ways and Means",24,0,0,1,25
1202248,882864,2019-06-17,Assembly,"Assembly Ways And Means Committee: Favorable refer to committee Rules",33,0,0,2,35
1202248,886124,2019-06-20,Assembly,"Assembly Rules Committee: Favorable",27,0,0,4,31
1202258,971815,2020-07-16,Assembly,"Assembly Local Governments Committee: Held for Consideration",15,4,0,1,20
1202263,971651,2020-07-16,Assembly,"Assembly Real Property Taxation Committee: Held for Consideration",8,2,0,0,10
1202285,942067,2020-03-03,Assembly,"Assembly Children And Families Committee: Held for Consideration",11,4,0,1,16
1202297,971802,2020-07-16,Assembly,"Assembly Local Governments Committee: Held for Consideration",15,4,0,1,20
1202321,971127,2020-07-14,Assembly,"Assembly Judiciary Committee: Held for Consideration",15,6,0,0,21
1202329,948097,2020-03-10,Assembly,"Assembly Transportation Committee: Held for Consideration",18,7,0,0,25
1202334,971150,2020-07-14,Assembly,"Assembly Insurance Committee: Held for Consideration",14,6,0,2,22
1202340,971787,2020-07-16,Assembly,"Assembly Governmental Employees Committee: Held for Consideration",9,5,0,0,14
1202353,971910,2020-07-16,Assembly,"Assembly Real Property Taxation Committee: Held for Consideration",8,2,0,0,10
1202363,827518,2019-03-11,Senate,"Senate Insurance Committee Vote",11,0,0,0,11
1202363,827519,2019-03-25,Senate,"Senate Floor Vote - Final Passage",62,0,0,0,62
1202363,901897,2020-01-13,Senate,"Senate Insurance Committee Vote",11,0,0,0,11
1202363,904980,2020-01-23,Senate,"Senate Floor Vote - Final Passage",59,0,0,3,62
1202373,972073,2020-07-17,Assembly,"Assembly Ways And Means Committee: Held for Consideration",22,10,0,2,34
1202384,811007,2019-02-28,Assembly,"Assembly Local Governments Committee: Favorable",15,0,0,4,19
1202384,816996,2019-03-07,Assembly,"Assembly Floor Vote - Final Passage",141,0,0,9,150
1202384,885404,2019-06-18,Senate,"Senate Floor Vote - Final Passage",62,0,0,0,62
1203300,810189,2019-02-27,Assembly,"Assembly Judiciary Committee: Favorable",21,0,0,0,21
1203300,816724,2019-03-07,Assembly,"Assembly Floor Vote - Final Passage",141,0,0,9,150
1203309,902664,2020-01-14,Assembly,"Assembly Judiciary Committee: Favorable refer to committee Codes",21,0,0,0,21
1203309,914281,2020-01-14,Assembly,"Assembly Judiciary Committee: Favorable refer to committee Codes",21,0,0,0,21
1203321,838354,2019-04-08,Assembly,"Assembly Judiciary Committee: Favorable refer to committee Codes",14,6,0,1,21
1203321,857327,2019-04-30,Assembly,"Assembly Codes Committee: Favorable",13,7,0,2,22
1203345,875765,2019-05-30,Assembly,"Assembly Judiciary Committee: Favorable refer to committee Codes",20,0,0,1,21
1203345,877415,2019-06-04,Assembly,"Assembly Codes Committee: Favorable refer to committee Rules",21,1,0,0,22
1203345,972067,2020-07-17,Assembly,"Assembly Codes Committee: Favorable refer to committee Rules",20,1,0,1,22
1203345,972899,2020-07-22,Assembly,"Assembly Rules Committee: Favorable",22,7,0,1,30
1203359,868872,2019-05-21,Assembly,"Assembly Judiciary Committee: Favorable",15,6,0,0,21
1203368,857056,2019-04-30,Assembly,"Assembly Social Services Committee: Favorable refer to committee Codes",18,0,0,0,18
1203368,859881,2019-05-07,Assembly,"Assembly Codes Committee: Favorable",20,0,0,2,22
1203375,878315,2019-06-04,Assembly,"Assembly Judiciary Committee: Favorable refer to committee Codes",14,7,0,0,21
1203375,880209,2019-06-11,Assembly,"Assembly Codes Committee: Favorable refer to committee Rules",16,6,0,0,22
1203375,881338,2019-06-13,Assembly,"Assembly Rules Committee: Favorable",26,0,0,5,31
1203375,886477,2019-06-20,Assembly,"Assembly Floor Vote - Final Passage",100,47,0,3,150
1203375,972511,2020-07-21,Senate,"Senate Floor Vote - Final Passage",43,17,0,0,60
1203381,913976,2020-02-04,Assembly,"Assembly Judiciary Committee: Favorable refer to committee Codes",18,2,0,1,21
1203381,933430,2020-02-25,Assembly,"Assembly Codes Committee: Favorable",16,5,0,1,22
1203392,809722,2019-02-27,Assembly,"Assembly Judiciary Committee: Favorable refer to committee Codes",21,0,0,0,21
1203392,814257,2019-03-05,Assembly,"Assembly Codes Committee: Favorable",22,0,0,0,22
1203392,822486,2019-03-14,Assembly,"Assembly Floor Vote - Final Passage",134,0,0,16,150
1203392,833343,2019-04-01,Senate,"Senate Floor Vote - Final Passage",61,0,0,1,62
1203398,886778,2019-06-20,Senate,"Senate Floor Vote - Final Passage",62,0,0,0,62
1203398,887202,2019-06-20,Senate,"Senate Rules Committee Vote",19,0,0,0,19
1203398,942099,2020-03-03,Senate,"Senate Education Committee Vote",15,0,0,0,15
1203411,971047,2020-07-14,Assembly,"Assembly Insurance Committee: Favorable refer to committee Codes",14,6,0,2,22
1203411,971826,2020-07-17,Assembly,"Assembly Codes Committee: Favorable refer to committee Rules",15,6,0,1,22
1203411,973080,2020-07-22,Assembly,"Assembly Rules Committee: Favorable",22,7,0,1,30
1203425,809846,2019-02-27,Assembly,"Assembly Governmental Operations Committee: Favorable refer to committee Codes",13,0,0,1,14
1203425,861480,2019-05-07,Assembly,"Assembly Codes Committee: Favorable",19,1,0,2,22
1203441,869188,2019-05-21,Senate,"Senate Rules Committee Vote",19,0,0,0,19
1203441,869189,2019-05-21,Senate,"Senate Consumer Protection Committee Vote",7,0,0,0,7
1203441,869190,2019-05-22,Senate,"Senate Floor Vote - Final Passage",61,0,0,1,62
1203441,877291,2019-06-03,Assembly,"Assembly Floor Vote - Final Passage",129,13,0,8,150
1203455,882903,2019-06-17,Assembly,"Assembly Judiciary Committee: Favorable refer to committee Codes",16,2,0,3,21
1203455,883897,2019-06-18,Assembly,"Assembly Ways And Means Committee: Favorable refer to committee Rules",28,5,0,2,35
1203455,883898,2019-06-18,Assembly,"Assembly Codes Committee: Favorable refer to committee Ways and Means",16,6,0,0,22
1203455,884880,2019-06-19,Assembly,"Assembly Rules Committee: Favorable",27,0,0,4,31
1203522,971191,2020-07-14,Assembly,"Assembly Judiciary Committee: Favorable refer to committee Rules",21,0,0,0,21
1203522,972574,2020-07-21,Assembly,"Assembly Floor Vote - Final Passage",142,0,0,3,145
1203522,972575,2020-07-21,Assembly,"Assembly Rules Committee: Favorable",26,0,0,4,30
1203536,971067,2020-07-14,Assembly,"Assembly Judiciary Committee: Favorable refer to committee Codes",15,6,0,0,21
1203536,971720,2020-07-17,Assembly,"Assembly Codes Committee: Favorable refer to committee Rules",15,6,0,1,22
1203536,972799,2020-07-21,Assembly,"Assembly Rules Committee: Favorable",19,7,0,4,30
1203562,813853,2019-03-05,Assembly,"Assembly Judiciary Committee: Favorable refer to committee Codes",19,0,0,2,21
1203562,819257,2019-03-12,Assembly,"Assembly Codes Committee: Favorable",21,0,0,1,22
1203562,826277,2019-03-20,Assembly,"Assembly Floor Vote - Final Passage",144,0,0,6,150
1203562,861466,2019-05-08,Senate,"Senate Floor Vote - Final Passage",60,1,0,1,62
1203572,857233,2019-04-30,Assembly,"Assembly Judiciary Committee: Favorable refer to committee Codes",18,1,0,2,21
1203572,859856,2019-05-07,Assembly,"Assembly Codes Committee: Favorable",20,0,0,2,22
1203572,865090,2019-05-15,Assembly,"Assembly Floor Vote - Final Passage",141,0,0,9,150
1203572,868285,2019-05-21,Senate,"Senate Floor Vote - Final Passage",59,2,0,1,62
1203583,814131,2019-03-05,Assembly,"Assembly Judiciary Committee: Favorable refer to committee Ways and Means",19,0,0,2,21
1203583,878577,2019-06-05,Assembly,"Assembly Ways And Means Committee: Favorable refer to committee Rules",31,0,0,4,35
1203583,880233,2019-06-11,Assembly,"Assembly Rules Committee: Favorable",25,0,0,6,31
1203583,881598,2019-06-13,Assembly,"Assembly Floor Vote - Final Passage",144,2,0,4,150
1203583,882190,2019-06-14,Senate,"Senate Floor Vote - Final Passage",62,0,0,0,62
1203599,856996,2019-04-30,Assembly,"Assembly Consumer Affairs And Protection Committee: Favorable refer to committee Codes",16,0,0,0,16
1203599,859883,2019-05-07,Assembly,"Assembly Codes Committee: Favorable refer to committee Ways and Means",20,0,0,2,22
1203599,878203,2019-06-05,Assembly,"Assembly Ways And Means Committee: Favorable refer to committee Rules",31,0,0,4,35
1203599,880419,2019-06-11,Assembly,"Assembly Rules Committee: Favorable",25,0,0,6,31
1203615,834108,2019-04-02,Assembly,"Assembly Health Committee: Favorable refer to committee Codes",17,7,0,2,26
1203615,839061,2019-04-09,Assembly,"Assembly Codes Committee: Favorable",16,6,0,0,22
1203639,860850,2019-05-07,Assembly,"Assembly Codes Committee: Favorable",15,5,0,2,22
1203657,857630,2019-04-30,Assembly,"Assembly Judiciary Committee: Favorable",13,6,0,2,21
1203669,878960,2019-05-29,Senate,"Senate Civil Service and Pensions Committee Vote",7,0,0,0,7
1203669,878961,2019-06-06,Senate,"Senate Floor Vote - Final Passage",61,0,0,1,62
1203669,886441,2019-06-21,Assembly,"Assembly Floor Vote - Final Passage",142,1,0,7,150
1203691,825327,2019-03-19,Assembly,"Assembly Judiciary Committee: Favorable refer to committee Codes",14,6,0,1,21
1203691,838921,2019-04-09,Assembly,"Assembly Codes Committee: Favorable",16,6,0,0,22
1203691,881082,2019-06-11,Assembly,"Assembly Floor Vote - Final Passage",99,41,0,10,150
1203749,810215,2019-02-27,Assembly,"Assembly Judiciary Committee: Favorable",16,5,0,0,21
1203770,877864,2019-06-05,Assembly,"Assembly Insurance Committee: Favorable refer to committee Codes",17,7,0,0,24
1203770,880215,2019-06-11,Assembly,"Assembly Codes Committee: Favorable refer to committee Rules",20,2,0,0,22
1203792,971149,2020-07-14,Assembly,"Assembly Correction Committee: Held for Consideration",10,2,0,1,13
1203805,809851,2019-02-27,Assembly,"Assembly Governmental Operations Committee: Favorable",12,1,0,1,14
1203805,820344,2019-03-12,Assembly,"Assembly Floor Vote - Final Passage",106,36,0,8,150
1203816,881530,2019-05-30,Senate,"Senate Rules Committee Vote",18,0,0,1,19
1203816,881764,2019-06-13,Senate,"Senate Floor Vote - Final Passage",61,1,0,0,62
1203816,904770,2020-01-22,Senate,"Senate Finance Committee Vote",23,0,0,0,23
1203816,939612,2020-03-02,Senate,"Senate Floor Vote - Final Passage",61,0,0,1,62
1203840,972029,2020-07-17,Assembly,"Assembly Ways And Means Committee: Held for Consideration",22,10,0,2,34
1203860,972039,2020-07-17,Assembly,"Assembly Codes Committee: Held for Consideration",15,6,0,1,22
1203865,972043,2020-07-17,Assembly,"Assembly Codes Committee: Held for Consideration",15,6,0,1,22
1203921,971717,2020-07-17,Assembly,"Assembly Codes Committee: Held for Consideration",15,6,0,1,22
1203941,882223,2019-06-13,Assembly,"Assembly Codes Committee: Held for Consideration",14,6,0,2,22
1203947,834122,2019-04-02,Assembly,"Assembly Local Governments Committee: Favorable refer to committee Ways and Means",17,0,0,2,19
1203947,875617,2019-05-30,Assembly,"Assembly Ways And Means Committee: Favorable",26,5,0,4,35
1203963,971982,2020-07-17,Assembly,"Assembly Ways And Means Committee: Held for Consideration",22,10,0,2,34
1203970,971142,2020-07-14,Assembly,"Assembly Judiciary Committee: Held for Consideration",15,6,0,0,21
1203976,972061,2020-07-17,Assembly,"Assembly Codes Committee: Held for Consideration",15,6,0,1,22
1203983,971604,2020-07-16,Assembly,"Assembly Governmental Operations Committee: Held for Consideration",10,4,0,0,14
1204015,970920,2020-07-13,Assembly,"Assembly Agriculture Committee: Held for Consideration",13,6,0,2,21
1204021,970939,2020-07-13,Assembly,"Assembly Agriculture Committee: Held for Consideration",13,6,0,2,21
1204028,971214,2020-07-14,Assembly,"Assembly Correction Committee: Held for Consideration",10,2,0,1,13
1204041,972069,2020-07-17,Assembly,"Assembly Codes Committee: Held for Consideration",15,6,0,1,22
1204069,972030,2020-07-17,Assembly,"Assembly Codes Committee: Held for Consideration",15,6,0,1,22
1204109,878718,2019-06-06,Assembly,"Assembly Environmental Conservation Committee: Held for Consideration",21,7,0,2,30
1204120,882229,2019-06-13,Assembly,"Assembly Codes Committee: Held for Consideration",14,6,0,2,22
1204157,971321,2020-07-15,Assembly,"Assembly Social Services Committee: Held for Consideration",12,5,0,0,17
1204161,943153,2020-03-03,Assembly,"Assembly Mental Health Committee: Held for Consideration",9,3,0,1,13
1204169,809645,2019-02-26,Senate,"Senate Mental Health and Developmental Disabilities Committee Vote",7,0,0,0,7
1204176,970811,2020-07-13,Assembly,"Assembly Health Committee: Held for Consideration",18,6,0,2,26
1204246,970834,2020-07-13,Assembly,"Assembly Alcoholism And Drug Abuse Committee: Held for Consideration",9,4,0,1,14
1204258,970952,2020-07-13,Assembly,"Assembly Agriculture Committee: Held for Consideration",14,5,0,2,21
1204282,814758,2019-03-06,Senate,"Senate Racing, Gaming and Wagering Committee Vote",7,0,0,0,7
1204288,870187,2019-05-22,Assembly,"Assembly Election Law Committee: Favorable refer to committee Ways and Means",10,4,0,2,16
1204288,878632,2019-06-05,Assembly,"Assembly Ways And Means Committee: Favorable refer to committee Rules",21,10,0,4,35
1204288,880400,2019-06-11,Assembly,"Assembly Rules Committee: Favorable",25,0,0,6,31
1204324,970930,2020-07-13,Assembly,"Assembly Agriculture Committee: Held for Consideration",13,6,0,2,21
1204333,815112,2019-03-06,Senate,"Senate Racing, Gaming and Wagering Committee Vote",7,0,0,0,7
1204337,971068,2020-07-14,Assembly,"Assembly Judiciary Committee: Held for Consideration",15,6,0,0,21
1204351,970815,2020-07-13,Assembly,"Assembly Economic Development Committee: Held for Consideration",17,7,0,1,25
1204369,840768,2019-04-09,Assembly,"Assembly Transportation Committee: Held for Consideration",16,7,0,2,25
1204402,822456,2019-03-14,Assembly,"Assembly Transportation Committee: Favorable refer to committee Ways and Means",22,0,0,3,25
1204402,857567,2019-04-30,Assembly,"Assembly Ways And Means Committee: Favorable",33,0,0,2,35
1204402,860363,2019-05-07,Senate,"Senate Floor Vote - Final Passage",61,0,0,1,62
1204402,860883,2019-05-07,Assembly,"Assembly Floor Vote - Final Passage",132,1,0,17,150
1204448,971161,2020-07-14,Assembly,"Assembly Judiciary Committee: Held for Consideration",15,6,0,0,21
1204457,971171,2020-07-14,Assembly,"Assembly Judiciary Committee: Held for Consideration",15,6,0,0,21
1204472,971141,2020-07-14,Assembly,"Assembly Judiciary Committee: Held for Consideration",15,6,0,0,21
1204497,971602,2020-07-16,Assembly,"Assembly Governmental Operations Committee: Held for Consideration",10,4,0,0,14
1204512,972086,2020-07-17,Assembly,"Assembly Codes Committee: Held for Consideration",15,6,0,1,22
1204516,971175,2020-07-14,Assembly,"Assembly Correction Committee: Held for Consideration",10,2,0,1,13
1204536,861477,2019-05-07,Assembly,"Assembly Health Committee: Favorable refer to committee Ways and Means",22,0,0,4,26
1204558,971498,2020-07-16,Assembly,"Assembly Transportation Committee: Held for Consideration",16,6,0,2,24
1204571,971601,2020-07-16,Assembly,"Assembly Real Property Taxation Committee: Held for Consideration",8,2,0,0,10
1204577,942062,2020-03-03,Assembly,"Assembly Children And Families Committee: Held for Consideration",10,5,0,1,16
1204597,971162,2020-07-14,Assembly,"Assembly Judiciary Committee: Held for Consideration",15,6,0,0,21
1204616,970931,2020-07-13,Assembly,"Assembly Agriculture Committee: Held for Consideration",14,5,0,2,21
1204651,972093,2020-07-17,Assembly,"Assembly Codes Committee: Held for Consideration",15,6,0,1,22
1204658,971981,2020-07-17,Assembly,"Assembly Ways And Means Committee: Held for Consideration",22,10,0,2,34
1204662,971138,2020-07-14,Assembly,"Assembly Insurance Committee: Held for Consideration",14,6,0,2,22
1204671,815015,2019-03-05,Senate,"Senate Civil Service and Pensions Committee Vote",7,0,0,0,7
1204671,887102,2019-06-19,Senate,"Senate Floor Vote - Final Passage",62,0,0,0,62
1204671,887103,2019-06-19,Senate,"Senate Rules Committee Vote",19,0,0,0,19
1204687,971911,2020-07-16,Assembly,"Assembly Governmental Operations Committee: Held for Consideration",10,4,0,0,14
1204693,971612,2020-07-16,Assembly,"Assembly Governmental Operations Committee: Held for Consideration",10,4,0,0,14
1204724,970927,2020-07-13,Assembly,"Assembly Agriculture Committee: Held for Consideration",13,6,0,2,21
1204749,820388,2019-03-12,Assembly,"Assembly Veterans' Affairs Committee: Favorable refer to committee Ways and Means",19,0,0,0,19
1204749,840376,2019-04-09,Assembly,"Assembly Ways And Means Committee: Favorable",32,0,0,3,35
1204757,972092,2020-07-17,Assembly,"Assembly Codes Committee: Held for Consideration",15,6,0,1,22
1204762,972100,2020-07-17,Assembly,"Assembly Codes Committee: Held for Consideration",15,6,0,1,22
1204787,882222,2019-06-13,Assembly,"Assembly Codes Committee: Held for Consideration",14,6,0,2,22
1204793,971079,2020-07-14,Assembly,"Assembly Environmental Conservation Committee: Held for Consideration",19,8,0,1,28
1204999,841476,2019-03-18,Senate,"Senate Mental Health and Developmental Disabilities Committee Vote",7,0,0,0,7
1204999,841477,2019-04-10,Senate,"Senate Floor Vote - Final Passage",56,3,0,3,62
1204999,881914,2019-06-14,Senate,"Senate Floor Vote - Final Passage",61,1,0,0,62
1205928,881029,2019-05-30,Senate,"Senate Cultural Affairs, Tourism, Parks And Recreation Committee Vote",7,0,0,0,7
1205928,881818,2019-06-12,Senate,"Senate Floor Vote - Final Passage",48,14,0,0,62
1205928,883441,2019-06-17,Assembly,"Assembly Floor Vote - Final Passage",138,10,0,2,150
1206006,861013,2019-04-30,Senate,"Senate Higher Education Committee Vote",11,0,0,0,11
1206006,861014,2019-05-08,Senate,"Senate Floor Vote - Final Passage",61,0,0,1,62
1206006,877269,2019-06-03,Assembly,"Assembly Floor Vote - Final Passage",140,1,0,9,150
1206031,855552,2019-04-30,Senate,"Senate Civil Service and Pensions Committee Vote",7,0,0,0,7
1206031,881995,2019-06-12,Senate,"Senate Floor Vote - Final Passage",62,0,0,0,62
1206031,881996,2019-06-12,Senate,"Senate Rules Committee Vote",19,0,0,0,19
1206031,884201,2019-06-18,Assembly,"Assembly Floor Vote - Final Passage",145,1,0,4,150
1206738,884064,2019-06-18,Assembly,"Assembly Floor Vote - Final Passage",106,41,0,3,150
1206738,884589,2019-06-18,Senate,"Senate Rules Committee Vote",17,2,0,0,19
1206738,885075,2019-06-18,Senate,"Senate Floor Vote - Final Passage",45,17,0,0,62
1206919,875421,2019-05-30,Senate,"Senate Judiciary Committee Vote",11,3,0,1,15
1207011,881539,2019-05-14,Senate,"Senate Judiciary Committee Vote",12,3,0,0,15
1207011,881819,2019-06-13,Senate,"Senate Floor Vote - Final Passage",40,22,0,0,62
1207011,903193,2020-01-14,Senate,"Senate Judiciary Committee Vote",10,5,0,0,15
1207011,973111,2020-07-21,Senate,"Senate Floor Vote - Final Passage",40,20,0,0,60
1207284,813540,2019-03-04,Senate,"Senate Local Government Committee Vote",7,0,0,0,7
1207465,876851,2019-05-07,Senate,"Senate Labor Committee Vote",12,0,0,1,13
1207465,876852,2019-06-03,Senate,"Senate Floor Vote - Final Passage",55,7,0,0,62
1207465,903424,2020-01-14,Senate,"Senate Labor Committee Vote",13,0,0,0,13
1207970,825025,2019-03-18,Senate,"Senate Agriculture Committee Vote",9,0,0,0,9
1207970,839837,2019-04-09,Senate,"Senate Finance Committee Vote",23,0,0,0,23
1207970,855377,2019-04-30,Senate,"Senate Floor Vote - Final Passage",62,0,0,0,62
1207970,884146,2019-06-18,Assembly,"Assembly Floor Vote - Final Passage",145,1,0,4,150
1209672,880031,2019-06-11,Senate,"Senate Rules Committee Vote",15,4,0,0,19
1209672,880453,2019-06-11,Senate,"Senate Floor Vote - Final Passage",47,14,0,1,62
1209672,972913,2020-07-20,Senate,"Senate Investigations and Government Operations Committee Vote",6,0,0,0,6
1209672,972914,2020-07-21,Senate,"Senate Finance Committee Vote",20,3,0,0,23
1209672,973411,2020-07-22,Senate,"Senate Floor Vote - Final Passage",52,8,0,0,60
1209672,973780,2020-07-21,Senate,"Senate Finance Committee Vote",20,3,0,0,23
1209714,839381,2019-04-09,Senate,"Senate Social Services Committee Vote",6,1,0,0,7
1209714,860879,2019-05-07,Senate,"Senate Finance Committee Vote",21,2,0,0,23
1209714,877664,2019-06-04,Senate,"Senate Floor Vote - Final Passage",42,20,0,0,62
1209714,878594,2019-06-05,Assembly,"Assembly Floor Vote - Final Passage",94,50,0,6,150
1209899,869891,2019-04-30,Senate,"Senate Health Committee Vote",15,0,0,0,15
1209899,869892,2019-05-22,Senate,"Senate Floor Vote - Final Passage",61,0,0,1,62
1209899,904756,2020-01-22,Senate,"Senate Health Committee Vote",15,0,0,0,15
1209899,933544,2020-02-24,Senate,"Senate Floor Vote - Final Passage",59,0,0,3,62
1209987,971403,2020-07-16,Assembly,"Assembly Governmental Employees Committee: Held for Consideration",10,4,0,0,14
1209991,882327,2019-06-14,Assembly,"Assembly Ways And Means Committee: Favorable refer to committee Rules",29,1,0,5,35
1209991,882328,2019-06-14,Assembly,"Assembly Governmental Employees Committee: Favorable refer to committee Ways and Means",13,0,0,1,14
1209991,882516,2019-06-17,Assembly,"Assembly Rules Committee: Favorable",26,0,0,5,31
1209995,943325,2020-03-03,Assembly,"Assembly Social Services Committee: Held for Consideration",12,4,0,1,17
1209999,877915,2019-06-05,Assembly,"Assembly Governmental Employees Committee: Favorable refer to committee Rules",14,0,0,0,14
1209999,880518,2019-06-11,Assembly,"Assembly Rules Committee: Favorable",25,0,0,6,31
1209999,882380,2019-06-14,Assembly,"Assembly Floor Vote - Final Passage",139,5,0,6,150
1209999,886324,2019-06-19,Senate,"Senate Floor Vote - Final Passage",59,3,0,0,62
1210008,878551,2019-06-04,Assembly,"Assembly Housing Committee: Held for Consideration",18,8,0,2,28
1210014,971189,2020-07-14,Assembly,"Assembly Correction Committee: Held for Consideration",10,2,0,1,13
1210019,874641,2019-05-29,Assembly,"Assembly Environmental Conservation Committee: Favorable",29,0,0,1,30
1210019,877839,2019-06-04,Assembly,"Assembly Floor Vote - Final Passage",142,5,0,3,150
1210019,882841,2019-06-17,Senate,"Senate Floor Vote - Final Passage",61,1,0,0,62
1210023,971671,2020-07-16,Assembly,"Assembly Real Property Taxation Committee: Held for Consideration",8,2,0,0,10
1210030,881434,2019-06-13,Assembly,"Assembly Codes Committee: Favorable refer to committee Rules",20,0,0,2,22
1210030,881435,2019-06-13,Assembly,"Assembly Health Committee: Favorable refer to committee Codes",25,1,0,0,26
1210030,882536,2019-06-17,Assembly,"Assembly Rules Committee: Favorable",26,0,0,5,31
1210030,883949,2019-06-18,Assembly,"Assembly Floor Vote - Final Passage",145,1,0,4,150
1210040,824175,2019-03-19,Assembly,"Assembly Judiciary Committee: Favorable refer to committee Codes",14,6,0,1,21
1210040,838992,2019-04-09,Assembly,"Assembly Codes Committee: Favorable",16,6,0,0,22
1210057,971263,2020-07-14,Assembly,"Assembly Education Committee: Held for Consideration",23,6,0,2,31
1210060,860278,2019-04-30,Senate,"Senate Higher Education Committee Vote",11,0,0,0,11
1210060,860279,2019-05-07,Senate,"Senate Floor Vote - Final Passage",59,2,0,1,62
1210070,972003,2020-07-17,Assembly,"Assembly Codes Committee: Held for Consideration",15,6,0,1,22
1210077,870070,2019-05-21,Assembly,"Assembly Governmental Operations Committee: Favorable refer to committee Codes",14,0,0,0,14
1210077,875101,2019-05-30,Assembly,"Assembly Codes Committee: Favorable refer to committee Ways and Means",19,0,0,3,22
1210077,882017,2019-06-14,Assembly,"Assembly Ways And Means Committee: Favorable refer to committee Rules",30,0,0,5,35
1210077,882417,2019-06-17,Assembly,"Assembly Rules Committee: Favorable",26,0,0,5,31
1210087,971935,2020-07-17,Assembly,"Assembly Codes Committee: Held for Consideration",15,6,0,1,22
1210094,878312,2019-06-04,Assembly,"Assembly Correction Committee: Favorable refer to committee Codes",10,3,0,0,13
1210110,878941,2019-06-06,Assembly,"Assembly Environmental Conservation Committee: Favorable refer to committee Rules",28,0,0,2,30
1210110,880516,2019-06-11,Assembly,"Assembly Rules Committee: Favorable",25,0,0,6,31
1210110,881600,2019-06-13,Assembly,"Assembly Floor Vote - Final Passage",145,0,0,5,150
1210110,882019,2019-06-14,Senate,"Senate Floor Vote - Final Passage",62,0,0,0,62
1210115,971188,2020-07-14,Assembly,"Assembly Correction Committee: Held for Consideration",10,2,0,1,13
1210120,971063,2020-07-14,Assembly,"Assembly Insurance Committee: Held for Consideration",14,6,0,2,22
1210126,879159,2019-06-05,Assembly,"Assembly Transportation Committee: Favorable refer to committee Rules",26,0,0,0,26
1210126,880536,2019-06-11,Assembly,"Assembly Rules Committee: Favorable",25,0,0,6,31
1210126,881606,2019-06-13,Assembly,"Assembly Floor Vote - Final Passage",139,1,0,10,150
1210126,886590,2019-06-19,Senate,"Senate Floor Vote - Final Passage",62,0,0,0,62
1210134,824199,2019-03-19,Assembly,"Assembly Judiciary Committee: Favorable refer to committee Codes",14,6,0,1,21
1210134,857547,2019-04-30,Assembly,"Assembly Codes Committee: Favorable",14,6,0,2,22
1210158,971674,2020-07-16,Assembly,"Assembly Real Property Taxation Committee: Held for Consideration",8,2,0,0,10
1210183,810928,2019-02-28,Assembly,"Assembly Health Committee: Favorable refer to committee Ways and Means",25,0,0,1,26
1210183,814270,2019-03-05,Assembly,"Assembly Rules Committee: Favorable",27,0,0,4,31
1210183,815736,2019-03-06,Assembly,"Assembly Floor Vote - Final Passage",146,0,0,4,150
1210183,820260,2019-03-05,Assembly,"Assembly Rules Committee: Favorable",27,0,0,4,31
1210185,971273,2020-07-14,Assembly,"Assembly Education Committee: Held for Consideration",23,6,0,2,31
1210192,971965,2020-07-17,Assembly,"Assembly Ways And Means Committee: Held for Consideration",22,10,0,2,34
1210199,971134,2020-07-14,Assembly,"Assembly Insurance Committee: Held for Consideration",14,6,0,2,22
1210208,860706,2019-04-30,Senate,"Senate Civil Service and Pensions Committee Vote",7,0,0,0,7
1210208,860707,2019-05-07,Senate,"Senate Floor Vote - Final Passage",60,1,0,1,62
1210208,880621,2019-06-11,Assembly,"Assembly Floor Vote - Final Passage",138,4,0,8,150
1210211,877545,2019-06-04,Assembly,"Assembly Real Property Taxation Committee: Favorable refer to committee Ways and Means",10,0,0,0,10
1210211,879373,2019-06-06,Assembly,"Assembly Ways And Means Committee: Favorable refer to committee Rules",31,0,0,4,35
1210211,881330,2019-06-13,Assembly,"Assembly Rules Committee: Favorable",26,0,0,5,31
1210211,883958,2019-06-18,Assembly,"Assembly Floor Vote - Final Passage",145,1,0,4,150
1210211,885588,2019-06-18,Senate,"Senate Floor Vote - Final Passage",59,3,0,0,62
1210225,971657,2020-07-16,Assembly,"Assembly Real Property Taxation Committee: Held for Consideration",8,2,0,0,10
1210235,878719,2019-06-06,Assembly,"Assembly Environmental Conservation Committee: Held for Consideration",21,7,0,2,30
1210273,833861,2019-04-02,Assembly,"Assembly Health Committee: Favorable refer to committee Ways and Means",24,0,0,2,26
1210273,863848,2019-05-14,Assembly,"Assembly Ways And Means Committee: Favorable",32,0,0,3,35
1210273,870493,2019-05-22,Assembly,"Assembly Floor Vote - Final Passage",146,0,0,4,150
1210273,877662,2019-06-04,Senate,"Senate Floor Vote - Final Passage",62,0,0,0,62
1210284,971106,2020-07-14,Assembly,"Assembly Environmental Conservation Committee: Held for Consideration",19,8,0,1,28
1210330,882195,2019-06-13,Assembly,"Assembly Codes Committee: Held for Consideration",14,6,0,2,22
1210338,970795,2020-07-13,Assembly,"Assembly Agriculture Committee: Favorable refer to committee Rules",19,0,0,2,21
1210338,972207,2020-07-20,Assembly,"Assembly Rules Committee: Favorable",27,0,0,3,30
1210341,884326,2019-05-29,Senate,"Senate Civil Service and Pensions Committee Vote",7,0,0,0,7
1210341,885396,2019-06-19,Assembly,"Assembly Floor Vote - Final Passage",147,0,0,3,150
1210341,886623,2019-06-19,Senate,"Senate Floor Vote - Final Passage",62,0,0,0,62
1210345,970792,2020-07-13,Assembly,"Assembly Health Committee: Held for Consideration",18,6,0,2,26
1210361,970780,2020-07-13,Assembly,"Assembly Health Committee: Held for Consideration",18,6,0,2,26
1210374,972108,2020-07-17,Assembly,"Assembly Ways And Means Committee: Held for Consideration",22,10,0,2,34
1210387,972091,2020-07-17,Assembly,"Assembly Codes Committee: Held for Consideration",15,6,0,1,22
1210389,809749,2019-02-27,Assembly,"Assembly Real Property Taxation Committee: Favorable refer to committee Ways and Means",9,0,0,1,10
1210389,840073,2019-04-09,Assembly,"Assembly Ways And Means Committee: Favorable",26,6,0,3,35
1210389,857463,2019-05-01,Assembly,"Assembly Floor Vote - Final Passage",134,7,0,9,150
1210389,881689,2019-06-13,Senate,"Senate Floor Vote - Final Passage",62,0,0,0,62
1210409,878425,2019-06-05,Assembly,"Assembly Transportation Committee: Favorable refer to committee Codes",26,0,0,0,26
1210409,880257,2019-06-11,Assembly,"Assembly Codes Committee: Favorable refer to committee Rules",22,0,0,0,22
1210409,881335,2019-06-13,Assembly,"Assembly Rules Committee: Favorable",26,0,0,5,31
1210409,884481,2019-06-18,Assembly,"Assembly Floor Vote - Final Passage",146,0,0,4,150
1210475,833723,2019-04-02,Assembly,"Assembly Ways And Means Committee: Favorable",28,2,0,5,35
1210475,833724,2019-04-02,Assembly,"Assembly Local Governments Committee: Favorable refer to committee Ways and Means",17,0,0,2,19
1210475,840224,2019-04-09,Assembly,"Assembly Floor Vote - Final Passage",146,0,0,4,150
1210475,971709,2020-07-16,Assembly,"Assembly Local Governments Committee: Favorable refer to committee Ways and Means",19,0,0,1,20
1210475,971761,2020-07-17,Assembly,"Assembly Ways And Means Committee: Favorable refer to committee Rules",32,0,0,2,34
1210475,973024,2020-07-22,Assembly,"Assembly Rules Committee: Favorable",25,0,0,5,30
1210475,973673,2020-07-23,Senate,"Senate Floor Vote - Final Passage",42,18,0,0,60
1211233,833482,2019-04-02,Assembly,"Assembly Ways And Means Committee: Favorable",21,9,0,5,35
1211265,881432,2019-04-29,Senate,"Senate Insurance Committee Vote",11,0,0,0,11
1211265,882118,2019-06-13,Senate,"Senate Floor Vote - Final Passage",62,0,0,0,62
1211265,884159,2019-06-18,Assembly,"Assembly Floor Vote - Final Passage",146,0,0,4,150
1211305,885164,2019-06-19,Senate,"Senate Rules Committee Vote",19,0,0,0,19
1211305,886471,2019-06-19,Senate,"Senate Floor Vote - Final Passage",62,0,0,0,62
1211305,964116,2020-06-09,Senate,"Senate Floor Vote - Final Passage",62,0,0,0,62
1211305,966190,2020-05-28,Senate,"Senate Rules Committee Vote",19,0,0,0,19
1211305,966191,2020-06-08,Senate,"Senate Transportation Committee Vote",15,0,0,0,15
1211305,973446,2020-07-24,Assembly,"Assembly Floor Vote - Final Passage",141,0,0,4,145
1211316,863958,2019-05-13,Senate,"Senate Investigations and Government Operations Committee Vote",7,0,0,0,7
1211316,868429,2019-05-21,Senate,"Senate Finance Committee Vote",23,0,0,0,23
1211316,878069,2019-06-05,Senate,"Senate Floor Vote - Final Passage",62,0,0,0,62
1211316,902649,2020-01-14,Senate,"Senate Investigations and Government Operations Committee Vote",7,0,0,0,7
1211316,964109,2020-06-09,Senate,"Senate Floor Vote - Final Passage",62,0,0,0,62
1211316,966322,2020-05-28,Senate,"Senate Rules Committee Vote",19,0,0,0,19
1211316,966323,2020-06-08,Senate,"Senate Finance Committee Vote",23,0,0,0,23
1211376,829125,2019-03-26,Assembly,"Assembly Housing Committee: Favorable refer to committee Codes",19,8,0,1,28
1211376,839707,2019-04-09,Assembly,"Assembly Codes Committee: Favorable",16,6,0,0,22
1211376,864944,2019-05-15,Assembly,"Assembly Floor Vote - Final Passage",93,47,0,10,150
1211376,875386,2019-05-30,Senate,"Senate Floor Vote - Final Passage",39,19,0,4,62
1211451,943184,2020-03-03,Assembly,"Assembly Mental Health Committee: Held for Consideration",9,3,0,1,13
1211456,886571,2019-06-19,Senate,"Senate Floor Vote - Final Passage",43,19,0,0,62
1211456,887387,2019-06-19,Senate,"Senate Rules Committee Vote",17,2,0,0,19
1211459,863978,2019-05-14,Senate,"Senate Education Committee Vote",15,0,0,0,15
1211459,881952,2019-06-12,Senate,"Senate Floor Vote - Final Passage",62,0,0,0,62
1211459,881953,2019-06-12,Senate,"Senate Rules Committee Vote",19,0,0,0,19
1211459,942827,2020-03-03,Senate,"Senate Education Committee Vote",15,0,0,0,15
1211462,971685,2020-07-16,Assembly,"Assembly Governmental Operations Committee: Held for Consideration",10,4,0,0,14
1211465,971111,2020-07-14,Assembly,"Assembly Environmental Conservation Committee: Held for Consideration",19,8,0,1,28
1211468,860935,2019-05-07,Assembly,"Assembly Governmental Employees Committee: Favorable refer to committee Ways and Means",14,0,0,0,14
1211468,879216,2019-06-05,Assembly,"Assembly Ways And Means Committee: Favorable refer to committee Rules",30,1,0,4,35
1211468,880547,2019-06-11,Assembly,"Assembly Rules Committee: Favorable",25,0,0,6,31
1211468,884273,2019-06-18,Assembly,"Assembly Floor Vote - Final Passage",138,10,0,2,150
1211468,886305,2019-06-19,Senate,"Senate Floor Vote - Final Passage",62,0,0,0,62
1211490,839714,2019-04-09,Assembly,"Assembly Transportation Committee: Favorable refer to committee Codes",21,2,0,2,25
1211492,971943,2020-07-17,Assembly,"Assembly Ways And Means Committee: Held for Consideration",22,10,0,2,34
1211505,971621,2020-07-16,Assembly,"Assembly Governmental Operations Committee: Held for Consideration",10,4,0,0,14
1211507,972070,2020-07-17,Assembly,"Assembly Ways And Means Committee: Held for Consideration",22,10,0,2,34
1211516,971969,2020-07-17,Assembly,"Assembly Codes Committee: Held for Consideration",15,6,0,1,22
1211520,971800,2020-07-16,Assembly,"Assembly Governmental Employees Committee: Held for Consideration",9,5,0,0,14
1211534,971345,2020-07-15,Assembly,"Assembly Veterans' Affairs Committee: Held for Consideration",12,5,0,2,19
1211538,972088,2020-07-17,Assembly,"Assembly Ways And Means Committee: Held for Consideration",22,10,0,2,34
1211548,971595,2020-07-16,Assembly,"Assembly Governmental Operations Committee: Held for Consideration",10,4,0,0,14
1211551,971963,2020-07-17,Assembly,"Assembly Ways And Means Committee: Held for Consideration",22,10,0,2,34
1211566,972056,2020-07-17,Assembly,"Assembly Ways And Means Committee: Held for Consideration",22,10,0,2,34
1211573,878564,2019-06-04,Assembly,"Assembly Tourism, Arts And Sports Development Committee: Favorable refer to committee Ways and Means",19,0,0,1,20
1211573,878565,2019-06-05,Assembly,"Assembly Ways And Means Committee: Favorable refer to committee Rules",30,1,0,4,35
1211573,880535,2019-06-11,Assembly,"Assembly Rules Committee: Favorable",25,0,0,6,31
1211578,971813,2020-07-16,Assembly,"Assembly Governmental Employees Committee: Held for Consideration",10,4,0,0,14
1211588,970783,2020-07-13,Assembly,"Assembly Health Committee: Held for Consideration",18,6,0,2,26
1211601,971796,2020-07-16,Assembly,"Assembly Governmental Employees Committee: Held for Consideration",9,5,0,0,14
1211615,972122,2020-07-17,Assembly,"Assembly Ways And Means Committee: Held for Consideration",22,10,0,2,34
1211624,972084,2020-07-17,Assembly,"Assembly Ways And Means Committee: Held for Consideration",22,10,0,2,34
1211627,861591,2019-05-07,Assembly,"Assembly Transportation Committee: Favorable refer to committee Ways and Means",23,0,0,2,25
1211627,869024,2019-05-21,Assembly,"Assembly Ways And Means Committee: Favorable",32,0,0,3,35
1211630,972104,2020-07-17,Assembly,"Assembly Ways And Means Committee: Held for Consideration",22,10,0,2,34
1211633,882215,2019-06-13,Assembly,"Assembly Codes Committee: Held for Consideration",14,6,0,2,22
1211640,878283,2019-06-05,Assembly,"Assembly Insurance Committee: Favorable refer to committee Codes",24,0,0,0,24
1211640,881423,2019-06-13,Assembly,"Assembly Codes Committee: Favorable refer to committee Rules",20,0,0,2,22
1211640,882526,2019-06-17,Assembly,"Assembly Rules Committee: Favorable",26,0,0,5,31
1211649,971314,2020-07-14,Assembly,"Assembly Higher Education Committee: Held for Consideration",16,9,0,0,25
1211651,971619,2020-07-16,Assembly,"Assembly Governmental Operations Committee: Held for Consideration",10,4,0,0,14
1211655,972025,2020-07-17,Assembly,"Assembly Ways And Means Committee: Held for Consideration",22,10,0,2,34
1211660,971988,2020-07-17,Assembly,"Assembly Ways And Means Committee: Held for Consideration",22,10,0,2,34
1211689,972880,2020-07-22,Assembly,"Assembly Rules Committee: Favorable",29,0,0,1,30
1211689,972881,2020-07-22,Assembly,"Assembly Ways And Means Committee: Favorable refer to committee Rules",31,1,0,2,34
1211700,971104,2020-07-14,Assembly,"Assembly Environmental Conservation Committee: Held for Consideration",19,8,0,1,28
1211709,809897,2019-02-27,Assembly,"Assembly Education Committee: Favorable refer to committee Codes",28,0,0,3,31
1211709,814214,2019-03-05,Assembly,"Assembly Codes Committee: Favorable",22,0,0,0,22
1211709,822596,2019-03-14,Assembly,"Assembly Floor Vote - Final Passage",134,0,0,16,150
1211709,827446,2019-03-25,Senate,"Senate Floor Vote - Final Passage",62,0,0,0,62
1211712,971404,2020-07-16,Assembly,"Assembly Local Governments Committee: Held for Consideration",14,5,0,1,20
1211733,971261,2020-07-14,Assembly,"Assembly Education Committee: Held for Consideration",23,6,0,2,31
1211736,820368,2019-03-12,Assembly,"Assembly Local Governments Committee: Favorable",18,0,0,1,19
1211736,826543,2019-03-20,Assembly,"Assembly Floor Vote - Final Passage",143,1,0,6,150
1211736,884870,2019-06-18,Senate,"Senate Floor Vote - Final Passage",62,0,0,0,62
1211745,813920,2019-03-05,Senate,"Senate Education Committee Vote",14,0,0,1,15
1211745,839419,2019-04-09,Senate,"Senate Finance Committee Vote",23,0,0,0,23
1211745,881999,2019-06-13,Senate,"Senate Floor Vote - Final Passage",62,0,0,0,62
1211745,918508,2020-02-10,Senate,"Senate Education Committee Vote",15,0,0,0,15
1211745,935412,2020-02-25,Senate,"Senate Finance Committee Vote",22,0,0,1,23
1211745,940300,2020-03-02,Senate,"Senate Floor Vote - Final Passage",61,0,0,1,62
1211745,972324,2020-07-20,Assembly,"Assembly Floor Vote - Final Passage",141,0,0,4,145
1211761,882207,2019-06-13,Assembly,"Assembly Codes Committee: Held for Consideration",14,6,0,2,22
1211776,971637,2020-07-16,Assembly,"Assembly Real Property Taxation Committee: Held for Consideration",8,2,0,0,10
1211779,971624,2020-07-16,Assembly,"Assembly Governmental Operations Committee: Held for Consideration",10,4,0,0,14
1211793,881989,2019-06-12,Senate,"Senate Floor Vote - Final Passage",62,0,0,0,62
1211793,881990,2019-06-12,Senate,"Senate Rules Committee Vote",19,0,0,0,19
1211793,886538,2019-06-21,Assembly,"Assembly Floor Vote - Final Passage",144,0,0,6,150
1211795,971328,2020-07-14,Assembly,"Assembly Higher Education Committee: Held for Consideration",24,1,0,0,25
1211798,971603,2020-07-16,Assembly,"Assembly Governmental Operations Committee: Held for Consideration",10,4,0,0,14
1211806,971792,2020-07-16,Assembly,"Assembly Governmental Employees Committee: Held for Consideration",9,5,0,0,14
1211824,972099,2020-07-17,Assembly,"Assembly Ways And Means Committee: Held for Consideration",22,10,0,2,34
1211847,934745,2020-02-25,Assembly,"Assembly Housing Committee: Favorable refer to committee Codes",21,5,0,2,28
1211847,940749,2020-03-03,Assembly,"Assembly Codes Committee: Favorable",17,4,0,1,22
1211850,970924,2020-07-13,Assembly,"Assembly Children And Families Committee: Held for Consideration",11,4,0,1,16
1211857,970793,2020-07-13,Assembly,"Assembly Health Committee: Held for Consideration",18,6,0,2,26
1211864,971797,2020-07-16,Assembly,"Assembly Local Governments Committee: Held for Consideration",15,4,0,1,20
1211878,970788,2020-07-13,Assembly,"Assembly Economic Development Committee: Held for Consideration",17,7,0,1,25
1211886,971310,2020-07-14,Assembly,"Assembly Higher Education Committee: Held for Consideration",24,1,0,0,25
1211892,878726,2019-06-06,Assembly,"Assembly Environmental Conservation Committee: Favorable refer to committee Rules",27,1,0,2,30
1211892,880524,2019-06-11,Assembly,"Assembly Rules Committee: Favorable",25,0,0,6,31
1211898,972863,2020-07-22,Assembly,"Assembly Codes Committee: Favorable refer to committee Rules",21,0,0,1,22
1211898,973018,2020-07-22,Assembly,"Assembly Rules Committee: Favorable",29,0,0,1,30
1211918,973338,2020-07-22,Senate,"Senate Rules Committee Vote",18,1,0,0,19
1211918,973509,2020-07-22,Senate,"Senate Floor Vote - Final Passage",58,2,0,0,60
1211929,971332,2020-07-14,Assembly,"Assembly Higher Education Committee: Held for Consideration",18,7,0,0,25
1211938,971338,2020-07-14,Assembly,"Assembly Higher Education Committee: Held for Consideration",16,9,0,0,25
1211944,970803,2020-07-13,Assembly,"Assembly Health Committee: Held for Consideration",18,6,0,2,26
1211947,970760,2020-07-13,Assembly,"Assembly Economic Development Committee: Held for Consideration",17,7,0,1,25
1211949,971634,2020-07-16,Assembly,"Assembly Governmental Operations Committee: Held for Consideration",10,4,0,0,14
1211956,880718,2019-06-12,Assembly,"Assembly Local Governments Committee: Favorable refer to committee Ways and Means",17,0,0,2,19
1211956,881449,2019-06-13,Assembly,"Assembly Ways And Means Committee: Favorable refer to committee Rules",29,0,0,6,35
1211956,882543,2019-06-17,Assembly,"Assembly Rules Committee: Favorable",26,0,0,5,31
1211959,881786,2019-06-14,Assembly,"Assembly Transportation Committee: Favorable refer to committee Ways and Means",24,0,0,1,25
1211959,884874,2019-06-19,Assembly,"Assembly Rules Committee: Favorable",28,0,0,3,31
1211959,884875,2019-06-19,Assembly,"Assembly Ways And Means Committee: Favorable refer to committee Rules",33,0,0,2,35
1211967,829826,2019-03-26,Senate,"Senate Rules Committee Vote",19,0,0,0,19
1211967,829827,2019-03-27,Senate,"Senate Floor Vote - Final Passage",51,10,0,1,62
1211967,864951,2019-05-15,Assembly,"Assembly Floor Vote - Final Passage",141,0,0,9,150
1211974,815569,2019-03-06,Assembly,"Assembly Corporations, Authorities And Commissions Committee: Favorable refer to committee Codes",20,4,0,2,26
1211974,839019,2019-04-09,Assembly,"Assembly Codes Committee: Favorable",16,6,0,0,22
1211980,971264,2020-07-14,Assembly,"Assembly Education Committee: Held for Consideration",23,6,0,2,31
1211986,971056,2020-07-14,Assembly,"Assembly Judiciary Committee: Held for Consideration",15,6,0,0,21
1211991,948692,2020-03-10,Assembly,"Assembly Governmental Operations Committee: Held for Consideration",10,4,0,0,14
1212010,971146,2020-07-14,Assembly,"Assembly Insurance Committee: Favorable refer to committee Codes",18,2,0,2,22
1212010,971834,2020-07-17,Assembly,"Assembly Codes Committee: Favorable refer to committee Rules",21,0,0,1,22
1212010,972205,2020-07-20,Assembly,"Assembly Rules Committee: Favorable",25,2,0,3,30
1212014,856967,2019-03-18,Senate,"Senate Mental Health And Developmental Disabilities Committee Vote",7,0,0,0,7
1212014,856968,2019-05-01,Senate,"Senate Floor Vote - Final Passage",62,0,0,0,62
1212014,902916,2020-01-15,Senate,"Senate Mental Health and Developmental Disabilities Committee Vote",7,0,0,0,7
1212014,918559,2020-02-10,Senate,"Senate Floor Vote - Final Passage",61,0,0,1,62
1212018,857539,2019-04-30,Assembly,"Assembly Codes Committee: Favorable",17,3,0,2,22
1212021,971680,2020-07-16,Assembly,"Assembly Real Property Taxation Committee: Held for Consideration",8,2,0,0,10
1212024,971254,2020-07-14,Assembly,"Assembly Education Committee: Held for Consideration",23,6,0,2,31
1212032,971635,2020-07-16,Assembly,"Assembly Governmental Operations Committee: Held for Consideration",10,4,0,0,14
1212061,970775,2020-07-13,Assembly,"Assembly Health Committee: Held for Consideration",18,6,0,2,26
1212071,829788,2019-03-26,Assembly,"Assembly Correction Committee: Favorable refer to committee Ways and Means",10,3,0,0,13
1212088,971991,2020-07-17,Assembly,"Assembly Ways And Means Committee: Held for Consideration",22,10,0,2,34
1212091,971623,2020-07-16,Assembly,"Assembly Governmental Operations Committee: Held for Consideration",10,4,0,0,14
1212094,840827,2019-04-09,Assembly,"Assembly Transportation Committee: Held for Consideration",16,7,0,2,25
1212103,970921,2020-07-13,Assembly,"Assembly Agriculture Committee: Held for Consideration",14,5,0,2,21
1212147,811106,2019-02-28,Assembly,"Assembly Correction Committee: Favorable refer to committee Ways and Means",9,3,0,1,13
1212147,879271,2019-06-06,Assembly,"Assembly Ways And Means Committee: Favorable refer to committee Rules",21,10,0,4,35
1212224,823447,2019-03-18,Assembly,"Assembly Codes Committee: Favorable",15,6,0,1,22
1212224,841907,2019-04-10,Assembly,"Assembly Floor Vote - Final Passage",141,0,0,9,150
1212224,863293,2019-05-13,Senate,"Senate Floor Vote - Final Passage",60,0,0,2,62
1212238,971117,2020-07-14,Assembly,"Assembly Environmental Conservation Committee: Held for Consideration",19,8,0,1,28
1212300,971131,2020-07-14,Assembly,"Assembly Insurance Committee: Held for Consideration",14,6,0,2,22
1212902,886015,2019-05-21,Senate,"Senate Higher Education Committee Vote",11,0,0,0,11
1212902,886506,2019-06-20,Senate,"Senate Floor Vote - Final Passage",62,0,0,0,62
1212902,941737,2020-03-03,Senate,"Senate Higher Education Committee Vote",11,0,0,0,11
1212933,810361,2019-02-27,Assembly,"Assembly Higher Education Committee: Favorable refer to committee Codes",25,0,0,1,26
1212933,814225,2019-03-05,Assembly,"Assembly Codes Committee: Favorable",22,0,0,0,22
1212966,885097,2019-06-18,Senate,"Senate Floor Vote - Final Passage",43,19,0,0,62
1212966,886394,2019-06-18,Senate,"Senate Rules Committee Vote",15,4,0,0,19
1213000,885408,2019-06-19,Senate,"Senate Rules Committee Vote",19,0,0,0,19
1213000,885409,2019-06-19,Assembly,"Assembly Floor Vote - Final Passage",147,0,0,3,150
1213000,886615,2019-06-19,Senate,"Senate Floor Vote - Final Passage",62,0,0,0,62
1213023,855663,2019-04-30,Senate,"Senate Civil Service and Pensions Committee Vote",7,0,0,0,7
1213023,861001,2019-05-07,Senate,"Senate Finance Committee Vote",23,0,0,0,23
1213023,867788,2019-05-20,Senate,"Senate Floor Vote - Final Passage",60,0,0,2,62
1213023,883142,2019-06-17,Assembly,"Assembly Floor Vote - Final Passage",145,3,0,2,150
1213027,837893,2019-03-26,Senate,"Senate Rules Committee Vote",18,1,0,0,19
1213027,837894,2019-04-08,Senate,"Senate Floor Vote - Final Passage",59,0,0,3,62
1213027,876681,2019-06-03,Senate,"Senate Floor Vote - Final Passage",53,9,0,0,62
1213027,878152,2019-06-04,Assembly,"Assembly Floor Vote - Final Passage",145,2,0,3,150
1213044,869173,2019-05-21,Senate,"Senate Rules Committee Vote",19,0,0,0,19
1213044,869174,2019-05-22,Senate,"Senate Floor Vote - Final Passage",61,0,0,1,62
1213044,972708,2020-07-20,Senate,"Senate Civil Service and Pensions Committee Vote",7,0,0,0,7
1213044,972709,2020-07-21,Senate,"Senate Finance Committee Vote",23,0,0,0,23
1213044,973249,2020-07-22,Senate,"Senate Rules Committee Vote",19,0,0,0,19
1213044,973655,2020-07-22,Senate,"Senate Floor Vote - Final Passage",60,0,0,0,60
1213054,902652,2020-01-14,Senate,"Senate Health Committee Vote",14,0,0,0,14
1213256,867372,2019-03-05,Senate,"Senate Civil Service And Pensions Committee Vote",7,0,0,0,7
1213256,867373,2019-05-20,Senate,"Senate Floor Vote - Final Passage",60,0,0,2,62
1213302,881780,2019-06-12,Senate,"Senate Floor Vote - Final Passage",62,0,0,0,62
1213302,881781,2019-06-12,Senate,"Senate Rules Committee Vote",19,0,0,0,19
1213329,886798,2019-06-20,Senate,"Senate Floor Vote - Final Passage",62,0,0,0,62
1213329,887309,2019-06-20,Senate,"Senate Rules Committee Vote",19,0,0,0,19
1213395,859545,2019-04-08,Senate,"Senate Corporations, Authorities and Commissions Committee Vote",7,0,0,0,7
1213395,859546,2019-05-06,Senate,"Senate Floor Vote - Final Passage",61,0,0,1,62
1213395,883145,2019-06-17,Assembly,"Assembly Floor Vote - Final Passage",148,0,0,2,150
1213456,881987,2019-06-12,Senate,"Senate Floor Vote - Final Passage",62,0,0,0,62
1213456,881988,2019-06-12,Senate,"Senate Rules Committee Vote",19,0,0,0,19
1213456,913885,2020-02-03,Senate,"Senate Domestic Animal Welfare Committee Vote",6,0,0,1,7
1213587,879110,2019-05-14,Senate,"Senate Civil Service and Pensions Committee Vote",6,0,0,1,7
1213587,879111,2019-06-06,Senate,"Senate Floor Vote - Final Passage",61,0,0,1,62
1213587,885122,2019-06-19,Assembly,"Assembly Floor Vote - Final Passage",146,2,0,2,150
1213610,884609,2019-06-18,Senate,"Senate Rules Committee Vote",18,1,0,0,19
1213610,885088,2019-06-18,Senate,"Senate Floor Vote - Final Passage",59,3,0,0,62
1213610,886413,2019-06-21,Assembly,"Assembly Floor Vote - Final Passage",136,5,0,9,150
1214575,884580,2019-06-18,Senate,"Senate Rules Committee Vote",16,3,0,0,19
1214575,885064,2019-06-18,Senate,"Senate Floor Vote - Final Passage",48,14,0,0,62
1214575,886328,2019-06-20,Assembly,"Assembly Floor Vote - Final Passage",142,4,0,4,150
1214598,881754,2019-06-12,Senate,"Senate Floor Vote - Final Passage",62,0,0,0,62
1214598,881755,2019-06-12,Senate,"Senate Rules Committee Vote",19,0,0,0,19
1214598,882785,2019-06-17,Senate,"Senate Floor Vote - Final Passage",62,0,0,0,62
1214598,886179,2019-06-21,Assembly,"Assembly Floor Vote - Final Passage",144,0,0,6,150
1214608,881489,2019-05-07,Senate,"Senate Crime Victims, Crime and Correction Committee Vote",7,0,0,0,7
1214608,881490,2019-05-21,Senate,"Senate Finance Committee Vote",23,0,0,0,23
1214608,881745,2019-06-13,Senate,"Senate Floor Vote - Final Passage",62,0,0,0,62
1214608,884281,2019-06-18,Assembly,"Assembly Floor Vote - Final Passage",146,0,0,4,150
1214624,855582,2019-04-30,Senate,"Senate Civil Service and Pensions Committee Vote",7,0,0,0,7
1214624,877983,2019-06-05,Senate,"Senate Floor Vote - Final Passage",62,0,0,0,62
1214624,877984,2019-06-05,Senate,"Senate Rules Committee Vote",19,0,0,0,19
1214689,814886,2019-03-06,Assembly,"Assembly Health Committee: Favorable refer to committee Codes",17,8,0,1,26
1214689,819200,2019-03-12,Assembly,"Assembly Codes Committee: Favorable refer to committee Ways and Means",14,7,0,1,22
1214711,867301,2019-05-07,Senate,"Senate Labor Committee Vote",12,0,0,1,13
1214711,867827,2019-05-20,Senate,"Senate Floor Vote - Final Passage",60,0,0,2,62
1214711,903447,2020-01-14,Senate,"Senate Labor Committee Vote",13,0,0,0,13
1214711,972500,2020-07-21,Senate,"Senate Floor Vote - Final Passage",60,0,0,0,60
1214715,815565,2019-03-06,Assembly,"Assembly Health Committee: Favorable refer to committee Codes",17,8,0,1,26
1214724,867671,2019-03-12,Senate,"Senate Internet And Technology Committee Vote",7,0,0,0,7
1214724,867672,2019-05-20,Senate,"Senate Floor Vote - Final Passage",59,1,0,2,62
1214724,877226,2019-06-03,Assembly,"Assembly Floor Vote - Final Passage",141,1,0,8,150
1214740,809877,2019-02-27,Assembly,"Assembly Rules Committee: Favorable",27,0,0,4,31
1214740,809878,2019-02-27,Assembly,"Assembly Codes Committee: Favorable refer to committee Rules",21,0,0,1,22
1214740,809879,2019-02-27,Assembly,"Assembly Governmental Operations Committee: Favorable refer to committee Codes",13,0,0,1,14
1214740,811054,2019-02-27,Assembly,"Assembly Floor Vote - Final Passage",141,1,0,8,150
1214740,823517,2019-03-18,Senate,"Senate Floor Vote - Final Passage",62,0,0,0,62
1214842,869318,2019-05-14,Senate,"Senate Civil Service and Pensions Committee Vote",6,0,0,1,7
1214842,869319,2019-05-22,Senate,"Senate Floor Vote - Final Passage",61,0,0,1,62
1215006,881105,2019-05-20,Senate,"Senate Local Government Committee Vote",7,0,0,0,7
1215006,882091,2019-06-12,Senate,"Senate Floor Vote - Final Passage",61,1,0,0,62
1215006,906629,2020-01-27,Senate,"Senate Local Government Committee Vote",7,0,0,0,7
1215006,921162,2020-02-11,Senate,"Senate Floor Vote - Final Passage",61,1,0,0,62
1215015,885955,2019-06-19,Senate,"Senate Rules Committee Vote",19,0,0,0,19
1215015,886455,2019-06-21,Assembly,"Assembly Floor Vote - Final Passage",144,0,0,6,150
1215015,886792,2019-06-20,Senate,"Senate Floor Vote - Final Passage",61,1,0,0,62
1215041,810013,2019-02-27,Assembly,"Assembly Rules Committee: Favorable",21,6,0,4,31
1215041,810014,2019-02-27,Assembly,"Assembly Ways And Means Committee: Favorable refer to committee Rules",22,8,0,5,35
1215041,810015,2019-02-27,Assembly,"Assembly Codes Committee: Favorable refer to committee Ways and Means",15,6,0,1,22
1215041,810016,2019-02-27,Assembly,"Assembly Governmental Operations Committee: Favorable refer to committee Codes",9,4,0,1,14
1215041,811112,2019-02-27,Assembly,"Assembly Floor Vote - Final Passage",101,41,0,8,150
1215109,860759,2019-04-30,Senate,"Senate Finance Committee Vote",23,0,0,0,23
1215109,860760,2019-05-07,Senate,"Senate Floor Vote - Final Passage",61,0,0,1,62
1215109,904434,2020-01-22,Senate,"Senate Finance Committee Vote",23,0,0,0,23
1215285,877655,2019-05-13,Senate,"Senate Transportation Committee Vote",14,0,0,1,15
1215285,877656,2019-06-04,Senate,"Senate Floor Vote - Final Passage",62,0,0,0,62
1215285,915014,2020-02-04,Senate,"Senate Transportation Committee Vote",15,0,0,0,15
1215285,932004,2020-02-24,Senate,"Senate Floor Vote - Final Passage",59,0,0,3,62
1215285,973748,2020-07-24,Assembly,"Assembly Floor Vote - Final Passage",141,0,0,4,145
1215306,810331,2019-02-27,Assembly,"Assembly Election Law Committee: Favorable",13,0,0,3,16
1215306,816812,2019-03-07,Assembly,"Assembly Floor Vote - Final Passage",139,2,0,9,150
1215306,819887,2019-03-12,Senate,"Senate Floor Vote - Final Passage",53,8,0,1,62
1215337,841393,2019-03-26,Senate,"Senate Investigations and Government Operations Committee Vote",7,0,0,0,7
1215337,841394,2019-04-10,Senate,"Senate Floor Vote - Final Passage",51,8,0,3,62
1215337,902621,2020-01-14,Senate,"Senate Investigations and Government Operations Committee Vote",7,0,0,0,7
1216264,813723,2019-03-05,Senate,"Senate Education Committee Vote",14,0,0,1,15
1216264,863979,2019-05-14,Senate,"Senate Finance Committee Vote",22,0,0,1,23
1216264,869305,2019-05-22,Senate,"Senate Floor Vote - Final Passage",61,0,0,1,62
1216264,886802,2019-06-21,Assembly,"Assembly Floor Vote - Final Passage",144,0,0,6,150
1216285,875565,2019-05-30,Senate,"Senate Judiciary Committee Vote",13,1,0,1,15
1216285,934037,2020-02-25,Senate,"Senate Judiciary Committee Vote",13,1,0,1,15
1216323,883373,2019-04-30,Senate,"Senate Education Committee Vote",15,0,0,0,15
1216323,885019,2019-06-18,Senate,"Senate Floor Vote - Final Passage",61,1,0,0,62
1216323,902645,2020-01-14,Senate,"Senate Education Committee Vote",15,0,0,0,15
1216368,823715,2019-03-11,Senate,"Senate Children and Families Committee Vote",7,0,0,0,7
1216368,823716,2019-03-18,Senate,"Senate Floor Vote - Final Passage",62,0,0,0,62
1216368,916256,2020-02-04,Senate,"Senate Children and Families Committee Vote",7,0,0,0,7
1216368,951033,2020-03-11,Senate,"Senate Floor Vote - Final Passage",58,0,0,4,62
1216407,876524,2019-03-05,Senate,"Senate Education Committee Vote",14,0,0,1,15
1216407,876936,2019-06-03,Senate,"Senate Floor Vote - Final Passage",62,0,0,0,62
1216407,886461,2019-06-21,Assembly,"Assembly Floor Vote - Final Passage",143,1,0,6,150
1216449,823467,2019-03-18,Senate,"Senate Mental Health and Developmental Disabilities Committee Vote",7,0,0,0,7
1216449,949119,2020-03-11,Senate,"Senate Mental Health and Developmental Disabilities Committee Vote",7,0,0,0,7
1216458,885116,2019-06-18,Senate,"Senate Floor Vote - Final Passage",58,4,0,0,62
1216458,886425,2019-06-18,Senate,"Senate Rules Committee Vote",18,1,0,0,19
1216458,886426,2019-06-21,Assembly,"Assembly Floor Vote - Final Passage",143,1,0,6,150
1216481,861007,2019-05-07,Senate,"Senate Committee Vote",7,0,0,0,7
1216504,869017,2019-05-13,Senate,"Senate Consumer Protection Committee Vote",7,0,0,0,7
1216504,870013,2019-05-22,Senate,"Senate Floor Vote - Final Passage",61,0,0,1,62
1216504,883085,2019-06-17,Senate,"Senate Floor Vote - Final Passage",62,0,0,0,62
1216504,886304,2019-06-20,Assembly,"Assembly Floor Vote - Final Passage",136,10,0,4,150
1216619,859578,2019-04-08,Senate,"Senate Racing, Gaming and Wagering Committee Vote",7,0,0,0,7
1216619,859579,2019-05-06,Senate,"Senate Floor Vote - Final Passage",61,0,0,1,62
1216619,901914,2020-01-13,Senate,"Senate Racing, Gaming and Wagering Committee Vote",7,0,0,0,7
1216619,904013,2020-01-21,Senate,"Senate Floor Vote - Final Passage",60,1,0,1,62
1216669,819325,2019-03-12,Senate,"Senate Health Committee Vote",15,0,0,0,15
1216669,820119,2019-03-12,Senate,"Senate Floor Vote - Final Passage",61,0,0,1,62
1216669,820343,2019-03-12,Senate,"Senate Health Committee Vote",15,0,0,0,15
1216669,822605,2019-03-14,Assembly,"Assembly Floor Vote - Final Passage",134,0,0,16,150
1216689,828892,2019-03-26,Senate,"Senate Committee Vote",7,0,0,0,7
1216689,868873,2019-05-21,Senate,"Senate Finance Committee Vote",23,0,0,0,23
1216689,876671,2019-06-03,Senate,"Senate Floor Vote - Final Passage",57,5,0,0,62
1216743,856772,2019-04-30,Senate,"Senate Mental Health and Developmental Disabilities Committee Vote",7,0,0,0,7
1216743,914006,2020-02-04,Senate,"Senate Mental Health and Developmental Disabilities Committee Vote",7,0,0,0,7
1216776,855660,2019-04-30,Senate,"Senate Committee Vote",7,0,0,0,7
1216799,878454,2019-05-07,Senate,"Senate Labor Committee Vote",9,3,0,1,13
1216799,878455,2019-06-05,Senate,"Senate Floor Vote - Final Passage",39,23,0,0,62
1216799,879292,2019-06-06,Assembly,"Assembly Floor Vote - Final Passage",96,42,0,12,150
1216950,810002,2019-02-27,Assembly,"Assembly Rules Committee: Favorable",27,0,0,4,31
1216950,810003,2019-02-27,Assembly,"Assembly Codes Committee: Favorable refer to committee Rules",21,0,0,1,22
1216950,811157,2019-02-28,Senate,"Senate Floor Vote - Final Passage",62,0,0,1,63
1216950,811770,2019-02-28,Assembly,"Assembly Floor Vote - Final Passage",138,0,0,12,150
1217327,874833,2019-05-21,Senate,"Senate Higher Education Committee Vote",11,0,0,0,11
1217327,875533,2019-05-30,Senate,"Senate Floor Vote - Final Passage",58,0,0,4,62
1217431,839367,2019-04-09,Senate,"Senate Investigations and Government Operations Committee Vote",7,0,0,0,7
1217814,870446,2019-05-21,Senate,"Senate Elections Committee Vote",7,0,0,0,7
1218158,870267,2019-05-21,Assembly,"Assembly Insurance Committee: Favorable refer to committee Codes",16,7,0,1,24
1218158,875095,2019-05-30,Assembly,"Assembly Codes Committee: Favorable",16,3,0,3,22
1218158,881676,2019-06-13,Assembly,"Assembly Floor Vote - Final Passage",105,35,0,10,150
1218171,883520,2019-06-17,Assembly,"Assembly Local Governments Committee: Favorable refer to committee Ways and Means",18,0,0,1,19
1218171,883521,2019-06-17,Assembly,"Assembly Ways And Means Committee: Favorable refer to committee Rules",33,0,0,2,35
1218171,883522,2019-06-18,Assembly,"Assembly Rules Committee: Favorable",25,0,0,6,31
1218185,972036,2020-07-17,Assembly,"Assembly Ways And Means Committee: Held for Consideration",22,10,0,2,34
1218198,838356,2019-04-08,Assembly,"Assembly Judiciary Committee: Favorable refer to committee Ways and Means",20,0,0,1,21
1218198,868958,2019-05-21,Assembly,"Assembly Ways And Means Committee: Favorable",32,0,0,3,35
1218198,875746,2019-05-30,Assembly,"Assembly Floor Vote - Final Passage",140,0,0,10,150
1218255,970946,2020-07-13,Assembly,"Assembly Agriculture Committee: Held for Consideration",13,6,0,2,21
1218330,972110,2020-07-17,Assembly,"Assembly Ways And Means Committee: Held for Consideration",22,10,0,2,34
1218489,971676,2020-07-16,Assembly,"Assembly Real Property Taxation Committee: Held for Consideration",8,2,0,0,10
1218515,972026,2020-07-17,Assembly,"Assembly Codes Committee: Held for Consideration",15,6,0,1,22
1218559,840839,2019-04-09,Assembly,"Assembly Environmental Conservation Committee: Favorable refer to committee Codes",29,0,0,1,30
1218559,856986,2019-04-30,Assembly,"Assembly Codes Committee: Favorable refer to committee Ways and Means",20,0,0,2,22
1218559,868824,2019-05-21,Assembly,"Assembly Ways And Means Committee: Favorable",32,0,0,3,35
1218616,970794,2020-07-13,Assembly,"Assembly Mental Health Committee: Held for Consideration",10,3,0,0,13
1218632,972096,2020-07-17,Assembly,"Assembly Ways And Means Committee: Held for Consideration",22,10,0,2,34
1218688,971938,2020-07-17,Assembly,"Assembly Ways And Means Committee: Held for Consideration",22,10,0,2,34
1218714,840800,2019-04-09,Assembly,"Assembly Transportation Committee: Favorable refer to committee Ways and Means",23,0,0,2,25
1218714,883553,2019-06-18,Assembly,"Assembly Rules Committee: Favorable",25,0,0,6,31
1218714,883554,2019-06-18,Assembly,"Assembly Ways And Means Committee: Favorable refer to committee Rules",33,0,0,2,35
1218731,839337,2019-04-09,Senate,"Senate Transportation Committee Vote",15,0,0,0,15
1218731,885092,2019-06-18,Senate,"Senate Floor Vote - Final Passage",62,0,0,0,62
1218731,886366,2019-06-18,Senate,"Senate Rules Committee Vote",19,0,0,0,19
1218731,886367,2019-06-21,Assembly,"Assembly Floor Vote - Final Passage",144,0,0,6,150
1218746,971458,2020-07-16,Assembly,"Assembly Transportation Committee: Held for Consideration",16,6,0,2,24
1218773,864321,2019-05-14,Senate,"Senate Committee Vote",7,0,0,0,7
1218862,971325,2020-07-14,Assembly,"Assembly Higher Education Committee: Held for Consideration",18,7,0,0,25
1218964,875733,2019-05-30,Assembly,"Assembly Judiciary Committee: Favorable refer to committee Codes",20,0,0,1,21
1218964,877179,2019-06-04,Assembly,"Assembly Codes Committee: Favorable refer to committee Rules",22,0,0,0,22
1218964,880549,2019-06-11,Assembly,"Assembly Rules Committee: Favorable",25,0,0,6,31
1218964,972595,2020-07-21,Assembly,"Assembly Floor Vote - Final Passage",116,26,0,3,145
1218964,973456,2020-07-22,Senate,"Senate Floor Vote - Final Passage",57,3,0,0,60
1219021,971220,2020-07-14,Assembly,"Assembly Correction Committee: Held for Consideration",10,2,0,1,13
1219035,855786,2019-04-09,Senate,"Senate Environmental Conservation Committee Vote",11,0,0,0,11
1219035,855787,2019-04-30,Senate,"Senate Floor Vote - Final Passage",62,0,0,0,62
1219035,875711,2019-05-30,Assembly,"Assembly Floor Vote - Final Passage",139,1,0,10,150
1219094,972058,2020-07-17,Assembly,"Assembly Codes Committee: Held for Consideration",15,6,0,1,22
1219108,828104,2019-03-12,Senate,"Senate Housing, Construction And Community Development Committee Vote",9,0,0,1,10
1219108,828105,2019-03-25,Senate,"Senate Floor Vote - Final Passage",62,0,0,0,62
1219108,857638,2019-05-01,Assembly,"Assembly Floor Vote - Final Passage",141,0,0,9,150
1219123,870182,2019-05-21,Assembly,"Assembly Transportation Committee: Held for Consideration",17,8,0,0,25
1219150,970846,2020-07-13,Assembly,"Assembly Health Committee: Held for Consideration",18,6,0,2,26
1219179,971931,2020-07-17,Assembly,"Assembly Codes Committee: Held for Consideration",15,6,0,1,22
1219194,971463,2020-07-16,Assembly,"Assembly Transportation Committee: Held for Consideration",16,6,0,2,24
1219238,970753,2020-07-13,Assembly,"Assembly Health Committee: Held for Consideration",18,6,0,2,26
1219320,814920,2019-03-06,Assembly,"Assembly Mental Health Committee: Favorable refer to committee Ways and Means",11,0,0,2,13
1219320,878580,2019-06-05,Assembly,"Assembly Ways And Means Committee: Favorable refer to committee Rules",31,0,0,4,35
1219320,882471,2019-06-17,Assembly,"Assembly Rules Committee: Favorable",26,0,0,5,31
1219337,971097,2020-07-14,Assembly,"Assembly Environmental Conservation Committee: Held for Consideration",19,8,0,1,28
1219381,906924,2020-01-28,Assembly,"Assembly Consumer Affairs And Protection Committee: Favorable refer to committee Codes",13,0,0,3,16
1219381,914472,2020-02-04,Assembly,"Assembly Codes Committee: Favorable",19,0,0,3,22
1219409,882219,2019-06-13,Assembly,"Assembly Codes Committee: Held for Consideration",14,6,0,2,22
1219524,971125,2020-07-14,Assembly,"Assembly Insurance Committee: Held for Consideration",14,6,0,2,22
1219625,970862,2020-07-13,Assembly,"Assembly Banks Committee: Favorable refer to committee Rules",28,1,0,2,31
1219625,972218,2020-07-20,Assembly,"Assembly Rules Committee: Favorable",27,0,0,3,30
1219625,972281,2020-07-20,Assembly,"Assembly Floor Vote - Final Passage",141,0,0,4,145
1219625,973525,2020-07-23,Senate,"Senate Floor Vote - Final Passage",48,12,0,0,60
1219643,971178,2020-07-14,Assembly,"Assembly Insurance Committee: Held for Consideration",14,6,0,2,22
1219700,971712,2020-07-17,Assembly,"Assembly Codes Committee: Held for Consideration",15,6,0,1,22
1219814,970769,2020-07-13,Assembly,"Assembly Health Committee: Held for Consideration",18,6,0,2,26
1219858,971136,2020-07-14,Assembly,"Assembly Judiciary Committee: Held for Consideration",15,6,0,0,21
1219916,884408,2019-06-18,Senate,"Senate Rules Committee Vote",18,1,0,0,19
1219916,885468,2019-06-18,Senate,"Senate Floor Vote - Final Passage",58,4,0,0,62
1219929,857484,2019-04-30,Assembly,"Assembly Health Committee: Favorable",17,8,0,1,26
1219945,875759,2019-05-30,Assembly,"Assembly Agriculture Committee: Favorable",19,0,0,2,21
1219945,877847,2019-06-04,Assembly,"Assembly Floor Vote - Final Passage",147,0,0,3,150
1219945,881760,2019-06-13,Senate,"Senate Floor Vote - Final Passage",62,0,0,0,62
1219988,829023,2019-03-19,Senate,"Senate Aging Committee Vote",7,0,0,0,7
1219988,829024,2019-03-26,Senate,"Senate Floor Vote - Final Passage",59,2,0,1,62
1219988,859611,2019-05-06,Assembly,"Assembly Floor Vote - Final Passage",142,0,0,8,150
1222104,841151,2019-04-09,Senate,"Senate Labor Committee Vote",13,0,0,0,13
1222104,863526,2019-05-14,Senate,"Senate Finance Committee Vote",21,1,0,1,23
1222104,874588,2019-05-29,Senate,"Senate Floor Vote - Final Passage",60,0,0,2,62
1222104,885407,2019-06-18,Senate,"Senate Floor Vote - Final Passage",62,0,0,0,62
1222104,886559,2019-06-20,Assembly,"Assembly Floor Vote - Final Passage",145,0,0,5,150
1222119,972840,2020-07-22,Assembly,"Assembly Ways And Means Committee: Favorable refer to committee Rules",27,5,0,2,34
1222119,973103,2020-07-22,Assembly,"Assembly Rules Committee: Favorable",28,1,0,1,30
1222130,855632,2019-04-30,Senate,"Senate Children and Families Committee Vote",7,0,0,0,7
1222130,884411,2019-06-18,Senate,"Senate Rules Committee Vote",19,0,0,0,19
1222130,885478,2019-06-18,Senate,"Senate Floor Vote - Final Passage",52,10,0,0,62
1222130,904714,2020-01-21,Senate,"Senate Children and Families Committee Vote",7,0,0,0,7
1222138,876799,2019-06-03,Senate,"Senate Floor Vote - Final Passage",62,0,0,0,62
1222138,877076,2019-06-03,Senate,"Senate Rules Committee Vote",19,0,0,0,19
1222138,886202,2019-06-21,Assembly,"Assembly Floor Vote - Final Passage",143,1,0,6,150
1222197,821481,2019-03-11,Senate,"Senate Insurance Committee Vote",11,0,0,0,11
1222197,821482,2019-03-14,Senate,"Senate Floor Vote - Final Passage",61,0,0,1,62
1222197,906469,2020-01-27,Senate,"Senate Insurance Committee Vote",11,0,0,0,11
1222197,948582,2020-03-10,Senate,"Senate Floor Vote - Final Passage",59,0,0,3,62
1222197,972831,2020-07-21,Assembly,"Assembly Floor Vote - Final Passage",142,0,0,3,145
1222209,840805,2019-04-09,Assembly,"Assembly Transportation Committee: Favorable",17,6,0,2,25
1222266,814676,2019-03-05,Senate,"Senate Civil Service and Pensions Committee Vote",7,0,0,0,7
1222266,880027,2019-06-11,Senate,"Senate Rules Committee Vote",19,0,0,0,19
1222266,880507,2019-06-11,Senate,"Senate Floor Vote - Final Passage",60,1,0,1,62
1222266,904705,2020-01-22,Senate,"Senate Civil Service and Pensions Committee Vote",7,0,0,0,7
1222318,884394,2019-06-18,Senate,"Senate Rules Committee Vote",19,0,0,0,19
1222318,885465,2019-06-18,Senate,"Senate Floor Vote - Final Passage",62,0,0,0,62
1222318,941916,2020-03-02,Senate,"Senate Insurance Committee Vote",11,0,0,0,11
1222318,948586,2020-03-10,Senate,"Senate Floor Vote - Final Passage",59,0,0,3,62
1222344,878717,2019-06-06,Assembly,"Assembly Corporations, Authorities And Commissions Committee: Favorable refer to committee Ways and Means",25,0,0,1,26
1222344,880837,2019-06-12,Assembly,"Assembly Ways And Means Committee: Favorable refer to committee Rules",30,0,0,5,35
1222344,881360,2019-06-13,Assembly,"Assembly Rules Committee: Favorable",26,0,0,5,31
1222371,868014,2019-05-21,Assembly,"Assembly Judiciary Committee: Favorable",21,0,0,0,21
1222371,875811,2019-05-30,Assembly,"Assembly Floor Vote - Final Passage",139,1,0,10,150
1222371,886560,2019-06-20,Senate,"Senate Floor Vote - Final Passage",62,0,0,0,62
1222388,881404,2019-06-13,Assembly,"Assembly Codes Committee: Favorable refer to committee Rules",20,0,0,2,22
1222388,882537,2019-06-17,Assembly,"Assembly Rules Committee: Favorable",26,0,0,5,31
1222388,883948,2019-06-18,Assembly,"Assembly Floor Vote - Final Passage",134,12,0,4,150
1222925,859430,2019-04-08,Senate,"Senate Local Government Committee Vote",7,0,0,0,7
1222925,859431,2019-05-06,Senate,"Senate Floor Vote - Final Passage",58,3,0,1,62
1222925,882160,2019-06-14,Senate,"Senate Floor Vote - Final Passage",59,3,0,0,62
1222925,884908,2019-06-19,Assembly,"Assembly Floor Vote - Final Passage",148,0,0,2,150
1222974,824160,2019-03-19,Assembly,"Assembly Governmental Employees Committee: Favorable",14,0,0,0,14
1222974,831638,2019-03-28,Assembly,"Assembly Floor Vote - Final Passage",142,1,0,7,150
1222974,856471,2019-05-01,Senate,"Senate Floor Vote - Final Passage",62,0,0,0,62
1223024,818661,2019-03-11,Senate,"Senate Transportation Committee Vote",15,0,0,0,15
1223024,820017,2019-03-12,Senate,"Senate Floor Vote - Final Passage",57,4,0,1,62
1223024,820264,2019-03-12,Senate,"Senate Rules Committee Vote",18,1,0,0,19
1223024,882825,2019-06-17,Senate,"Senate Floor Vote - Final Passage",58,4,0,0,62
1223024,942326,2020-03-03,Senate,"Senate Transportation Committee Vote",15,0,0,0,15
1223024,972481,2020-07-21,Senate,"Senate Floor Vote - Final Passage",58,2,0,0,60
1223800,885081,2019-06-18,Senate,"Senate Floor Vote - Final Passage",62,0,0,0,62
1223800,886371,2019-06-18,Senate,"Senate Rules Committee Vote",18,1,0,0,19
1224129,824156,2019-03-19,Assembly,"Assembly Governmental Employees Committee: Favorable refer to committee Ways and Means",14,0,0,0,14
1224190,881869,2019-06-13,Senate,"Senate Floor Vote - Final Passage",62,0,0,0,62
1224190,881870,2019-06-13,Senate,"Senate Rules Committee Vote",19,0,0,0,19
1224190,883106,2019-06-17,Assembly,"Assembly Floor Vote - Final Passage",147,1,0,2,150
1224405,971123,2020-07-14,Assembly,"Assembly Election Law Committee: Favorable refer to committee Rules",16,0,0,0,16
1224405,972545,2020-07-21,Assembly,"Assembly Floor Vote - Final Passage",142,0,0,3,145
1224405,972546,2020-07-21,Assembly,"Assembly Rules Committee: Favorable",26,0,0,4,30
1224471,832755,2019-03-26,Senate,"Senate Housing, Construction and Community Development Committee Vote",11,0,0,0,11
1224471,832756,2019-04-01,Senate,"Senate Floor Vote - Final Passage",59,2,0,1,62
1224471,904598,2020-01-21,Senate,"Senate Housing, Construction and Community Development Committee Vote",11,0,0,0,11
1224471,972368,2020-07-21,Senate,"Senate Floor Vote - Final Passage",58,2,0,0,60
1224507,971606,2020-07-16,Assembly,"Assembly Real Property Taxation Committee: Held for Consideration",8,2,0,0,10
1224607,970839,2020-07-13,Assembly,"Assembly Health Committee: Held for Consideration",18,6,0,2,26
1224644,963437,2020-06-08,Assembly,"Assembly Codes Committee: Favorable refer to committee Rules",15,6,0,1,22
1224644,963438,2020-06-08,Assembly,"Assembly Rules Committee: Favorable",24,2,0,5,31
1224644,963463,2020-06-08,Senate,"Senate Floor Vote - Final Passage",62,0,0,0,62
1224644,963674,2020-06-08,Assembly,"Assembly Floor Vote - Final Passage",139,5,0,3,147
1224671,971916,2020-07-17,Assembly,"Assembly Codes Committee: Held for Consideration",15,6,0,1,22
1224723,970770,2020-07-13,Assembly,"Assembly Health Committee: Held for Consideration",18,6,0,2,26
1224837,971397,2020-07-16,Assembly,"Assembly Transportation Committee: Held for Consideration",16,6,0,2,24
1224875,970786,2020-07-13,Assembly,"Assembly Health Committee: Held for Consideration",18,6,0,2,26
1224888,971203,2020-07-14,Assembly,"Assembly Correction Committee: Held for Consideration",10,2,0,1,13
1224912,874142,2019-05-29,Assembly,"Assembly Racing And Wagering Committee: Favorable refer to committee Codes",8,3,0,0,11
1224926,970791,2020-07-13,Assembly,"Assembly Economic Development Committee: Held for Consideration",17,7,0,1,25
1224964,971172,2020-07-14,Assembly,"Assembly Election Law Committee: Held for Consideration",12,4,0,0,16
1225017,882221,2019-06-13,Assembly,"Assembly Codes Committee: Held for Consideration",14,6,0,2,22
1225054,971993,2020-07-17,Assembly,"Assembly Ways And Means Committee: Held for Consideration",22,10,0,2,34
1225227,971177,2020-07-14,Assembly,"Assembly Judiciary Committee: Held for Consideration",15,6,0,0,21
1225253,824188,2019-03-19,Assembly,"Assembly Judiciary Committee: Favorable refer to committee Codes",19,1,0,1,21
1225253,838964,2019-04-09,Assembly,"Assembly Codes Committee: Favorable",22,0,0,0,22
1225253,857366,2019-05-01,Assembly,"Assembly Floor Vote - Final Passage",139,2,0,9,150
1225253,879508,2019-06-06,Senate,"Senate Floor Vote - Final Passage",61,0,0,1,62
1225382,868248,2019-05-21,Assembly,"Assembly Insurance Committee: Favorable refer to committee Ways and Means",22,1,0,1,24
1225382,877520,2019-06-04,Assembly,"Assembly Ways And Means Committee: Favorable refer to committee Rules",33,0,0,2,35
1225382,882449,2019-06-17,Assembly,"Assembly Rules Committee: Favorable",26,0,0,5,31
1225395,972018,2020-07-17,Assembly,"Assembly Ways And Means Committee: Held for Consideration",22,10,0,2,34
1225420,882784,2019-06-17,Assembly,"Assembly Labor Committee: Favorable refer to committee Ways and Means",28,0,0,1,29
1225420,884673,2019-06-19,Assembly,"Assembly Rules Committee: Favorable",28,0,0,3,31
1225420,884674,2019-06-19,Assembly,"Assembly Ways And Means Committee: Favorable refer to committee Rules",33,0,0,2,35
1225512,971275,2020-07-14,Assembly,"Assembly Education Committee: Held for Consideration",23,6,0,2,31
1225550,971126,2020-07-14,Assembly,"Assembly Insurance Committee: Held for Consideration",14,6,0,2,22
1225564,971799,2020-07-16,Assembly,"Assembly Local Governments Committee: Held for Consideration",15,4,0,1,20
1225576,856198,2019-04-30,Senate,"Senate Cities Committee Vote",7,0,0,0,7
1225576,868582,2019-05-21,Senate,"Senate Finance Committee Vote",22,1,0,0,23
1225576,881793,2019-06-12,Senate,"Senate Floor Vote - Final Passage",54,8,0,0,62
1225576,886283,2019-06-21,Assembly,"Assembly Floor Vote - Final Passage",99,43,0,8,150
1225628,821570,2019-03-14,Assembly,"Assembly Transportation Committee: Favorable refer to committee Codes",21,1,0,3,25
1225628,856993,2019-04-30,Assembly,"Assembly Codes Committee: Favorable",20,0,0,2,22
1225628,922573,2020-02-12,Assembly,"Assembly Floor Vote - Final Passage",105,39,0,3,147
1225628,941358,2020-03-03,Senate,"Senate Floor Vote - Final Passage",54,8,0,0,62
1225703,857023,2019-04-30,Assembly,"Assembly Mental Health Committee: Favorable refer to committee Ways and Means",11,0,0,2,13
1225703,864191,2019-05-14,Assembly,"Assembly Ways And Means Committee: Favorable",32,0,0,3,35
1225718,840864,2019-04-09,Assembly,"Assembly Transportation Committee: Held for Consideration",16,7,0,2,25
1225766,972035,2020-07-17,Assembly,"Assembly Codes Committee: Held for Consideration",15,6,0,1,22
1225791,971230,2020-07-14,Assembly,"Assembly Education Committee: Held for Consideration",23,6,0,2,31
1225803,971578,2020-07-16,Assembly,"Assembly Real Property Taxation Committee: Held for Consideration",8,2,0,0,10
1225828,971165,2020-07-14,Assembly,"Assembly Judiciary Committee: Held for Consideration",15,6,0,0,21
1225891,819288,2019-03-12,Assembly,"Assembly Insurance Committee: Favorable refer to committee Codes",23,0,0,1,24
1225891,838899,2019-04-09,Assembly,"Assembly Codes Committee: Favorable",22,0,0,0,22
1225932,972101,2020-07-17,Assembly,"Assembly Ways And Means Committee: Held for Consideration",22,10,0,2,34
1225974,824173,2019-03-19,Assembly,"Assembly Racing And Wagering Committee: Favorable refer to committee Ways and Means",11,0,0,0,11
1225974,857178,2019-04-30,Assembly,"Assembly Ways And Means Committee: Favorable",33,0,0,2,35
1227026,971670,2020-07-16,Assembly,"Assembly Real Property Taxation Committee: Held for Consideration",8,2,0,0,10
1227125,972060,2020-07-17,Assembly,"Assembly Ways And Means Committee: Held for Consideration",22,10,0,2,34
1227520,838129,2019-03-19,Senate,"Senate Civil Service and Pensions Committee Vote",7,0,0,0,7
1227520,838130,2019-04-08,Senate,"Senate Floor Vote - Final Passage",59,0,0,3,62
1227520,948267,2020-03-10,Senate,"Senate Civil Service and Pensions Committee Vote",7,0,0,0,7
1227530,859259,2019-03-26,Senate,"Senate Housing, Construction and Community Development Committee Vote",10,1,0,0,11
1227530,859260,2019-05-06,Senate,"Senate Floor Vote - Final Passage",56,5,0,1,62
1227530,880643,2019-06-11,Assembly,"Assembly Floor Vote - Final Passage",137,5,0,8,150
1227540,880975,2019-05-21,Senate,"Senate Housing, Construction and Community Development Committee Vote",11,0,0,0,11
1227540,881736,2019-06-12,Senate,"Senate Floor Vote - Final Passage",62,0,0,0,62
1227540,881737,2019-06-13,Assembly,"Assembly Floor Vote - Final Passage",146,0,0,4,150
1227586,862922,2019-05-06,Senate,"Senate Local Government Committee Vote",7,0,0,0,7
1227586,862923,2019-05-13,Senate,"Senate Floor Vote - Final Passage",58,2,0,2,62
1227586,884433,2019-06-17,Assembly,"Assembly Floor Vote - Final Passage",147,0,0,3,150
1227592,884986,2019-06-19,Assembly,"Assembly Floor Vote - Final Passage",145,3,0,2,150
1227592,885593,2019-06-18,Senate,"Senate Floor Vote - Final Passage",62,0,0,0,62
1227592,886695,2019-06-18,Senate,"Senate Rules Committee Vote",19,0,0,0,19
1227615,839927,2019-03-12,Senate,"Senate Internet and Technology Committee Vote",7,0,0,0,7
1227615,839928,2019-04-09,Senate,"Senate Floor Vote - Final Passage",60,0,0,2,62
1227615,921360,2020-02-11,Senate,"Senate Internet and Technology Committee Vote",7,0,0,0,7
1227615,935176,2020-02-25,Senate,"Senate Floor Vote - Final Passage",60,0,0,2,62
1227644,859342,2019-04-08,Senate,"Senate Local Government Committee Vote",7,0,0,0,7
1227644,859343,2019-05-06,Senate,"Senate Floor Vote - Final Passage",58,3,0,1,62
1227644,884549,2019-06-17,Assembly,"Assembly Floor Vote - Final Passage",147,0,0,3,150
1227715,818321,2019-03-11,Senate,"Senate Transportation Committee Vote",15,0,0,0,15
1227753,829004,2019-03-26,Senate,"Senate Committee Vote",7,0,0,0,7
1227832,824767,2019-03-19,Senate,"Senate Civil Service and Pensions Committee Vote",7,0,0,0,7
1227893,874552,2019-05-06,Senate,"Senate Local Government Committee Vote",7,0,0,0,7
1227893,874553,2019-05-29,Senate,"Senate Floor Vote - Final Passage",60,0,0,2,62
1227893,878139,2019-06-04,Assembly,"Assembly Floor Vote - Final Passage",146,0,0,4,150
1227913,814203,2019-03-05,Assembly,"Assembly Codes Committee: Favorable",16,6,0,0,22
1227913,829701,2019-03-26,Assembly,"Assembly Floor Vote - Final Passage",108,39,0,3,150
1227913,841001,2019-04-10,Senate,"Senate Floor Vote - Final Passage",42,17,0,3,62
1227993,854155,2019-04-08,Senate,"Senate Local Government Committee Vote",7,0,0,0,7
1227993,854156,2019-04-29,Senate,"Senate Floor Vote - Final Passage",58,3,0,1,62
1227993,884907,2019-06-19,Assembly,"Assembly Floor Vote - Final Passage",147,0,0,3,150
1228600,868318,2019-04-08,Senate,"Senate Local Government Committee Vote",7,0,0,0,7
1228600,868319,2019-05-20,Senate,"Senate Floor Vote - Final Passage",60,0,0,2,62
1228600,880342,2019-06-11,Senate,"Senate Floor Vote - Final Passage",61,0,0,1,62
1228600,884228,2019-06-18,Assembly,"Assembly Floor Vote - Final Passage",145,1,0,4,150
1228602,864262,2019-05-06,Senate,"Senate Local Government Committee Vote",7,0,0,0,7
1228602,864263,2019-05-15,Senate,"Senate Floor Vote - Final Passage",57,1,0,4,62
1228602,906332,2020-01-27,Senate,"Senate Local Government Committee Vote",7,0,0,0,7
1228610,874241,2019-05-29,Assembly,"Assembly Racing And Wagering Committee: Favorable",11,0,0,0,11
1228627,877857,2019-06-05,Assembly,"Assembly Insurance Committee: Favorable refer to committee Codes",24,0,0,0,24
1228627,880103,2019-06-11,Assembly,"Assembly Codes Committee: Favorable refer to committee Rules",22,0,0,0,22
1228632,886517,2019-06-18,Senate,"Senate Rules Committee Vote",17,2,0,0,19
1228632,886518,2019-06-19,Senate,"Senate Floor Vote - Final Passage",61,1,0,0,62
1228632,941947,2020-03-03,Senate,"Senate Transportation Committee Vote",15,0,0,0,15
1228638,970932,2020-07-13,Assembly,"Assembly Consumer Affairs And Protection Committee: Favorable refer to committee Codes",14,1,0,1,16
1228638,971874,2020-07-17,Assembly,"Assembly Codes Committee: Favorable refer to committee Ways and Means",21,0,0,1,22
1228641,868486,2019-05-21,Assembly,"Assembly Governmental Employees Committee: Favorable refer to committee Ways and Means",14,0,0,0,14
1228644,869763,2019-05-21,Senate,"Senate Rules Committee Vote",19,0,0,0,19
1228644,869764,2019-05-22,Senate,"Senate Floor Vote - Final Passage",61,0,0,1,62
1228644,884177,2019-06-14,Senate,"Senate Floor Vote - Final Passage",62,0,0,0,62
1228666,871393,2019-05-22,Senate,"Senate Energy and Telecommunications Committee Vote",9,0,0,0,9
1228666,875424,2019-05-30,Senate,"Senate Rules Committee Vote",18,0,0,1,19
1228669,868508,2019-05-21,Assembly,"Assembly Governmental Employees Committee: Favorable refer to committee Ways and Means",14,0,0,0,14
1228669,878631,2019-06-05,Assembly,"Assembly Ways And Means Committee: Favorable refer to committee Rules",29,2,0,4,35
1228669,880250,2019-06-11,Assembly,"Assembly Rules Committee: Favorable",25,0,0,6,31
1228669,884474,2019-06-18,Assembly,"Assembly Floor Vote - Final Passage",134,13,0,3,150
1228688,860927,2019-05-07,Assembly,"Assembly Governmental Employees Committee: Favorable refer to committee Ways and Means",14,0,0,0,14
1228688,878067,2019-06-05,Assembly,"Assembly Ways And Means Committee: Favorable refer to committee Rules",30,1,0,4,35
1228688,880248,2019-06-11,Assembly,"Assembly Rules Committee: Favorable",24,1,0,6,31
1228698,972360,2019-03-12,Senate,"Senate Housing, Construction and Community Development Committee Vote",9,0,0,1,10
1228698,972361,2020-02-11,Senate,"Senate Housing, Construction and Community Development Committee Vote",11,0,0,0,11
1228698,972362,2020-07-21,Senate,"Senate Floor Vote - Final Passage",60,0,0,0,60
1228698,972737,2020-07-21,Assembly,"Assembly Floor Vote - Final Passage",142,0,0,3,145
1228703,972686,2020-07-20,Senate,"Senate Environmental Conservation Committee Vote",9,2,0,0,11
1228703,973226,2020-07-22,Senate,"Senate Rules Committee Vote",17,2,0,0,19
1228703,974158,2020-07-23,Senate,"Senate Floor Vote - Final Passage",48,12,0,0,60
1228716,881614,2019-05-29,Senate,"Senate Banks Committee Vote",11,0,0,0,11
1228716,882074,2019-06-13,Senate,"Senate Floor Vote - Final Passage",62,0,0,0,62
1228716,903291,2020-01-15,Senate,"Senate Banks Committee Vote",10,0,0,0,10
1228716,919654,2020-02-10,Senate,"Senate Floor Vote - Final Passage",54,7,0,1,62
1228716,972728,2020-07-21,Assembly,"Assembly Floor Vote - Final Passage",106,36,0,3,145
1228723,882659,2019-06-17,Assembly,"Assembly Rules Committee: Favorable",25,0,0,6,31
1228723,882660,2019-06-17,Assembly,"Assembly Codes Committee: Favorable refer to committee Rules",18,2,0,2,22
1228735,971973,2020-07-17,Assembly,"Assembly Ways And Means Committee: Held for Consideration",22,10,0,2,34
1228748,869245,2019-05-14,Senate,"Senate Education Committee Vote",15,0,0,0,15
1228748,869246,2019-05-22,Senate,"Senate Floor Vote - Final Passage",61,0,0,1,62
1228748,882247,2019-06-14,Senate,"Senate Floor Vote - Final Passage",62,0,0,0,62
1228748,883525,2019-06-17,Assembly,"Assembly Floor Vote - Final Passage",148,0,0,2,150
1228754,881889,2019-06-12,Senate,"Senate Floor Vote - Final Passage",62,0,0,0,62
1228754,881890,2019-06-12,Senate,"Senate Rules Committee Vote",19,0,0,0,19
1228754,906566,2020-01-27,Senate,"Senate Codes Committee Vote",12,0,0,0,12
1228754,972381,2020-07-21,Senate,"Senate Floor Vote - Final Passage",60,0,0,0,60
1228770,875233,2019-05-20,Senate,"Senate Local Government Committee Vote",6,1,0,0,7
1228770,875234,2019-05-30,Senate,"Senate Floor Vote - Final Passage",46,12,0,4,62
1228770,885041,2019-06-19,Assembly,"Assembly Floor Vote - Final Passage",109,39,0,2,150
1228772,878712,2019-06-06,Assembly,"Assembly Environmental Conservation Committee: Favorable refer to committee Codes",28,0,0,2,30
1228772,882584,2019-06-17,Assembly,"Assembly Codes Committee: Favorable refer to committee Rules",20,0,0,2,22
1228772,886309,2019-06-20,Assembly,"Assembly Rules Committee: Favorable",27,0,0,4,31
1228812,884406,2019-06-17,Assembly,"Assembly Judiciary Committee: Favorable refer to committee Codes",18,0,0,3,21
1228814,839446,2019-04-09,Senate,"Senate Health Committee Vote",15,0,0,0,15
1228814,868079,2019-05-21,Senate,"Senate Finance Committee Vote",23,0,0,0,23
1228814,869214,2019-05-21,Senate,"Senate Finance Committee Vote",23,0,0,0,23
1228814,869215,2019-05-22,Senate,"Senate Floor Vote - Final Passage",55,6,0,1,62
1228822,870181,2019-05-21,Assembly,"Assembly Transportation Committee: Held for Consideration",17,8,0,0,25
1228826,876053,2019-05-30,Assembly,"Assembly Codes Committee: Favorable",19,0,0,3,22
1228826,878089,2019-06-04,Assembly,"Assembly Floor Vote - Final Passage",146,1,0,3,150
1228826,883895,2019-06-18,Senate,"Senate Floor Vote - Final Passage",62,0,0,0,62
1228852,875182,2019-05-20,Senate,"Senate Local Government Committee Vote",6,1,0,0,7
1228852,875183,2019-05-30,Senate,"Senate Floor Vote - Final Passage",46,12,0,4,62
1228852,883037,2019-06-17,Senate,"Senate Floor Vote - Final Passage",59,3,0,0,62
1228852,884960,2019-06-19,Assembly,"Assembly Floor Vote - Final Passage",110,37,0,3,150
1228859,828790,2019-03-12,Senate,"Senate Housing, Construction and Community Development Committee Vote",9,0,0,1,10
1228859,828791,2019-03-26,Senate,"Senate Floor Vote - Final Passage",43,18,0,1,62
1228859,831120,2019-03-27,Assembly,"Assembly Floor Vote - Final Passage",104,44,0,2,150
1228860,825160,2019-03-19,Assembly,"Assembly Governmental Employees Committee: Favorable refer to committee Ways and Means",14,0,0,0,14
1228918,874111,2019-05-29,Assembly,"Assembly Environmental Conservation Committee: Favorable refer to committee Codes",29,0,0,1,30
1228918,877525,2019-06-04,Assembly,"Assembly Codes Committee: Favorable refer to committee Rules",22,0,0,0,22
1228918,880247,2019-06-11,Assembly,"Assembly Rules Committee: Favorable",25,0,0,6,31
1228929,881862,2019-05-14,Senate,"Senate Children And Families Committee Vote",7,0,0,0,7
1228929,882255,2019-06-14,Senate,"Senate Floor Vote - Final Passage",46,16,0,0,62
1228929,884001,2019-06-18,Assembly,"Assembly Floor Vote - Final Passage",99,49,0,2,150
1228956,868541,2019-05-21,Assembly,"Assembly Real Property Taxation Committee: Favorable refer to committee Ways and Means",10,0,0,0,10
1228956,878628,2019-06-05,Assembly,"Assembly Ways And Means Committee: Favorable refer to committee Rules",31,0,0,4,35
1228956,880533,2019-06-11,Assembly,"Assembly Rules Committee: Favorable",25,0,0,6,31
1228974,874819,2019-05-21,Senate,"Senate Finance Committee Vote",23,0,0,0,23
1228974,875529,2019-05-30,Senate,"Senate Floor Vote - Final Passage",58,0,0,4,62
1228974,875737,2019-05-30,Assembly,"Assembly Floor Vote - Final Passage",140,0,0,10,150
1229040,902544,2020-01-14,Senate,"Senate Education Committee Vote",15,0,0,0,15
1229089,860739,2019-05-07,Assembly,"Assembly Environmental Conservation Committee: Favorable",28,0,0,2,30
1229105,880917,2019-05-29,Senate,"Senate Local Government Committee Vote",7,0,0,0,7
1229105,882009,2019-06-12,Senate,"Senate Floor Vote - Final Passage",62,0,0,0,62
1229105,886520,2019-06-21,Assembly,"Assembly Floor Vote - Final Passage",144,0,0,6,150
1229149,971317,2020-07-14,Assembly,"Assembly Higher Education Committee: Held for Consideration",18,7,0,0,25
1229154,881833,2019-06-06,Senate,"Senate Rules Committee Vote",19,0,0,0,19
1229154,881834,2019-06-14,Senate,"Senate Floor Vote - Final Passage",62,0,0,0,62
1229154,884283,2019-06-18,Assembly,"Assembly Floor Vote - Final Passage",147,1,0,2,150
1229198,883833,2019-05-20,Senate,"Senate Codes Committee Vote",9,4,0,0,13
1229198,885570,2019-06-18,Senate,"Senate Floor Vote - Final Passage",44,18,0,0,62
1229198,886239,2019-06-20,Assembly,"Assembly Floor Vote - Final Passage",137,11,0,2,150
1229216,857531,2019-04-30,Assembly,"Assembly Housing Committee: Favorable",17,8,0,3,28
1229216,863493,2019-05-13,Assembly,"Assembly Floor Vote - Final Passage",95,46,0,9,150
1229304,863963,2019-05-14,Senate,"Senate Health Committee Vote",15,0,0,0,15
1229333,828482,2019-03-26,Assembly,"Assembly Correction Committee: Favorable refer to committee Ways and Means",10,3,0,0,13
1229346,819313,2019-03-12,Assembly,"Assembly Veterans' Affairs Committee: Favorable refer to committee Codes",19,0,0,0,19
1229346,857021,2019-04-30,Assembly,"Assembly Codes Committee: Favorable",20,0,0,2,22
1229346,860939,2019-05-07,Assembly,"Assembly Floor Vote - Final Passage",133,0,0,17,150
1229346,868510,2019-05-21,Senate,"Senate Floor Vote - Final Passage",61,0,0,1,62
1229370,819250,2019-03-12,Assembly,"Assembly Environmental Conservation Committee: Favorable refer to committee Codes",23,6,0,1,30
1229370,838862,2019-04-09,Assembly,"Assembly Ways And Means Committee: Favorable",21,11,0,3,35
1229370,838863,2019-04-09,Assembly,"Assembly Codes Committee: Favorable refer to committee Ways and Means",17,5,0,0,22
1229428,819873,2019-03-12,Assembly,"Assembly Environmental Conservation Committee: Favorable refer to committee Codes",25,4,0,1,30
1229428,838957,2019-04-09,Assembly,"Assembly Codes Committee: Favorable refer to committee Ways and Means",22,0,0,0,22
1229428,875806,2019-05-30,Assembly,"Assembly Ways And Means Committee: Favorable",24,7,0,4,35
1229452,877423,2019-06-04,Assembly,"Assembly Cities Committee: Favorable refer to committee Ways and Means",13,2,0,0,15
1229452,882642,2019-06-17,Assembly,"Assembly Rules Committee: Favorable",24,1,0,6,31
1229452,882643,2019-06-17,Assembly,"Assembly Ways And Means Committee: Favorable refer to committee Rules",22,9,2,2,35
1229500,881788,2019-06-14,Assembly,"Assembly Cities Committee: Favorable refer to committee Ways and Means",12,3,0,0,15
1229500,882671,2019-06-17,Assembly,"Assembly Rules Committee: Favorable",25,0,0,6,31
1229500,882672,2019-06-17,Assembly,"Assembly Ways And Means Committee: Favorable refer to committee Rules",28,5,0,2,35
1229730,972040,2020-07-17,Assembly,"Assembly Codes Committee: Held for Consideration",15,6,0,1,22
1229736,971170,2020-07-14,Assembly,"Assembly Correction Committee: Held for Consideration",10,2,0,1,13
1229751,839359,2019-04-09,Senate,"Senate Investigations and Government Operations Committee Vote",7,0,0,0,7
1229760,971598,2020-07-16,Assembly,"Assembly Governmental Operations Committee: Held for Consideration",10,4,0,0,14
1229811,881957,2019-06-12,Senate,"Senate Floor Vote - Final Passage",62,0,0,0,62
1229811,881958,2019-06-12,Senate,"Senate Rules Committee Vote",19,0,0,0,19
1229822,971600,2020-07-16,Assembly,"Assembly Real Property Taxation Committee: Held for Consideration",8,2,0,0,10
1229848,970996,2020-07-14,Assembly,"Assembly Education Committee: Held for Consideration",23,6,0,2,31
1229908,885591,2019-04-09,Senate,"Senate Investigations And Government Operations Committee Vote",7,0,0,0,7
1229908,886248,2019-06-21,Assembly,"Assembly Floor Vote - Final Passage",133,1,0,16,150
1229908,886707,2019-06-20,Senate,"Senate Floor Vote - Final Passage",58,4,0,0,62
1229917,881232,2019-05-29,Senate,"Senate Local Government Committee Vote",6,1,0,0,7
1229917,881718,2019-06-13,Senate,"Senate Floor Vote - Final Passage",62,0,0,0,62
1229978,882218,2019-06-14,Assembly,"Assembly Governmental Employees Committee: Favorable refer to committee Ways and Means",13,0,0,1,14
1229978,882669,2019-06-17,Assembly,"Assembly Rules Committee: Favorable",25,0,0,6,31
1229978,882670,2019-06-17,Assembly,"Assembly Ways And Means Committee: Favorable refer to committee Rules",32,1,0,2,35
1229981,860938,2019-05-07,Assembly,"Assembly Governmental Employees Committee: Favorable",14,0,0,0,14
1229985,882231,2019-06-13,Assembly,"Assembly Codes Committee: Held for Consideration",14,6,0,2,22
1229990,884431,2019-06-18,Senate,"Senate Rules Committee Vote",18,1,0,0,19
1229990,886663,2019-06-19,Senate,"Senate Floor Vote - Final Passage",46,16,0,0,62
1230004,877556,2019-06-04,Assembly,"Assembly Tourism, Arts And Sports Development Committee: Favorable refer to committee Ways and Means",19,0,0,1,20
1230004,879385,2019-06-06,Assembly,"Assembly Ways And Means Committee: Favorable refer to committee Rules",29,2,0,4,35
1230004,880523,2019-06-11,Assembly,"Assembly Rules Committee: Favorable",23,2,0,6,31
1230009,972121,2020-07-17,Assembly,"Assembly Codes Committee: Held for Consideration",15,6,0,1,22
1230013,972379,2020-02-03,Senate,"Senate Domestic Animal Welfare Committee Vote",6,0,0,1,7
1230013,972380,2020-07-21,Senate,"Senate Floor Vote - Final Passage",48,12,0,0,60
1230084,856719,2019-04-30,Senate,"Senate Mental Health and Developmental Disabilities Committee Vote",7,0,0,0,7
1230084,949125,2020-03-11,Senate,"Senate Mental Health and Developmental Disabilities Committee Vote",7,0,0,0,7
1230084,972907,2020-07-21,Senate,"Senate Finance Committee Vote",23,0,0,0,23
1230084,973843,2020-07-21,Senate,"Senate Finance Committee Vote",23,0,0,0,23
1230084,973844,2020-07-22,Senate,"Senate Floor Vote - Final Passage",60,0,0,0,60
1230096,854986,2019-04-08,Senate,"Senate Elections Committee Vote",7,0,0,0,7
1230096,854987,2019-04-29,Senate,"Senate Floor Vote - Final Passage",59,2,0,1,62
1230096,874783,2019-05-29,Assembly,"Assembly Floor Vote - Final Passage",137,3,0,10,150
1230269,880019,2019-06-11,Senate,"Senate Rules Committee Vote",19,0,0,0,19
1230269,880171,2019-06-11,Senate,"Senate Floor Vote - Final Passage",61,0,0,1,62
1230269,884202,2019-06-18,Assembly,"Assembly Floor Vote - Final Passage",143,3,0,4,150
1230285,902711,2020-01-14,Senate,"Senate Health Committee Vote",12,2,0,0,14
1230399,881985,2019-06-12,Senate,"Senate Floor Vote - Final Passage",62,0,0,0,62
1230399,881986,2019-06-12,Senate,"Senate Rules Committee Vote",19,0,0,0,19
1230480,878213,2019-06-05,Assembly,"Assembly Health Committee: Favorable refer to committee Codes",25,0,0,1,26
1230480,880152,2019-06-11,Assembly,"Assembly Codes Committee: Favorable refer to committee Rules",22,0,0,0,22
1230480,881340,2019-06-13,Assembly,"Assembly Rules Committee: Favorable",26,0,0,5,31
1230621,874342,2019-05-14,Senate,"Senate Health Committee Vote",15,0,0,0,15
1230621,874343,2019-05-29,Senate,"Senate Floor Vote - Final Passage",60,0,0,2,62
1230621,875639,2019-05-30,Assembly,"Assembly Floor Vote - Final Passage",141,0,0,9,150
1230650,881993,2019-06-12,Senate,"Senate Floor Vote - Final Passage",62,0,0,0,62
1230650,881994,2019-06-12,Senate,"Senate Rules Committee Vote",19,0,0,0,19
1230731,876063,2019-05-30,Assembly,"Assembly Social Services Committee: Held for Consideration",11,5,0,2,18
1231054,881106,2019-04-30,Senate,"Senate Mental Health and Developmental Disabilities Committee Vote",7,0,0,0,7
1231054,881923,2019-06-12,Senate,"Senate Floor Vote - Final Passage",62,0,0,0,62
1231061,882213,2019-06-14,Assembly,"Assembly Governmental Employees Committee: Favorable refer to committee Ways and Means",13,0,0,1,14
1231061,882728,2019-06-17,Assembly,"Assembly Ways And Means Committee: Favorable refer to committee Rules",32,1,0,2,35
1231061,883495,2019-06-18,Assembly,"Assembly Rules Committee: Favorable",25,0,0,6,31
1231089,876059,2019-05-30,Assembly,"Assembly Governmental Operations Committee: Favorable",12,0,0,2,14
1231146,878518,2019-06-05,Assembly,"Assembly Transportation Committee: Favorable refer to committee Ways and Means",26,0,0,0,26
1231146,879350,2019-06-06,Assembly,"Assembly Ways And Means Committee: Favorable refer to committee Rules",31,0,0,4,35
1231146,882532,2019-06-17,Assembly,"Assembly Rules Committee: Favorable",26,0,0,5,31
1231173,881746,2019-04-30,Senate,"Senate Health Committee Vote",13,2,0,0,15
1231173,881747,2019-06-12,Senate,"Senate Floor Vote - Final Passage",50,12,0,0,62
1231180,971789,2020-07-16,Assembly,"Assembly Governmental Employees Committee: Held for Consideration",10,4,0,0,14
1231187,857546,2019-04-30,Assembly,"Assembly Labor Committee: Favorable refer to committee Codes",20,7,0,2,29
1231187,877407,2019-06-04,Assembly,"Assembly Codes Committee: Favorable refer to committee Rules",15,7,0,0,22
1231187,877965,2019-06-05,Assembly,"Assembly Rules Committee: Favorable",19,8,0,4,31
1231198,857088,2019-04-30,Assembly,"Assembly Mental Health Committee: Favorable",11,0,0,2,13
1231198,860960,2019-05-07,Assembly,"Assembly Floor Vote - Final Passage",133,0,0,17,150
1231198,874533,2019-05-29,Senate,"Senate Floor Vote - Final Passage",60,0,0,2,62
1231213,870192,2019-05-21,Assembly,"Assembly Transportation Committee: Held for Consideration",18,7,0,0,25
1231219,870401,2019-05-21,Assembly,"Assembly Education Committee: Favorable refer to committee Ways and Means",31,0,0,0,31
1231219,874787,2019-05-30,Assembly,"Assembly Ways And Means Committee: Favorable",31,0,0,4,35
1231248,857026,2019-04-30,Assembly,"Assembly Corporations, Authorities And Commissions Committee: Favorable refer to committee Ways and Means",18,7,0,1,26
1231248,869028,2019-05-21,Assembly,"Assembly Ways And Means Committee: Favorable",25,7,0,3,35
1231278,877437,2019-06-04,Assembly,"Assembly Housing Committee: Favorable refer to committee Codes",26,0,0,2,28
1231278,881392,2019-06-13,Assembly,"Assembly Codes Committee: Favorable refer to committee Rules",20,0,0,2,22
1231278,882462,2019-06-17,Assembly,"Assembly Rules Committee: Favorable",26,0,0,5,31
1231295,881534,2019-05-20,Senate,"Senate Corporations, Authorities and Commissions Committee Vote",7,0,0,0,7
1231295,881812,2019-06-13,Senate,"Senate Floor Vote - Final Passage",61,1,0,0,62
1231295,886576,2019-06-20,Assembly,"Assembly Floor Vote - Final Passage",135,11,0,4,150
1231329,972054,2020-07-17,Assembly,"Assembly Codes Committee: Held for Consideration",15,6,0,1,22
1231337,877896,2019-06-05,Assembly,"Assembly Governmental Employees Committee: Favorable refer to committee Ways and Means",14,0,0,0,14
1231337,883562,2019-06-18,Assembly,"Assembly Rules Committee: Favorable",25,0,0,6,31
1231337,883563,2019-06-18,Assembly,"Assembly Ways And Means Committee: Favorable refer to committee Rules",32,1,0,2,35
1231350,857468,2019-05-01,Assembly,"Assembly Education Committee: Favorable",28,0,0,3,31
1231350,860900,2019-05-07,Assembly,"Assembly Floor Vote - Final Passage",133,0,0,17,150
1231350,861354,2019-05-08,Senate,"Senate Floor Vote - Final Passage",60,1,0,1,62
1231356,971922,2020-07-17,Assembly,"Assembly Codes Committee: Held for Consideration",15,6,0,1,22
1231373,971431,2020-07-16,Assembly,"Assembly Transportation Committee: Favorable refer to committee Ways and Means",22,0,0,2,24
1231373,971863,2020-07-17,Assembly,"Assembly Ways And Means Committee: Favorable refer to committee Rules",32,0,0,2,34
1231373,972896,2020-07-22,Assembly,"Assembly Rules Committee: Favorable",29,0,0,1,30
1231373,973584,2020-07-23,Assembly,"Assembly Floor Vote - Final Passage",141,0,0,4,145
1231396,971811,2020-07-16,Assembly,"Assembly Governmental Employees Committee: Held for Consideration",10,4,0,0,14
1231421,828106,2019-03-18,Senate,"Senate Mental Health and Developmental Disabilities Committee Vote",7,0,0,0,7
1231421,828107,2019-03-25,Senate,"Senate Floor Vote - Final Passage",62,0,0,0,62
1231421,870247,2019-05-22,Assembly,"Assembly Floor Vote - Final Passage",146,0,0,4,150
1231561,877035,2019-06-03,Senate,"Senate Floor Vote - Final Passage",60,2,0,0,62
1231561,877315,2019-06-03,Senate,"Senate Rules Committee Vote",18,1,0,0,19
1231561,877316,2019-06-03,Assembly,"Assembly Floor Vote - Final Passage",116,26,0,8,150
1231704,880153,2019-05-20,Senate,"Senate Corporations, Authorities and Commissions Committee Vote",7,0,0,0,7
1231704,880154,2019-06-11,Senate,"Senate Floor Vote - Final Passage",61,0,0,1,62
1231704,922276,2020-02-12,Senate,"Senate Corporations, Authorities and Commissions Committee Vote",6,0,0,1,7
1231704,936972,2020-02-27,Senate,"Senate Floor Vote - Final Passage",59,0,0,3,62
1231704,972325,2020-07-20,Assembly,"Assembly Floor Vote - Final Passage",140,1,0,4,145
1231850,863988,2019-04-08,Senate,"Senate Corporations, Authorities and Commissions Committee Vote",7,0,0,0,7
1231850,863989,2019-05-13,Senate,"Senate Floor Vote - Final Passage",59,1,0,2,62
1231850,877795,2019-06-04,Assembly,"Assembly Floor Vote - Final Passage",139,8,0,3,150
1231962,875814,2019-05-30,Senate,"Senate Environmental Conservation Committee Vote",10,0,0,1,11
1232409,824235,2019-03-19,Assembly,"Assembly Governmental Operations Committee: Favorable refer to committee Codes",10,3,0,1,14
1232655,971481,2020-07-15,Assembly,"Assembly Labor Committee: Held for Consideration",18,7,0,3,28
1232662,971197,2020-07-14,Assembly,"Assembly Judiciary Committee: Held for Consideration",15,6,0,0,21
1232697,972095,2020-07-17,Assembly,"Assembly Codes Committee: Held for Consideration",15,6,0,1,22
1232707,878713,2019-06-06,Assembly,"Assembly Environmental Conservation Committee: Favorable refer to committee Codes",28,0,0,2,30
1232707,881419,2019-06-13,Assembly,"Assembly Codes Committee: Favorable refer to committee Rules",18,2,0,2,22
1232713,970899,2020-07-13,Assembly,"Assembly Alcoholism And Drug Abuse Committee: Held for Consideration",9,4,0,1,14
1232733,972089,2020-07-17,Assembly,"Assembly Codes Committee: Held for Consideration",15,6,0,1,22
1232767,971311,2020-07-14,Assembly,"Assembly Higher Education Committee: Held for Consideration",18,7,0,0,25
1232778,971291,2020-07-15,Assembly,"Assembly Labor Committee: Favorable refer to committee Ways and Means",25,0,0,3,28
1232778,971869,2020-07-17,Assembly,"Assembly Ways And Means Committee: Favorable refer to committee Rules",32,0,0,2,34
1232778,972193,2020-07-20,Assembly,"Assembly Rules Committee: Favorable",27,0,0,3,30
1232787,972111,2020-07-17,Assembly,"Assembly Ways And Means Committee: Held for Consideration",22,10,0,2,34
1232802,971560,2020-07-16,Assembly,"Assembly Governmental Operations Committee: Held for Consideration",10,4,0,0,14
1232810,877135,2019-06-04,Assembly,"Assembly Real Property Taxation Committee: Favorable refer to committee Ways and Means",10,0,0,0,10
1232810,878292,2019-06-05,Assembly,"Assembly Ways And Means Committee: Favorable refer to committee Rules",31,0,0,4,35
1232810,880540,2019-06-11,Assembly,"Assembly Rules Committee: Favorable",25,0,0,6,31
1232821,971334,2020-07-14,Assembly,"Assembly Higher Education Committee: Held for Consideration",18,7,0,0,25
1232844,970818,2020-07-13,Assembly,"Assembly Health Committee: Held for Consideration",18,6,0,2,26
1232849,971777,2020-07-16,Assembly,"Assembly Local Governments Committee: Held for Consideration",15,4,0,1,20
1232860,879513,2019-06-06,Assembly,"Assembly Environmental Conservation Committee: Favorable refer to committee Ways and Means",28,0,0,2,30
1232860,885258,2019-06-19,Assembly,"Assembly Ways And Means Committee: Favorable refer to committee Rules",33,0,0,2,35
1232860,885259,2019-06-20,Assembly,"Assembly Rules Committee: Favorable",27,0,0,4,31
1232871,857562,2019-04-30,Assembly,"Assembly Health Committee: Favorable refer to committee Ways and Means",25,0,0,1,26
1232892,881858,2019-06-12,Senate,"Senate Floor Vote - Final Passage",48,14,0,0,62
1232892,881859,2019-06-12,Senate,"Senate Rules Committee Vote",18,1,0,0,19
1232903,971184,2020-07-14,Assembly,"Assembly Election Law Committee: Held for Consideration",12,4,0,0,16
1232909,971946,2020-07-17,Assembly,"Assembly Codes Committee: Held for Consideration",15,6,0,1,22
1232941,933757,2020-02-25,Assembly,"Assembly Aging Committee: Favorable refer to committee Codes",30,0,0,0,30
1232945,970950,2020-07-13,Assembly,"Assembly Children And Families Committee: Held for Consideration",11,4,0,1,16
1232961,971410,2020-07-16,Assembly,"Assembly Transportation Committee: Favorable refer to committee Rules",22,0,0,2,24
1232974,840742,2019-04-09,Assembly,"Assembly Governmental Operations Committee: Favorable refer to committee Ways and Means",13,0,0,1,14
1232974,864845,2019-05-14,Assembly,"Assembly Ways And Means Committee: Favorable",24,8,0,3,35
1232974,972813,2020-07-21,Assembly,"Assembly Floor Vote - Final Passage",136,6,0,3,145
1233008,970919,2020-07-13,Assembly,"Assembly Consumer Affairs And Protection Committee: Held for Consideration",12,3,0,1,16
1233023,972045,2020-07-17,Assembly,"Assembly Ways And Means Committee: Held for Consideration",22,10,0,2,34
1233034,970995,2020-07-14,Assembly,"Assembly Education Committee: Held for Consideration",23,6,0,2,31
1233039,877130,2019-06-04,Assembly,"Assembly Real Property Taxation Committee: Favorable refer to committee Ways and Means",10,0,0,0,10
1233039,878300,2019-06-05,Assembly,"Assembly Ways And Means Committee: Favorable refer to committee Rules",31,0,0,4,35
1233039,880552,2019-06-11,Assembly,"Assembly Rules Committee: Favorable",25,0,0,6,31
1233046,860646,2019-03-19,Senate,"Senate Civil Service And Pensions Committee Vote",7,0,0,0,7
1233046,860647,2019-05-07,Senate,"Senate Floor Vote - Final Passage",61,0,0,1,62
1233046,884962,2019-06-18,Assembly,"Assembly Floor Vote - Final Passage",146,0,0,4,150
1233049,861242,2019-05-07,Assembly,"Assembly Judiciary Committee: Favorable",14,6,0,1,21
1233049,972363,2020-07-21,Senate,"Senate Floor Vote - Final Passage",43,17,0,0,60
1233049,972920,2020-07-21,Assembly,"Assembly Floor Vote - Final Passage",97,45,0,3,145
1233069,971971,2020-07-17,Assembly,"Assembly Ways And Means Committee: Held for Consideration",22,10,0,2,34
1233102,972077,2020-07-17,Assembly,"Assembly Codes Committee: Held for Consideration",15,6,0,1,22
1233108,824736,2019-03-19,Assembly,"Assembly Real Property Taxation Committee: Favorable refer to committee Codes",8,1,0,1,10
1233115,880603,2019-06-11,Assembly,"Assembly Ways And Means Committee: Favorable refer to committee Rules",27,6,0,2,35
1233115,881342,2019-06-13,Assembly,"Assembly Rules Committee: Favorable",24,2,0,5,31
1233118,879155,2019-06-05,Assembly,"Assembly Transportation Committee: Favorable refer to committee Ways and Means",26,0,0,0,26
1233118,882041,2019-06-14,Assembly,"Assembly Ways And Means Committee: Favorable refer to committee Rules",30,0,0,5,35
1233118,882510,2019-06-17,Assembly,"Assembly Rules Committee: Favorable",26,0,0,5,31
1233124,861241,2019-05-07,Assembly,"Assembly Judiciary Committee: Favorable",12,8,0,1,21
1233142,882305,2019-06-13,Assembly,"Assembly Codes Committee: Held for Consideration",14,6,0,2,22
1233180,862916,2019-05-13,Senate,"Senate Transportation Committee Vote",12,2,0,1,15
1233180,863539,2019-05-14,Senate,"Senate Rules Committee Vote",18,0,0,1,19
1233180,864258,2019-05-15,Senate,"Senate Floor Vote - Final Passage",51,7,0,4,62
1233180,915133,2020-02-04,Senate,"Senate Transportation Committee Vote",14,1,0,0,15
1233180,940904,2020-03-03,Senate,"Senate Floor Vote - Final Passage",54,8,0,0,62
1233213,878022,2019-06-04,Assembly,"Assembly Mental Health Committee: Favorable refer to committee Rules",12,0,0,1,13
1233213,878023,2019-06-05,Assembly,"Assembly Rules Committee: Favorable",27,0,0,4,31
1233245,971394,2020-07-16,Assembly,"Assembly Governmental Operations Committee: Held for Consideration",10,4,0,0,14
1233350,840793,2019-04-09,Assembly,"Assembly Tourism, Arts And Sports Development Committee: Favorable",20,0,0,0,20
1233350,857483,2019-05-01,Assembly,"Assembly Floor Vote - Final Passage",141,0,0,9,150
1233350,880138,2019-06-11,Senate,"Senate Floor Vote - Final Passage",61,0,0,1,62
1233380,860994,2019-05-07,Senate,"Senate Committee Vote",7,0,0,0,7
1233380,863571,2019-05-14,Senate,"Senate Finance Committee Vote",22,0,0,1,23
1233380,868784,2019-05-21,Senate,"Senate Floor Vote - Final Passage",43,18,0,1,62
1233380,884239,2019-06-18,Assembly,"Assembly Floor Vote - Final Passage",145,3,0,2,150
1233401,883535,2019-06-17,Assembly,"Assembly Real Property Taxation Committee: Favorable refer to committee Ways and Means",10,0,0,0,10
1233401,883536,2019-06-17,Assembly,"Assembly Ways And Means Committee: Favorable refer to committee Rules",33,0,0,2,35
1233401,883537,2019-06-18,Assembly,"Assembly Rules Committee: Favorable",25,0,0,6,31
1233456,822030,2019-03-14,Assembly,"Assembly Transportation Committee: Favorable refer to committee Codes",19,3,0,3,25
1233456,823326,2019-03-18,Assembly,"Assembly Rules Committee: Favorable",17,7,0,7,31
1233456,823327,2019-03-18,Assembly,"Assembly Codes Committee: Favorable refer to committee Ways and Means",15,6,0,1,22
1233456,823328,2019-03-18,Assembly,"Assembly Ways And Means Committee: Favorable refer to committee Rules",21,10,0,4,35
1233456,825127,2019-03-19,Senate,"Senate Floor Vote - Final Passage",43,18,0,1,62
1233456,825485,2019-03-19,Assembly,"Assembly Floor Vote - Final Passage",100,46,0,4,150
1233480,839317,2019-04-09,Senate,"Senate Social Services Committee Vote",7,0,0,0,7
1233480,877172,2019-05-30,Senate,"Senate Floor Vote - Final Passage",57,1,0,4,62
1233480,877173,2019-05-30,Senate,"Senate Rules Committee Vote",18,0,0,1,19
1233536,881927,2019-06-13,Senate,"Senate Floor Vote - Final Passage",59,3,0,0,62
1233536,881928,2019-06-13,Senate,"Senate Rules Committee Vote",19,0,0,0,19
1233536,883154,2019-06-17,Assembly,"Assembly Floor Vote - Final Passage",144,0,0,6,150
1233558,881940,2019-06-12,Senate,"Senate Floor Vote - Final Passage",62,0,0,0,62
1233558,881941,2019-06-12,Senate,"Senate Rules Committee Vote",19,0,0,0,19
1233558,934513,2020-02-25,Senate,"Senate Cities Committee Vote",7,0,0,0,7
1233558,948290,2020-03-10,Senate,"Senate Floor Vote - Final Passage",58,1,0,3,62
1233570,868931,2019-05-21,Assembly,"Assembly Insurance Committee: Favorable refer to committee Codes",23,0,0,1,24
1233570,877730,2019-06-04,Assembly,"Assembly Codes Committee: Favorable refer to committee Rules",22,0,0,0,22
1233570,880510,2019-06-11,Assembly,"Assembly Rules Committee: Favorable",25,0,0,6,31
1233601,878724,2019-06-06,Assembly,"Assembly Environmental Conservation Committee: Favorable refer to committee Codes",21,7,0,2,30
1233601,880204,2019-06-11,Assembly,"Assembly Codes Committee: Favorable refer to committee Ways and Means",16,6,0,0,22
1233622,971065,2020-07-14,Assembly,"Assembly Judiciary Committee: Favorable refer to committee Rules",15,6,0,0,21
1233622,972596,2020-07-21,Assembly,"Assembly Rules Committee: Favorable",19,7,0,4,30
1233644,867958,2019-05-21,Assembly,"Assembly Transportation Committee: Favorable refer to committee Ways and Means",25,0,0,0,25
1233675,839331,2019-04-09,Senate,"Senate Education Committee Vote",15,0,0,0,15
1233675,860878,2019-05-07,Senate,"Senate Finance Committee Vote",23,0,0,0,23
1233675,864701,2019-05-15,Senate,"Senate Floor Vote - Final Passage",57,1,0,4,62
1233675,877878,2019-06-04,Assembly,"Assembly Floor Vote - Final Passage",147,0,0,3,150
1233689,862960,2019-04-30,Senate,"Senate Transportation Committee Vote",15,0,0,0,15
1233689,862961,2019-05-13,Senate,"Senate Floor Vote - Final Passage",60,0,0,2,62
1233689,964169,2020-06-09,Senate,"Senate Floor Vote - Final Passage",62,0,0,0,62
1233689,966257,2020-05-28,Senate,"Senate Rules Committee Vote",19,0,0,0,19
1233689,966258,2020-06-08,Senate,"Senate Transportation Committee Vote",15,0,0,0,15
1233698,933573,2020-02-25,Assembly,"Assembly Correction Committee: Favorable refer to committee Ways and Means",8,2,0,3,13
1233708,834351,2019-04-02,Assembly,"Assembly Health Committee: Favorable refer to committee Ways and Means",23,1,0,2,26
1233708,875598,2019-05-30,Assembly,"Assembly Ways And Means Committee: Favorable",29,2,0,4,35
1233718,881067,2019-06-12,Assembly,"Assembly Local Governments Committee: Favorable refer to committee Ways and Means",17,0,0,2,19
1233718,882839,2019-06-17,Assembly,"Assembly Ways And Means Committee: Favorable refer to committee Rules",33,0,0,2,35
1233718,886113,2019-06-20,Assembly,"Assembly Rules Committee: Favorable",27,0,0,4,31
1233763,863750,2019-05-06,Senate,"Senate Codes Committee Vote",13,0,0,0,13
1233763,863751,2019-05-14,Senate,"Senate Floor Vote - Final Passage",59,0,0,3,62
1233763,901949,2020-01-13,Senate,"Senate Codes Committee Vote",13,0,0,0,13
1233763,973067,2020-07-21,Senate,"Senate Floor Vote - Final Passage",60,0,0,0,60
1233869,882330,2019-06-14,Assembly,"Assembly Ways And Means Committee: Favorable refer to committee Rules",26,4,0,5,35
1233869,882511,2019-06-17,Assembly,"Assembly Rules Committee: Favorable",26,0,0,5,31
1234744,878994,2019-06-06,Assembly,"Assembly Corporations, Authorities And Commissions Committee: Favorable refer to committee Ways and Means",16,9,0,1,26
1234868,857011,2019-04-30,Assembly,"Assembly Agriculture Committee: Favorable refer to committee Ways and Means",21,0,0,0,21
1234868,882622,2019-06-17,Assembly,"Assembly Rules Committee: Favorable",25,0,0,6,31
1234868,882623,2019-06-17,Assembly,"Assembly Ways And Means Committee: Favorable refer to committee Rules",33,0,0,2,35
1234887,878468,2019-06-04,Assembly,"Assembly Economic Development Committee: Favorable refer to committee Codes",17,7,0,2,26
1234887,880198,2019-06-11,Assembly,"Assembly Codes Committee: Favorable refer to committee Rules",18,4,0,0,22
1234887,881707,2019-06-14,Assembly,"Assembly Rules Committee: Favorable",25,0,0,6,31
1234903,841610,2019-04-09,Senate,"Senate Environmental Conservation Committee Vote",11,0,0,0,11
1234903,878030,2019-06-05,Senate,"Senate Floor Vote - Final Passage",62,0,0,0,62
1234903,878031,2019-06-05,Senate,"Senate Rules Committee Vote",19,0,0,0,19
1234903,886232,2019-06-21,Assembly,"Assembly Floor Vote - Final Passage",138,3,0,9,150
1234955,972696,2020-07-21,Senate,"Senate Finance Committee Vote",23,0,0,0,23
1234955,973650,2020-07-22,Senate,"Senate Floor Vote - Final Passage",58,2,0,0,60
1234955,973827,2020-07-21,Senate,"Senate Finance Committee Vote",23,0,0,0,23
1234989,882316,2019-06-13,Assembly,"Assembly Codes Committee: Held for Consideration",14,6,0,2,22
1235032,874630,2019-05-29,Assembly,"Assembly Local Governments Committee: Favorable refer to committee Ways and Means",17,0,0,2,19
1235032,882015,2019-06-14,Assembly,"Assembly Ways And Means Committee: Favorable refer to committee Rules",25,5,0,5,35
1235032,882402,2019-06-17,Assembly,"Assembly Rules Committee: Favorable",26,0,0,5,31
1235076,834356,2019-04-02,Assembly,"Assembly Health Committee: Favorable refer to committee Ways and Means",24,0,0,2,26
1235076,882322,2019-06-14,Assembly,"Assembly Ways And Means Committee: Favorable refer to committee Rules",30,0,0,5,35
1235076,882489,2019-06-17,Assembly,"Assembly Rules Committee: Favorable",26,0,0,5,31
1235272,820117,2019-03-12,Senate,"Senate Floor Vote - Final Passage",61,0,0,1,62
1235272,820561,2019-03-12,Senate,"Senate Rules Committee Vote",19,0,0,0,19
1235272,862063,2019-05-08,Assembly,"Assembly Floor Vote - Final Passage",138,0,0,12,150
1235639,820121,2019-03-12,Senate,"Senate Floor Vote - Final Passage",61,0,0,1,62
1235639,820540,2019-03-12,Senate,"Senate Rules Committee Vote",19,0,0,0,19
1235639,857254,2019-05-01,Assembly,"Assembly Floor Vote - Final Passage",139,1,0,10,150
1236629,882162,2019-06-14,Senate,"Senate Floor Vote - Final Passage",62,0,0,0,62
1236629,882163,2019-06-14,Senate,"Senate Rules Committee Vote",19,0,0,0,19
1236629,884418,2019-06-18,Assembly,"Assembly Floor Vote - Final Passage",126,20,0,4,150
1236635,880445,2019-06-11,Senate,"Senate Floor Vote - Final Passage",60,1,0,1,62
1236635,880446,2019-06-11,Senate,"Senate Rules Committee Vote",17,2,0,0,19
1236635,886445,2019-06-21,Assembly,"Assembly Floor Vote - Final Passage",143,1,0,6,150
1236636,856580,2019-04-30,Senate,"Senate Energy and Telecommunications Committee Vote",8,1,0,0,9
1236636,868521,2019-05-21,Senate,"Senate Finance Committee Vote",19,4,0,0,23
1236636,882921,2019-06-17,Senate,"Senate Floor Vote - Final Passage",48,14,0,0,62
1236636,886497,2019-06-20,Assembly,"Assembly Floor Vote - Final Passage",125,22,0,3,150
1236639,874918,2019-05-30,Senate,"Senate Transportation Committee Vote",14,1,0,0,15
1236655,868661,2019-05-14,Senate,"Senate Aging Committee Vote",7,0,0,0,7
1236655,868662,2019-05-21,Senate,"Senate Floor Vote - Final Passage",58,3,0,1,62
1236655,904675,2020-01-22,Senate,"Senate Aging Committee Vote",7,0,0,0,7
1236655,910293,2020-01-29,Senate,"Senate Floor Vote - Final Passage",56,2,0,4,62
1236655,973151,2020-07-22,Assembly,"Assembly Floor Vote - Final Passage",100,42,0,3,145
1236662,878183,2019-05-29,Senate,"Senate Elections Committee Vote",5,2,0,0,7
1236662,878184,2019-06-05,Senate,"Senate Floor Vote - Final Passage",40,22,0,0,62
1236662,901648,2020-01-08,Senate,"Senate Floor Vote - Final Passage",40,20,0,2,62
1236662,901649,2020-01-09,Senate,"Senate Floor Vote - Final Passage",40,20,0,2,62
1236662,901890,2020-01-09,Senate,"Senate Elections Committee Vote",5,2,0,0,7
1236662,901891,2020-01-09,Senate,"Senate Rules Committee Vote",13,5,0,1,19
1236662,972520,2020-07-21,Senate,"Senate Floor Vote - Final Passage",42,18,0,0,60
1236665,840921,2019-04-09,Senate,"Senate Transportation Committee Vote",14,1,0,0,15
1236665,855157,2019-04-30,Senate,"Senate Finance Committee Vote",23,0,0,0,23
1236665,856274,2019-04-30,Senate,"Senate Finance Committee Vote",23,0,0,0,23
1236665,856275,2019-05-01,Senate,"Senate Floor Vote - Final Passage",61,1,0,0,62
1236680,882136,2019-05-21,Senate,"Senate Consumer Protection Committee Vote",7,0,0,0,7
1236680,882137,2019-06-14,Senate,"Senate Floor Vote - Final Passage",59,3,0,0,62
1236680,902945,2020-01-15,Senate,"Senate Consumer Protection Committee Vote",6,1,0,0,7
1236681,821740,2019-03-12,Senate,"Senate Rules Committee Vote",19,0,0,0,19
1236681,821741,2019-03-14,Senate,"Senate Floor Vote - Final Passage",53,8,0,1,62
1236681,880669,2019-06-11,Assembly,"Assembly Floor Vote - Final Passage",118,24,0,8,150
1236691,875569,2019-05-30,Senate,"Senate Housing, Construction and Community Development Committee Vote",6,4,0,1,11
1236698,877263,2019-05-13,Senate,"Senate Insurance Committee Vote",11,0,0,0,11
1236698,877264,2019-06-04,Senate,"Senate Floor Vote - Final Passage",62,0,0,0,62
1236698,884134,2019-06-18,Assembly,"Assembly Floor Vote - Final Passage",146,0,0,4,150
1236705,880821,2019-05-30,Senate,"Senate Labor Committee Vote",12,1,0,0,13
1236705,882026,2019-06-12,Senate,"Senate Floor Vote - Final Passage",41,21,0,0,62
1236705,915473,2020-02-04,Senate,"Senate Labor Committee Vote",10,3,0,0,13
1236705,972438,2020-07-21,Senate,"Senate Floor Vote - Final Passage",42,18,0,0,60
1236711,885344,2019-06-18,Senate,"Senate Floor Vote - Final Passage",62,0,0,0,62
1236711,886587,2019-06-18,Senate,"Senate Rules Committee Vote",19,0,0,0,19
1236711,886588,2019-06-20,Assembly,"Assembly Floor Vote - Final Passage",144,2,0,4,150
1236714,862931,2019-05-06,Senate,"Senate Local Government Committee Vote",7,0,0,0,7
1236714,862932,2019-05-13,Senate,"Senate Floor Vote - Final Passage",58,2,0,2,62
1236714,884398,2019-06-18,Assembly,"Assembly Floor Vote - Final Passage",146,0,0,4,150
1236720,885615,2019-06-18,Senate,"Senate Floor Vote - Final Passage",62,0,0,0,62
1236720,886264,2019-06-18,Senate,"Senate Rules Committee Vote",18,1,0,0,19
1236726,867474,2019-05-20,Senate,"Senate Corporations, Authorities and Commissions Committee Vote",7,0,0,0,7
1236726,877907,2019-06-05,Senate,"Senate Rules Committee Vote",19,0,0,0,19
1236726,882073,2019-06-13,Senate,"Senate Floor Vote - Final Passage",62,0,0,0,62
1236726,886574,2019-06-21,Assembly,"Assembly Floor Vote - Final Passage",144,0,0,6,150
1236727,875414,2019-05-30,Senate,"Senate Floor Vote - Final Passage",58,0,0,4,62
1236727,875415,2019-05-30,Senate,"Senate Rules Committee Vote",18,0,0,1,19
1236727,886524,2019-06-21,Assembly,"Assembly Floor Vote - Final Passage",143,1,0,6,150
1236739,838421,2019-04-08,Senate,"Senate Corporations, Authorities and Commissions Committee Vote",7,0,0,0,7
1236739,922287,2020-02-12,Senate,"Senate Corporations, Authorities and Commissions Committee Vote",6,0,0,1,7
1236807,971781,2020-07-16,Assembly,"Assembly Governmental Employees Committee: Held for Consideration",10,4,0,0,14
1236848,880530,2019-06-11,Senate,"Senate Floor Vote - Final Passage",42,19,0,1,62
1236848,880531,2019-06-11,Senate,"Senate Rules Committee Vote",14,5,0,0,19
1236848,941040,2020-03-03,Senate,"Senate Finance Committee Vote",15,8,0,0,23
1236859,874391,2019-05-29,Assembly,"Assembly Environmental Conservation Committee: Favorable refer to committee Ways and Means",29,0,0,1,30
1236859,874828,2019-05-30,Assembly,"Assembly Ways And Means Committee: Favorable",31,0,0,4,35
1236859,877940,2019-06-04,Assembly,"Assembly Floor Vote - Final Passage",147,0,0,3,150
1236859,882240,2019-06-14,Senate,"Senate Floor Vote - Final Passage",62,0,0,0,62
1236872,878246,2019-06-05,Assembly,"Assembly Banks Committee: Favorable refer to committee Ways and Means",21,8,0,2,31
1236928,828494,2019-03-26,Assembly,"Assembly Economic Development Committee: Favorable refer to committee Ways and Means",24,0,0,2,26
1236947,886008,2019-06-19,Senate,"Senate Rules Committee Vote",19,0,0,0,19
1236947,886484,2019-06-19,Senate,"Senate Floor Vote - Final Passage",62,0,0,0,62
1236991,878298,2019-04-30,Senate,"Senate Consumer Protection Committee Vote",7,0,0,0,7
1236991,878299,2019-06-05,Senate,"Senate Floor Vote - Final Passage",44,18,0,0,62
1236991,903098,2020-01-15,Senate,"Senate Consumer Protection Committee Vote",6,1,0,0,7
1237005,970955,2020-07-13,Assembly,"Assembly Children And Families Committee: Held for Consideration",11,4,0,1,16
1237040,883282,2019-05-29,Senate,"Senate Commerce, Economic Development and Small Business Committee Vote",9,0,0,0,9
1237040,883283,2019-06-17,Senate,"Senate Floor Vote - Final Passage",62,0,0,0,62
1237040,902729,2020-01-14,Senate,"Senate Commerce, Economic Development and Small Business Committee Vote",9,0,0,0,9
1237040,922520,2020-02-13,Senate,"Senate Floor Vote - Final Passage",57,0,0,5,62
1237040,972519,2020-07-20,Assembly,"Assembly Floor Vote - Final Passage",140,1,0,4,145
1237049,881971,2019-06-12,Senate,"Senate Floor Vote - Final Passage",62,0,0,0,62
1237049,881972,2019-06-12,Senate,"Senate Rules Committee Vote",19,0,0,0,19
1237049,885215,2019-06-19,Assembly,"Assembly Floor Vote - Final Passage",148,0,0,2,150
1237094,864865,2019-05-14,Assembly,"Assembly Ways And Means Committee: Favorable",27,5,0,3,35
1237094,867971,2019-05-20,Assembly,"Assembly Floor Vote - Final Passage",114,30,0,6,150
1237094,882194,2019-06-14,Senate,"Senate Floor Vote - Final Passage",53,9,0,0,62
1237098,864848,2019-05-14,Assembly,"Assembly Ways And Means Committee: Favorable",26,6,0,3,35
1237098,867965,2019-05-20,Assembly,"Assembly Floor Vote - Final Passage",110,34,0,6,150
1237098,883480,2019-06-18,Senate,"Senate Floor Vote - Final Passage",48,14,0,0,62
1237103,881784,2019-06-14,Assembly,"Assembly Transportation Committee: Favorable refer to committee Ways and Means",24,0,0,1,25
1237103,883499,2019-06-18,Assembly,"Assembly Rules Committee: Favorable",25,0,0,6,31
1237103,883500,2019-06-18,Assembly,"Assembly Ways And Means Committee: Favorable refer to committee Rules",33,0,0,2,35
1237111,879160,2019-06-05,Assembly,"Assembly Transportation Committee: Held for Consideration",19,7,0,0,26
1237120,971064,2020-07-14,Assembly,"Assembly Insurance Committee: Held for Consideration",15,5,0,2,22
1237126,867725,2019-04-09,Senate,"Senate Cultural Affairs, Tourism, Parks and Recreation Committee Vote",7,0,0,0,7
1237126,867726,2019-05-20,Senate,"Senate Floor Vote - Final Passage",57,3,0,2,62
1237126,882558,2019-06-14,Assembly,"Assembly Floor Vote - Final Passage",143,1,0,6,150
1237133,864852,2019-05-14,Assembly,"Assembly Ways And Means Committee: Favorable",26,6,0,3,35
1237133,867968,2019-05-20,Assembly,"Assembly Floor Vote - Final Passage",110,34,0,6,150
1237147,878460,2019-06-04,Assembly,"Assembly Governmental Operations Committee: Favorable refer to committee Codes",12,0,0,2,14
1237147,881426,2019-06-13,Assembly,"Assembly Codes Committee: Favorable refer to committee Rules",20,0,0,2,22
1237147,882546,2019-06-17,Assembly,"Assembly Rules Committee: Favorable",26,0,0,5,31
1237150,970804,2020-07-13,Assembly,"Assembly Economic Development Committee: Held for Consideration",17,7,0,1,25
1237161,878402,2019-06-05,Assembly,"Assembly Transportation Committee: Favorable refer to committee Ways and Means",26,0,0,0,26
1237161,880831,2019-06-12,Assembly,"Assembly Ways And Means Committee: Favorable refer to committee Rules",30,0,0,5,35
1237161,883534,2019-06-18,Assembly,"Assembly Rules Committee: Favorable",25,0,0,6,31
1237165,882727,2019-06-17,Assembly,"Assembly Judiciary Committee: Favorable refer to committee Codes",18,0,0,3,21
1237165,883782,2019-06-18,Assembly,"Assembly Codes Committee: Favorable refer to committee Rules",22,0,0,0,22
1237165,885233,2019-06-20,Assembly,"Assembly Rules Committee: Favorable",27,0,0,4,31
1237174,972116,2020-07-17,Assembly,"Assembly Codes Committee: Held for Consideration",15,6,0,1,22
1237178,971817,2020-07-16,Assembly,"Assembly Local Governments Committee: Held for Consideration",15,4,0,1,20
1237187,875621,2019-05-30,Assembly,"Assembly Ways And Means Committee: Favorable",27,4,0,4,35
1237189,877748,2019-06-04,Assembly,"Assembly Ways And Means Committee: Favorable refer to committee Rules",26,7,0,2,35
1237189,880478,2019-06-11,Assembly,"Assembly Rules Committee: Favorable",25,0,0,6,31
1237197,857027,2019-05-01,Assembly,"Assembly Education Committee: Favorable refer to committee Ways and Means",28,0,0,3,31
1237197,884933,2019-06-19,Assembly,"Assembly Rules Committee: Favorable",28,0,0,3,31
1237197,884934,2019-06-19,Assembly,"Assembly Ways And Means Committee: Favorable refer to committee Rules",33,0,0,2,35
1237201,857218,2019-04-30,Assembly,"Assembly Ways And Means Committee: Favorable",25,8,0,2,35
1237201,867896,2019-05-20,Assembly,"Assembly Floor Vote - Final Passage",106,38,0,6,150
1237201,885632,2019-06-18,Senate,"Senate Floor Vote - Final Passage",53,9,0,0,62
1237203,880039,2019-06-11,Senate,"Senate Rules Committee Vote",19,0,0,0,19
1237203,880231,2019-06-11,Senate,"Senate Floor Vote - Final Passage",61,0,0,1,62
1237319,857523,2019-04-30,Assembly,"Assembly Judiciary Committee: Favorable refer to committee Codes",13,6,0,2,21
1237332,855585,2019-04-30,Senate,"Senate Committee Vote",7,0,0,0,7
1237340,881074,2019-06-12,Assembly,"Assembly Local Governments Committee: Favorable refer to committee Ways and Means",17,0,0,2,19
1237340,882725,2019-06-17,Assembly,"Assembly Ways And Means Committee: Favorable refer to committee Rules",33,0,0,2,35
1237340,883576,2019-06-18,Assembly,"Assembly Rules Committee: Favorable",25,0,0,6,31
1237340,885018,2019-06-19,Assembly,"Assembly Floor Vote - Final Passage",147,0,0,3,150
1237340,886770,2019-06-20,Senate,"Senate Floor Vote - Final Passage",62,0,0,0,62
1237355,860354,2019-05-07,Assembly,"Assembly Environmental Conservation Committee: Favorable refer to committee Ways and Means",28,0,0,2,30
1237355,869053,2019-05-21,Assembly,"Assembly Ways And Means Committee: Favorable",32,0,0,3,35
1237356,868859,2019-05-21,Assembly,"Assembly Children And Families Committee: Favorable",15,0,0,1,16
1237356,877469,2019-06-03,Assembly,"Assembly Floor Vote - Final Passage",142,0,0,8,150
1237356,882277,2019-06-14,Senate,"Senate Floor Vote - Final Passage",61,1,0,0,62
1237368,878716,2019-06-06,Assembly,"Assembly Corporations, Authorities And Commissions Committee: Held for Consideration",18,7,0,1,26
1237374,824659,2019-03-19,Senate,"Senate Education Committee Vote",15,0,0,0,15
1237410,860930,2019-05-07,Assembly,"Assembly Governmental Employees Committee: Favorable refer to committee Ways and Means",14,0,0,0,14
1237410,869057,2019-05-21,Assembly,"Assembly Ways And Means Committee: Favorable",31,1,0,3,35
1237414,882174,2019-06-14,Senate,"Senate Floor Vote - Final Passage",43,19,0,0,62
1237414,882175,2019-06-14,Senate,"Senate Rules Committee Vote",18,1,0,0,19
1237414,972294,2020-07-20,Senate,"Senate Insurance Committee Vote",9,2,0,0,11
1237414,973475,2020-07-22,Senate,"Senate Floor Vote - Final Passage",45,15,0,0,60
1237414,973811,2020-07-21,Senate,"Senate Rules Committee Vote",13,6,0,0,19
1237418,868880,2019-05-21,Assembly,"Assembly Children And Families Committee: Favorable refer to committee Codes",15,0,0,1,16
1237418,875076,2019-05-30,Assembly,"Assembly Codes Committee: Favorable",19,0,0,3,22
1237418,877766,2019-06-04,Assembly,"Assembly Floor Vote - Final Passage",147,0,0,3,150
1237418,881946,2019-06-12,Senate,"Senate Floor Vote - Final Passage",62,0,0,0,62
1237434,971978,2020-07-17,Assembly,"Assembly Codes Committee: Held for Consideration",15,6,0,1,22
1237441,875567,2019-05-29,Senate,"Senate Insurance Committee Vote",11,0,0,0,11
1237441,882973,2019-06-17,Senate,"Senate Floor Vote - Final Passage",50,12,0,0,62
1237441,882974,2019-06-17,Senate,"Senate Rules Committee Vote",17,2,0,0,19
1237446,878479,2019-06-05,Assembly,"Assembly Education Committee: Favorable refer to committee Ways and Means",27,2,0,2,31
1237446,882051,2019-06-14,Assembly,"Assembly Ways And Means Committee: Favorable refer to committee Rules",30,0,0,5,35
1237446,882490,2019-06-17,Assembly,"Assembly Rules Committee: Favorable",26,0,0,5,31
1237446,884506,2019-06-18,Assembly,"Assembly Floor Vote - Final Passage",146,0,0,4,150
1237454,878692,2019-06-06,Assembly,"Assembly Environmental Conservation Committee: Favorable refer to committee Ways and Means",28,0,0,2,30
1237454,882046,2019-06-14,Assembly,"Assembly Ways And Means Committee: Favorable refer to committee Rules",30,0,0,5,35
1237454,882500,2019-06-17,Assembly,"Assembly Rules Committee: Favorable",26,0,0,5,31
1237454,884403,2019-06-18,Assembly,"Assembly Floor Vote - Final Passage",145,1,0,4,150
1237454,886654,2019-06-19,Senate,"Senate Floor Vote - Final Passage",62,0,0,0,62
1237460,883259,2019-06-17,Assembly,"Assembly Labor Committee: Favorable refer to committee Ways and Means",27,1,0,1,29
1237460,884753,2019-06-19,Assembly,"Assembly Ways And Means Committee: Favorable refer to committee Rules",28,5,0,2,35
1237460,885253,2019-06-20,Assembly,"Assembly Rules Committee: Favorable",23,4,0,4,31
1237476,882331,2019-06-14,Assembly,"Assembly Ways And Means Committee: Favorable refer to committee Rules",30,0,0,5,35
1237476,882499,2019-06-17,Assembly,"Assembly Rules Committee: Favorable",26,0,0,5,31
1237483,970830,2020-07-13,Assembly,"Assembly Mental Health Committee: Favorable refer to committee Rules",13,0,0,0,13
1237483,972825,2020-07-21,Assembly,"Assembly Rules Committee: Favorable",26,0,0,4,30
1237524,824141,2019-03-19,Assembly,"Assembly Aging Committee: Favorable refer to committee Ways and Means",26,0,0,4,30
1237529,874076,2019-05-29,Senate,"Senate Civil Service and Pensions Committee Vote",7,0,0,0,7
1237529,886228,2019-06-03,Senate,"Senate Rules Committee Vote",19,0,0,0,19
1237562,828950,2019-03-26,Senate,"Senate Investigations and Government Operations Committee Vote",7,0,0,0,7
1237562,879107,2019-06-06,Senate,"Senate Rules Committee Vote",18,1,0,0,19
1237562,881977,2019-06-14,Senate,"Senate Floor Vote - Final Passage",53,9,0,0,62
1237598,841360,2019-03-18,Senate,"Senate Mental Health and Developmental Disabilities Committee Vote",7,0,0,0,7
1237598,841361,2019-04-10,Senate,"Senate Floor Vote - Final Passage",56,3,0,3,62
1237598,880341,2019-06-11,Senate,"Senate Floor Vote - Final Passage",60,1,0,1,62
1237598,887703,2019-06-20,Senate,"Senate Floor Vote - Final Passage",62,0,0,0,62
1237670,855672,2019-04-30,Senate,"Senate Children and Families Committee Vote",7,0,0,0,7
1237724,868143,2019-05-20,Senate,"Senate Rules Committee Vote",18,0,0,1,19
1237724,868144,2019-05-21,Senate,"Senate Floor Vote - Final Passage",61,0,0,1,62
1237724,877123,2019-06-03,Assembly,"Assembly Floor Vote - Final Passage",142,0,0,8,150
1237754,876784,2019-05-14,Senate,"Senate Higher Education Committee Vote",11,0,0,0,11
1237754,876785,2019-06-03,Senate,"Senate Floor Vote - Final Passage",62,0,0,0,62
1237754,880435,2019-06-11,Senate,"Senate Floor Vote - Final Passage",61,0,0,1,62
1237754,886476,2019-06-21,Assembly,"Assembly Floor Vote - Final Passage",144,0,0,6,150
1237770,882302,2019-04-30,Senate,"Senate Health Committee Vote",15,0,0,0,15
1237770,882303,2019-06-13,Senate,"Senate Floor Vote - Final Passage",62,0,0,0,62
1237873,857473,2019-04-30,Assembly,"Assembly Energy Committee: Favorable refer to committee Ways and Means",16,0,0,1,17
1237873,880604,2019-06-11,Assembly,"Assembly Ways And Means Committee: Favorable refer to committee Rules",33,0,0,2,35
1237873,881684,2019-06-14,Assembly,"Assembly Rules Committee: Favorable",25,0,0,6,31
1237873,884478,2019-06-18,Assembly,"Assembly Floor Vote - Final Passage",146,0,0,4,150
1237873,886774,2019-06-20,Senate,"Senate Floor Vote - Final Passage",62,0,0,0,62
1238024,877023,2019-06-03,Senate,"Senate Floor Vote - Final Passage",62,0,0,0,62
1238024,877312,2019-06-03,Senate,"Senate Rules Committee Vote",19,0,0,0,19
1238024,939652,2020-03-02,Senate,"Senate Corporations, Authorities and Commissions Committee Vote",6,0,0,1,7
1238184,874339,2019-05-14,Senate,"Senate Civil Service and Pensions Committee Vote",6,0,0,1,7
1238184,874340,2019-05-29,Senate,"Senate Floor Vote - Final Passage",60,0,0,2,62
1238184,877139,2019-06-03,Assembly,"Assembly Floor Vote - Final Passage",137,4,0,9,150
1238250,839101,2019-04-09,Senate,"Senate Health Committee Vote",15,0,0,0,15
1238250,839102,2019-04-09,Senate,"Senate Rules Committee Vote",16,2,0,1,19
1238250,844065,2019-04-09,Senate,"Senate Floor Vote - Final Passage",41,19,0,2,62
1238287,862940,2019-04-30,Senate,"Senate Civil Service and Pensions Committee Vote",7,0,0,0,7
1238287,862941,2019-05-13,Senate,"Senate Floor Vote - Final Passage",58,2,0,2,62
1238287,904459,2020-01-22,Senate,"Senate Civil Service and Pensions Committee Vote",7,0,0,0,7
1238287,913586,2020-02-03,Senate,"Senate Floor Vote - Final Passage",54,5,0,3,62
1238294,854432,2019-04-08,Senate,"Senate Alcoholism and Substance Abuse Committee Vote",7,0,0,0,7
1238294,854433,2019-04-29,Senate,"Senate Floor Vote - Final Passage",61,0,0,1,62
1238294,902010,2020-01-13,Senate,"Senate Alcoholism And Substance Abuse Committee Vote",7,0,0,0,7
1238294,914913,2020-02-04,Senate,"Senate Floor Vote - Final Passage",61,0,0,1,62
1238317,856108,2019-04-09,Senate,"Senate Cultural Affairs, Tourism, Parks and Recreation Committee Vote",7,0,0,0,7
1238317,856109,2019-05-01,Senate,"Senate Floor Vote - Final Passage",60,2,0,0,62
1238317,885016,2019-06-18,Assembly,"Assembly Floor Vote - Final Passage",146,0,0,4,150
1238363,878170,2019-05-29,Senate,"Senate Agriculture Committee Vote",9,0,0,0,9
1238363,878171,2019-06-05,Senate,"Senate Floor Vote - Final Passage",62,0,0,0,62
1238363,904948,2020-01-23,Senate,"Senate Agriculture Committee Vote",9,0,0,0,9
1238363,936036,2020-02-26,Senate,"Senate Floor Vote - Final Passage",60,0,0,2,62
1238363,972593,2020-07-21,Assembly,"Assembly Floor Vote - Final Passage",142,0,0,3,145
1238375,863972,2019-05-14,Senate,"Senate Health Committee Vote",15,0,0,0,15
1238375,868401,2019-05-21,Senate,"Senate Finance Committee Vote",23,0,0,0,23
1238375,877377,2019-06-04,Senate,"Senate Floor Vote - Final Passage",62,0,0,0,62
1238379,875427,2019-05-30,Senate,"Senate Floor Vote - Final Passage",55,3,0,4,62
1238379,875428,2019-05-30,Senate,"Senate Rules Committee Vote",17,1,0,1,19
1238399,884503,2019-05-30,Senate,"Senate Judiciary Committee Vote",12,2,0,1,15
1238399,886684,2019-06-19,Senate,"Senate Floor Vote - Final Passage",50,12,0,0,62
1238399,902976,2020-01-14,Senate,"Senate Judiciary Committee Vote",12,3,0,0,15
1238399,941338,2020-03-03,Senate,"Senate Floor Vote - Final Passage",49,13,0,0,62
1238546,860715,2019-05-06,Senate,"Senate Alcoholism and Substance Abuse Committee Vote",7,0,0,0,7
1238546,881978,2019-06-12,Senate,"Senate Floor Vote - Final Passage",62,0,0,0,62
1238546,881979,2019-06-12,Senate,"Senate Rules Committee Vote",19,0,0,0,19
1238546,933283,2020-02-24,Senate,"Senate Alcoholism and Substance Abuse Committee Vote",7,0,0,0,7
1238546,941285,2020-03-03,Senate,"Senate Finance Committee Vote",23,0,0,0,23
1238592,839739,2019-04-09,Assembly,"Assembly Ways And Means Committee: Favorable",31,1,0,3,35
1238592,839740,2019-04-09,Assembly,"Assembly Codes Committee: Favorable refer to committee Ways and Means",18,4,0,0,22
1238592,839741,2019-04-09,Assembly,"Assembly Environmental Conservation Committee: Favorable refer to committee Codes",29,0,0,1,30
1238992,855638,2019-04-30,Senate,"Senate Civil Service and Pensions Committee Vote",7,0,0,0,7
1238992,863525,2019-05-14,Senate,"Senate Finance Committee Vote",22,0,0,1,23
1238992,869315,2019-05-22,Senate,"Senate Floor Vote - Final Passage",61,0,0,1,62
1238996,860716,2019-05-06,Senate,"Senate Corporations, Authorities and Commissions Committee Vote",7,0,0,0,7
1238996,885400,2019-06-18,Senate,"Senate Floor Vote - Final Passage",62,0,0,0,62
1238996,886625,2019-06-18,Senate,"Senate Rules Committee Vote",18,1,0,0,19
1238996,941787,2020-03-02,Senate,"Senate Corporations, Authorities and Commissions Committee Vote",6,0,0,1,7
1239029,824688,2019-03-19,Assembly,"Assembly Agriculture Committee: Favorable refer to committee Ways and Means",20,0,0,1,21
1239029,881286,2019-06-12,Assembly,"Assembly Ways And Means Committee: Favorable refer to committee Rules",30,0,0,5,35
1239029,881694,2019-06-14,Assembly,"Assembly Rules Committee: Favorable",25,0,0,6,31
1239057,883064,2019-06-17,Senate,"Senate Floor Vote - Final Passage",62,0,0,0,62
1239057,883065,2019-06-17,Senate,"Senate Rules Committee Vote",19,0,0,0,19
1239058,881767,2019-06-12,Senate,"Senate Floor Vote - Final Passage",62,0,0,0,62
1239058,881768,2019-06-12,Senate,"Senate Rules Committee Vote",19,0,0,0,19
1239058,935206,2020-02-25,Senate,"Senate Transportation Committee Vote",15,0,0,0,15
1239152,972320,2020-07-20,Senate,"Senate Higher Education Committee Vote",11,0,0,0,11
1239152,973800,2020-07-21,Senate,"Senate Rules Committee Vote",19,0,0,0,19
1239152,973801,2020-07-22,Senate,"Senate Floor Vote - Final Passage",60,0,0,0,60
1239156,881961,2019-06-12,Senate,"Senate Floor Vote - Final Passage",62,0,0,0,62
1239156,881962,2019-06-12,Senate,"Senate Rules Committee Vote",19,0,0,0,19
1239163,971217,2020-07-14,Assembly,"Assembly Correction Committee: Held for Consideration",10,2,0,1,13
1239168,857128,2019-05-01,Assembly,"Assembly Education Committee: Favorable",28,0,0,3,31
1239168,861771,2019-05-08,Assembly,"Assembly Floor Vote - Final Passage",138,0,0,12,150
1239168,868617,2019-05-21,Senate,"Senate Floor Vote - Final Passage",61,0,0,1,62
1239182,877369,2019-06-04,Assembly,"Assembly Judiciary Committee: Favorable refer to committee Codes",21,0,0,0,21
1239182,882944,2019-06-17,Assembly,"Assembly Codes Committee: Favorable refer to committee Rules",20,0,0,2,22
1239182,884939,2019-06-19,Assembly,"Assembly Rules Committee: Favorable",27,0,0,4,31
1239182,886466,2019-06-21,Assembly,"Assembly Floor Vote - Final Passage",144,0,0,6,150
1239194,857508,2019-05-01,Assembly,"Assembly Education Committee: Favorable",28,0,0,3,31
1239194,861801,2019-05-08,Assembly,"Assembly Floor Vote - Final Passage",138,0,0,12,150
1239194,869842,2019-05-22,Senate,"Senate Floor Vote - Final Passage",61,0,0,1,62
1239195,971915,2020-07-17,Assembly,"Assembly Ways And Means Committee: Held for Consideration",22,10,0,2,34
1239216,881813,2019-06-14,Assembly,"Assembly Transportation Committee: Favorable refer to committee Ways and Means",24,0,0,1,25
1239216,882835,2019-06-17,Assembly,"Assembly Ways And Means Committee: Favorable refer to committee Rules",33,0,0,2,35
1239216,883639,2019-06-18,Assembly,"Assembly Rules Committee: Favorable",25,0,0,6,31
1239225,885167,2019-06-20,Assembly,"Assembly Rules Committee: Favorable",27,0,0,4,31
1239225,885168,2019-06-20,Assembly,"Assembly Ways And Means Committee: Favorable refer to committee Rules",34,0,0,1,35
1239240,971073,2020-07-14,Assembly,"Assembly Judiciary Committee: Held for Consideration",15,6,0,0,21
1239293,971684,2020-07-16,Assembly,"Assembly Governmental Operations Committee: Held for Consideration",10,4,0,0,14
1239306,832014,2019-03-26,Senate,"Senate Rules Committee Vote",18,1,0,0,19
1239306,832015,2019-03-29,Senate,"Senate Floor Vote - Final Passage",49,11,0,2,62
1239340,857491,2019-04-30,Assembly,"Assembly Labor Committee: Favorable",19,8,0,2,29
1239341,860987,2019-05-07,Senate,"Senate Children and Families Committee Vote",6,1,0,0,7
1239352,868091,2019-05-21,Assembly,"Assembly Rules Committee: Favorable",20,8,0,3,31
1239352,868092,2019-05-21,Assembly,"Assembly Codes Committee: Favorable refer to committee Rules",15,6,0,1,22
1239354,971148,2020-07-14,Assembly,"Assembly Insurance Committee: Held for Consideration",14,6,0,2,22
1239368,972024,2020-07-17,Assembly,"Assembly Ways And Means Committee: Held for Consideration",22,10,0,2,34
1239375,970874,2020-07-13,Assembly,"Assembly Children And Families Committee: Favorable refer to committee Codes",11,4,0,1,16
1239375,971772,2020-07-17,Assembly,"Assembly Codes Committee: Favorable refer to committee Rules",21,0,0,1,22
1239375,972201,2020-07-20,Assembly,"Assembly Rules Committee: Favorable",27,0,0,3,30
1239375,972271,2020-07-20,Assembly,"Assembly Floor Vote - Final Passage",141,0,0,4,145
1239380,883266,2019-06-17,Assembly,"Assembly Ways And Means Committee: Favorable refer to committee Rules",33,0,0,2,35
1239380,883267,2019-06-17,Assembly,"Assembly Real Property Taxation Committee: Favorable refer to committee Ways and Means",10,0,0,0,10
1239380,883539,2019-06-18,Assembly,"Assembly Rules Committee: Favorable",25,0,0,6,31
1239428,878570,2019-06-05,Assembly,"Assembly Ways And Means Committee: Favorable refer to committee Rules",31,0,0,4,35
1239428,882492,2019-06-17,Assembly,"Assembly Rules Committee: Favorable",26,0,0,5,31
1239433,885627,2019-06-18,Senate,"Senate Floor Vote - Final Passage",62,0,0,0,62
1239433,886263,2019-06-18,Senate,"Senate Rules Committee Vote",19,0,0,0,19
1239433,904783,2020-01-22,Senate,"Senate Committee Vote",7,0,0,0,7
1239433,942369,2020-03-03,Senate,"Senate Finance Committee Vote",23,0,0,0,23
1239437,971008,2020-07-14,Assembly,"Assembly Energy Committee: Held for Consideration",11,4,0,0,15
1239773,970918,2020-07-13,Assembly,"Assembly Corporations, Authorities And Commissions Committee: Favorable refer to committee Ways and Means",23,3,0,0,26
1239773,971737,2020-07-17,Assembly,"Assembly Ways And Means Committee: Favorable refer to committee Rules",32,0,0,2,34
1239773,972181,2020-07-20,Assembly,"Assembly Rules Committee: Favorable",27,0,0,3,30
1239773,972249,2020-07-20,Assembly,"Assembly Floor Vote - Final Passage",141,0,0,4,145
1239773,973647,2020-07-22,Senate,"Senate Floor Vote - Final Passage",59,1,0,0,60
1239778,860997,2019-05-07,Senate,"Senate Commerce, Economic Development and Small Business Committee Vote",9,0,0,0,9
1239778,863822,2019-05-14,Senate,"Senate Finance Committee Vote",21,1,0,1,23
1239778,868081,2019-05-21,Senate,"Senate Floor Vote - Final Passage",61,0,0,1,62
1239785,857501,2019-04-30,Assembly,"Assembly Labor Committee: Favorable",19,8,0,2,29
1239831,904848,2020-01-22,Assembly,"Assembly Health Committee: Favorable refer to committee Ways and Means",25,0,0,1,26
1239859,880381,2019-05-29,Senate,"Senate Insurance Committee Vote",11,0,0,0,11
1239859,880382,2019-06-11,Senate,"Senate Floor Vote - Final Passage",61,0,0,1,62
1239859,884118,2019-06-18,Assembly,"Assembly Floor Vote - Final Passage",146,0,0,4,150
1239884,859220,2019-04-08,Senate,"Senate Local Government Committee Vote",7,0,0,0,7
1239884,859561,2019-05-06,Senate,"Senate Floor Vote - Final Passage",57,4,0,1,62
1239884,867364,2019-05-20,Senate,"Senate Floor Vote - Final Passage",56,4,0,2,62
1239903,861615,2019-04-08,Senate,"Senate Codes Committee Vote",9,3,0,1,13
1239903,861616,2019-05-08,Senate,"Senate Floor Vote - Final Passage",38,23,0,1,62
1239903,868936,2019-05-21,Assembly,"Assembly Floor Vote - Final Passage",91,54,0,5,150
1239910,874745,2019-05-30,Senate,"Senate Domestic Animal Welfare Committee Vote",7,0,0,0,7
1239910,875407,2019-05-30,Senate,"Senate Domestic Animal Welfare Committee Vote",7,0,0,0,7
1239910,877417,2019-06-04,Senate,"Senate Floor Vote - Final Passage",47,15,0,0,62
1239910,882161,2019-06-14,Senate,"Senate Floor Vote - Final Passage",53,9,0,0,62
1239910,914097,2020-02-03,Senate,"Senate Domestic Animal Welfare Committee Vote",6,0,0,1,7
1239953,856494,2019-04-09,Senate,"Senate Labor Committee Vote",11,2,0,0,13
1239953,856495,2019-05-01,Senate,"Senate Floor Vote - Final Passage",48,14,0,0,62
1239953,886578,2019-06-21,Assembly,"Assembly Floor Vote - Final Passage",106,30,0,14,150
1240043,875562,2019-05-29,Senate,"Senate Racing, Gaming and Wagering Committee Vote",7,0,0,0,7
1240043,878037,2019-06-05,Senate,"Senate Rules Committee Vote",19,0,0,0,19
1240043,880116,2019-06-11,Senate,"Senate Floor Vote - Final Passage",58,3,0,1,62
1240104,883421,2019-05-30,Senate,"Senate Transportation Committee Vote",15,0,0,0,15
1240104,885046,2019-06-18,Senate,"Senate Floor Vote - Final Passage",61,1,0,0,62
1240104,974096,2020-07-20,Senate,"Senate Transportation Committee Vote",15,0,0,0,15
1240104,974097,2020-07-22,Senate,"Senate Rules Committee Vote",18,1,0,0,19
1240104,974098,2020-07-23,Senate,"Senate Floor Vote - Final Passage",59,1,0,0,60
1240165,880432,2019-04-09,Senate,"Senate Transportation Committee Vote",15,0,0,0,15
1240165,880433,2019-06-11,Senate,"Senate Floor Vote - Final Passage",61,0,0,1,62
1240165,884120,2019-06-18,Assembly,"Assembly Floor Vote - Final Passage",145,1,0,4,150
1240173,885378,2019-06-18,Senate,"Senate Floor Vote - Final Passage",39,23,0,0,62
1240173,886600,2019-06-18,Senate,"Senate Rules Committee Vote",12,7,0,0,19
1240187,857545,2019-04-30,Assembly,"Assembly Energy Committee: Favorable",16,0,0,1,17
1240229,830980,2019-03-26,Senate,"Senate Rules Committee Vote",19,0,0,0,19
1240229,830981,2019-03-28,Senate,"Senate Floor Vote - Final Passage",46,15,0,1,62
1240235,880986,2019-05-30,Senate,"Senate Alcoholism and Substance Abuse Committee Vote",7,0,0,0,7
1240235,882122,2019-06-12,Senate,"Senate Floor Vote - Final Passage",62,0,0,0,62
1240235,901907,2020-01-13,Senate,"Senate Alcoholism and Substance Abuse Committee Vote",7,0,0,0,7
1240235,914611,2020-02-04,Senate,"Senate Floor Vote - Final Passage",61,0,0,1,62
1240253,973257,2020-07-23,Assembly,"Assembly Rules Committee: Favorable",28,0,0,2,30
1240253,973258,2020-07-23,Assembly,"Assembly Ways And Means Committee: Favorable refer to committee Rules",32,1,0,1,34
1240253,973381,2020-07-23,Assembly,"Assembly Floor Vote - Final Passage",137,4,0,4,145
1240260,886286,2019-06-20,Assembly,"Assembly Rules Committee: Favorable",26,0,0,5,31
1240260,886287,2019-06-20,Assembly,"Assembly Ways And Means Committee: Favorable refer to committee Rules",33,0,0,2,35
1240261,881810,2019-06-14,Assembly,"Assembly Transportation Committee: Favorable refer to committee Rules",24,0,0,1,25
1240261,882413,2019-06-17,Assembly,"Assembly Rules Committee: Favorable",26,0,0,5,31
1240261,883959,2019-06-18,Assembly,"Assembly Floor Vote - Final Passage",146,0,0,4,150
1240261,886719,2019-06-20,Senate,"Senate Floor Vote - Final Passage",62,0,0,0,62
1240266,861482,2019-05-07,Assembly,"Assembly Health Committee: Favorable refer to committee Ways and Means",22,0,0,4,26
1240270,883916,2019-06-18,Assembly,"Assembly Ways And Means Committee: Favorable refer to committee Rules",23,10,0,2,35
1240270,884935,2019-06-19,Assembly,"Assembly Rules Committee: Favorable",27,0,0,4,31
1240271,881109,2019-06-11,Assembly,"Assembly Codes Committee: Favorable refer to committee Ways and Means",22,0,0,0,22
1240274,878336,2019-06-05,Assembly,"Assembly Election Law Committee: Favorable refer to committee Rules",15,0,0,1,16
1240274,882451,2019-06-17,Assembly,"Assembly Rules Committee: Favorable",26,0,0,5,31
1240277,971301,2020-07-14,Assembly,"Assembly Correction Committee: Held for Consideration",10,2,0,1,13
1240282,864846,2019-05-14,Assembly,"Assembly Ways And Means Committee: Favorable",28,4,0,3,35
1240282,867873,2019-05-20,Assembly,"Assembly Floor Vote - Final Passage",108,36,0,6,150
1240282,882144,2019-06-14,Senate,"Senate Floor Vote - Final Passage",53,9,0,0,62
1240295,971222,2020-07-14,Assembly,"Assembly Correction Committee: Held for Consideration",10,2,0,1,13
1240308,971121,2020-07-14,Assembly,"Assembly Judiciary Committee: Held for Consideration",15,6,0,0,21
1240314,882224,2019-06-13,Assembly,"Assembly Codes Committee: Favorable refer to committee Rules",20,0,0,2,22
1240314,882457,2019-06-17,Assembly,"Assembly Rules Committee: Favorable",26,0,0,5,31
1240314,884381,2019-06-18,Assembly,"Assembly Floor Vote - Final Passage",134,12,0,4,150
1240317,868628,2019-05-21,Assembly,"Assembly Correction Committee: Favorable",8,2,0,3,13
1240317,972836,2020-07-21,Senate,"Senate Floor Vote - Final Passage",49,11,0,0,60
1240317,972837,2020-07-21,Assembly,"Assembly Floor Vote - Final Passage",136,6,0,3,145
1240327,971388,2020-07-16,Assembly,"Assembly Governmental Operations Committee: Held for Consideration",10,4,0,0,14
1240401,886736,2019-06-19,Senate,"Senate Floor Vote - Final Passage",62,0,0,0,62
1240401,887376,2019-06-19,Senate,"Senate Rules Committee Vote",19,0,0,0,19
1240401,903111,2020-01-14,Senate,"Senate Judiciary Committee Vote",15,0,0,0,15
1240468,860691,2019-05-06,Senate,"Senate Local Government Committee Vote",7,0,0,0,7
1240468,886543,2019-06-20,Senate,"Senate Floor Vote - Final Passage",62,0,0,0,62
1240468,887364,2019-06-20,Senate,"Senate Rules Committee Vote",19,0,0,0,19
1240499,868885,2019-05-21,Assembly,"Assembly Cities Committee: Favorable refer to committee Ways and Means",15,0,0,0,15
1240499,874763,2019-05-30,Assembly,"Assembly Ways And Means Committee: Favorable",30,1,0,4,35
1240499,878055,2019-06-04,Assembly,"Assembly Floor Vote - Final Passage",146,1,0,3,150
1240499,882127,2019-06-14,Senate,"Senate Floor Vote - Final Passage",62,0,0,0,62
1240523,883038,2019-06-17,Senate,"Senate Floor Vote - Final Passage",62,0,0,0,62
1240523,883039,2019-06-17,Senate,"Senate Rules Committee Vote",19,0,0,0,19
1240523,886234,2019-06-21,Assembly,"Assembly Floor Vote - Final Passage",141,0,0,9,150
1240534,971919,2020-07-17,Assembly,"Assembly Ways And Means Committee: Held for Consideration",22,10,0,2,34
1240539,878714,2019-06-06,Assembly,"Assembly Corporations, Authorities And Commissions Committee: Favorable refer to committee Rules",25,0,0,1,26
1240539,880496,2019-06-11,Assembly,"Assembly Rules Committee: Favorable",25,0,0,6,31
1240550,971659,2020-07-16,Assembly,"Assembly Governmental Operations Committee: Favorable refer to committee Rules",14,0,0,0,14
1240550,973262,2020-07-23,Assembly,"Assembly Rules Committee: Favorable",28,0,0,2,30
1240556,876803,2019-06-03,Assembly,"Assembly Consumer Affairs And Protection Committee: Favorable refer to committee Rules",15,0,0,1,16
1240556,882427,2019-06-17,Assembly,"Assembly Rules Committee: Favorable",26,0,0,5,31
1240564,870257,2019-05-21,Assembly,"Assembly Governmental Employees Committee: Favorable refer to committee Ways and Means",14,0,0,0,14
1240564,884327,2019-06-18,Assembly,"Assembly Ways And Means Committee: Favorable refer to committee Rules",32,1,0,2,35
1240564,885226,2019-06-20,Assembly,"Assembly Rules Committee: Favorable",27,0,0,4,31
1240607,876046,2019-05-30,Assembly,"Assembly Governmental Operations Committee: Favorable refer to committee Codes",12,0,0,2,14
1240607,881424,2019-06-13,Assembly,"Assembly Codes Committee: Favorable refer to committee Rules",20,0,0,2,22
1240607,882539,2019-06-17,Assembly,"Assembly Rules Committee: Favorable",26,0,0,5,31
1240695,971795,2020-07-16,Assembly,"Assembly Governmental Employees Committee: Held for Consideration",10,4,0,0,14
1240704,877133,2019-06-04,Assembly,"Assembly Mental Health Committee: Favorable refer to committee Codes",12,0,0,1,13
1240704,882636,2019-06-17,Assembly,"Assembly Codes Committee: Favorable refer to committee Ways and Means",20,0,0,2,22
1240704,883592,2019-06-18,Assembly,"Assembly Rules Committee: Favorable",25,0,0,6,31
1240704,883593,2019-06-18,Assembly,"Assembly Ways And Means Committee: Favorable refer to committee Rules",33,0,0,2,35
1240704,886279,2019-06-20,Assembly,"Assembly Floor Vote - Final Passage",146,0,0,4,150
1240704,886737,2019-06-20,Senate,"Senate Floor Vote - Final Passage",62,0,0,0,62
1240708,860885,2019-05-07,Senate,"Senate Committee Vote",7,0,0,0,7
1240754,839134,2019-04-09,Assembly,"Assembly Tourism, Arts And Sports Development Committee: Favorable refer to committee Ways and Means",20,0,0,0,20
1240754,857554,2019-04-30,Assembly,"Assembly Ways And Means Committee: Favorable",33,0,0,2,35
1240811,876686,2019-06-03,Assembly,"Assembly Social Services Committee: Favorable refer to committee Ways and Means",16,0,0,2,18
1240811,879235,2019-06-06,Assembly,"Assembly Ways And Means Committee: Favorable refer to committee Rules",29,2,0,4,35
1240811,880428,2019-06-11,Assembly,"Assembly Rules Committee: Favorable",25,0,0,6,31
1240811,883194,2019-06-17,Assembly,"Assembly Floor Vote - Final Passage",145,3,0,2,150
1240811,885811,2019-06-18,Senate,"Senate Floor Vote - Final Passage",62,0,0,0,62
1240994,949203,2020-03-10,Senate,"Senate Crime Victims, Crime and Correction Committee Vote",7,0,0,0,7
1241004,950205,2020-03-11,Assembly,"Assembly Local Governments Committee: Held for Consideration",11,5,0,2,18
1241012,971575,2020-07-16,Assembly,"Assembly Governmental Operations Committee: Held for Consideration",10,4,0,0,14
1241092,971790,2020-07-16,Assembly,"Assembly Local Governments Committee: Held for Consideration",15,4,0,1,20
1241103,859920,2019-04-09,Senate,"Senate Social Services Committee Vote",6,1,0,0,7
1241103,860372,2019-05-07,Senate,"Senate Floor Vote - Final Passage",50,11,0,1,62
1241103,875068,2019-05-29,Assembly,"Assembly Floor Vote - Final Passage",107,34,0,9,150
1241157,971986,2020-07-17,Assembly,"Assembly Ways And Means Committee: Held for Consideration",22,10,0,2,34
1241223,884429,2019-06-18,Senate,"Senate Rules Committee Vote",17,2,0,0,19
1241223,884430,2019-06-18,Assembly,"Assembly Floor Vote - Final Passage",106,42,0,2,150
1241223,885484,2019-06-18,Senate,"Senate Floor Vote - Final Passage",45,17,0,0,62
1241259,860692,2019-05-06,Senate,"Senate Agriculture Committee Vote",9,0,0,0,9
1241259,863812,2019-05-14,Senate,"Senate Finance Committee Vote",22,0,0,1,23
1241259,881832,2019-06-13,Senate,"Senate Floor Vote - Final Passage",62,0,0,0,62
1241259,885356,2019-06-19,Assembly,"Assembly Floor Vote - Final Passage",148,0,0,2,150
1241290,877994,2019-06-05,Assembly,"Assembly Local Governments Committee: Favorable refer to committee Ways and Means",18,0,0,1,19
1241290,879336,2019-06-06,Assembly,"Assembly Ways And Means Committee: Favorable refer to committee Rules",26,5,0,4,35
1241290,880548,2019-06-11,Assembly,"Assembly Rules Committee: Favorable",24,1,0,6,31
1241387,870429,2019-05-21,Assembly,"Assembly Education Committee: Favorable refer to committee Ways and Means",31,0,0,0,31
1241387,878409,2019-06-05,Assembly,"Assembly Ways And Means Committee: Favorable refer to committee Rules",31,0,0,4,35
1241387,880522,2019-06-11,Assembly,"Assembly Rules Committee: Favorable",25,0,0,6,31
1241393,838423,2019-04-08,Senate,"Senate Alcoholism and Substance Abuse Committee Vote",7,0,0,0,7
1241393,877159,2019-05-30,Senate,"Senate Floor Vote - Final Passage",58,0,0,4,62
1241393,877160,2019-05-30,Senate,"Senate Rules Committee Vote",18,0,0,1,19
1241401,877635,2019-05-08,Senate,"Senate Banks Committee Vote",11,0,0,0,11
1241401,877636,2019-06-04,Senate,"Senate Floor Vote - Final Passage",62,0,0,0,62
1241401,972919,2020-07-21,Senate,"Senate Banks Committee Vote",11,0,0,0,11
1241401,973599,2020-07-22,Senate,"Senate Floor Vote - Final Passage",60,0,0,0,60
1241401,973945,2020-07-21,Senate,"Senate Banks Committee Vote",11,0,0,0,11
1241446,863393,2019-05-14,Senate,"Senate Civil Service and Pensions Committee Vote",6,0,0,1,7
1241523,860742,2019-05-06,Senate,"Senate Agriculture Committee Vote",9,0,0,0,9
1241523,863610,2019-05-14,Senate,"Senate Finance Committee Vote",22,0,0,1,23
1241523,882095,2019-06-13,Senate,"Senate Floor Vote - Final Passage",62,0,0,0,62
1241523,914123,2020-02-03,Senate,"Senate Agriculture Committee Vote",9,0,0,0,9
1241523,935154,2020-02-25,Senate,"Senate Finance Committee Vote",22,0,0,1,23
1241523,939541,2020-03-02,Senate,"Senate Floor Vote - Final Passage",61,0,0,1,62
1241873,867682,2019-04-08,Senate,"Senate Housing, Construction and Community Development Committee Vote",11,0,0,0,11
1241873,867683,2019-05-20,Senate,"Senate Floor Vote - Final Passage",60,0,0,2,62
1241873,904804,2020-01-21,Senate,"Senate Housing, Construction and Community Development Committee Vote",11,0,0,0,11
1241876,885397,2019-06-18,Senate,"Senate Floor Vote - Final Passage",48,14,0,0,62
1241876,886581,2019-06-18,Senate,"Senate Rules Committee Vote",14,5,0,0,19
1241885,855611,2019-04-30,Senate,"Senate Committee Vote",7,0,0,0,7
1241885,943051,2020-03-03,Senate,"Senate Committee Vote",7,0,0,0,7
1241893,934470,2020-02-25,Assembly,"Assembly Governmental Operations Committee: Held for Consideration",9,4,0,1,14
1241921,882315,2019-06-13,Assembly,"Assembly Codes Committee: Held for Consideration",14,6,0,2,22
1241931,877190,2019-06-04,Assembly,"Assembly Housing Committee: Favorable refer to committee Codes",18,8,0,2,28
1241931,882677,2019-06-17,Assembly,"Assembly Codes Committee: Favorable refer to committee Rules",17,3,0,2,22
1241954,875148,2019-05-30,Assembly,"Assembly Social Services Committee: Favorable refer to committee Ways and Means",16,0,0,2,18
1241963,859933,2019-04-09,Senate,"Senate Investigations And Government Operations Committee Vote",6,1,0,0,7
1241963,860813,2019-05-07,Senate,"Senate Floor Vote - Final Passage",44,17,0,1,62
1241963,877319,2019-06-03,Assembly,"Assembly Floor Vote - Final Passage",142,0,0,8,150
1241976,878033,2019-06-05,Assembly,"Assembly Education Committee: Favorable refer to committee Ways and Means",25,4,0,2,31
1241976,879296,2019-06-06,Assembly,"Assembly Ways And Means Committee: Favorable refer to committee Rules",22,9,0,4,35
1241976,883952,2019-06-18,Assembly,"Assembly Rules Committee: Favorable",25,0,0,6,31
1241976,886164,2019-06-20,Assembly,"Assembly Floor Vote - Final Passage",128,19,0,3,150
1241976,973390,2020-07-22,Senate,"Senate Floor Vote - Final Passage",46,14,0,0,60
1241984,884212,2019-05-07,Senate,"Senate Commerce, Economic Development and Small Business Committee Vote",9,0,0,0,9
1241984,884213,2019-06-17,Senate,"Senate Floor Vote - Final Passage",62,0,0,0,62
1241984,902874,2020-01-14,Senate,"Senate Commerce, Economic Development and Small Business Committee Vote",9,0,0,0,9
1241984,919369,2020-02-10,Senate,"Senate Floor Vote - Final Passage",61,0,0,1,62
1241984,972510,2020-07-20,Assembly,"Assembly Floor Vote - Final Passage",141,0,0,4,145
1242011,868758,2019-05-21,Assembly,"Assembly Governmental Employees Committee: Favorable refer to committee Ways and Means",14,0,0,0,14
1242011,884312,2019-06-18,Assembly,"Assembly Ways And Means Committee: Favorable refer to committee Rules",32,1,0,2,35
1242011,884912,2019-06-19,Assembly,"Assembly Rules Committee: Favorable",27,0,0,4,31
1242013,876047,2019-05-30,Assembly,"Assembly Social Services Committee: Favorable refer to committee Ways and Means",16,0,0,2,18
1242015,859538,2019-04-08,Senate,"Senate Local Government Committee Vote",7,0,0,0,7
1242015,859539,2019-05-06,Senate,"Senate Floor Vote - Final Passage",58,3,0,1,62
1242015,932612,2020-02-24,Senate,"Senate Local Government Committee Vote",7,0,0,0,7
1242015,965126,2020-06-09,Senate,"Senate Floor Vote - Final Passage",60,2,0,0,62
1242015,965345,2020-06-10,Assembly,"Assembly Floor Vote - Final Passage",144,0,0,3,147
1242016,886532,2019-06-20,Senate,"Senate Floor Vote - Final Passage",62,0,0,0,62
1242016,886533,2019-06-21,Assembly,"Assembly Floor Vote - Final Passage",140,1,0,9,150
1242016,887140,2019-06-20,Senate,"Senate Rules Committee Vote",19,0,0,0,19
1242030,868008,2019-05-21,Assembly,"Assembly Veterans' Affairs Committee: Favorable",17,0,0,2,19
1242358,971262,2020-07-14,Assembly,"Assembly Education Committee: Held for Consideration",23,6,0,2,31
1242366,971947,2020-07-17,Assembly,"Assembly Codes Committee: Held for Consideration",15,6,0,1,22
1242370,874290,2019-05-29,Assembly,"Assembly Environmental Conservation Committee: Held for Consideration",21,8,0,1,30
1242422,972011,2020-07-17,Assembly,"Assembly Ways And Means Committee: Held for Consideration",22,10,0,2,34
1242554,882847,2019-06-17,Assembly,"Assembly Ways And Means Committee: Favorable refer to committee Rules",33,0,0,2,35
1242554,882848,2019-06-17,Assembly,"Assembly Real Property Taxation Committee: Favorable refer to committee Ways and Means",10,0,0,0,10
1242554,883624,2019-06-18,Assembly,"Assembly Rules Committee: Favorable",25,0,0,6,31
1242557,875570,2019-05-30,Senate,"Senate Health Committee Vote",15,0,0,0,15
1242557,877042,2019-06-03,Senate,"Senate Floor Vote - Final Passage",51,11,0,0,62
1242557,877334,2019-06-03,Senate,"Senate Rules Committee Vote",17,2,0,0,19
1242557,885044,2019-06-19,Assembly,"Assembly Floor Vote - Final Passage",144,5,0,1,150
1242565,861012,2019-05-07,Senate,"Senate Social Services Committee Vote",7,0,0,0,7
1242565,920973,2020-02-11,Senate,"Senate Social Services Committee Vote",7,0,0,0,7
1242566,863169,2019-04-08,Senate,"Senate Local Government Committee Vote",7,0,0,0,7
1242566,863170,2019-05-13,Senate,"Senate Floor Vote - Final Passage",58,2,0,2,62
1242566,964159,2020-06-09,Senate,"Senate Floor Vote - Final Passage",60,2,0,0,62
1242566,966184,2020-05-28,Senate,"Senate Rules Committee Vote",19,0,0,0,19
1242566,966185,2020-06-08,Senate,"Senate Local Government Committee Vote",7,0,0,0,7
1242664,881805,2019-06-14,Assembly,"Assembly Transportation Committee: Favorable refer to committee Rules",24,0,0,1,25
1242673,857509,2019-04-30,Assembly,"Assembly Correction Committee: Favorable",12,0,0,1,13
1242673,861683,2019-05-08,Assembly,"Assembly Floor Vote - Final Passage",97,41,0,12,150
1242673,868856,2019-05-21,Senate,"Senate Floor Vote - Final Passage",59,2,0,1,62
1242723,875412,2019-05-21,Senate,"Senate Higher Education Committee Vote",11,0,0,0,11
1242723,875413,2019-05-30,Senate,"Senate Floor Vote - Final Passage",58,0,0,4,62
1242727,882045,2019-06-13,Assembly,"Assembly Health Committee: Favorable refer to committee Rules",23,3,0,0,26
1242727,882496,2019-06-17,Assembly,"Assembly Rules Committee: Favorable",26,0,0,5,31
1242875,880016,2019-06-11,Senate,"Senate Rules Committee Vote",19,0,0,0,19
1242875,880509,2019-06-11,Senate,"Senate Floor Vote - Final Passage",61,0,0,1,62
1242917,885485,2019-06-18,Senate,"Senate Floor Vote - Final Passage",62,0,0,0,62
1242917,886673,2019-06-18,Senate,"Senate Rules Committee Vote",19,0,0,0,19
1242964,877884,2019-05-29,Senate,"Senate Civil Service and Pensions Committee Vote",7,0,0,0,7
1242964,878428,2019-06-05,Senate,"Senate Floor Vote - Final Passage",62,0,0,0,62
1242964,886343,2019-06-21,Assembly,"Assembly Floor Vote - Final Passage",142,2,0,6,150
1243013,884584,2019-06-18,Senate,"Senate Rules Committee Vote",17,2,0,0,19
1243013,885855,2019-06-18,Senate,"Senate Floor Vote - Final Passage",45,17,0,0,62
1243013,972713,2020-07-20,Senate,"Senate Investigations and Government Operations Committee Vote",5,1,0,0,6
1243013,972714,2020-07-21,Senate,"Senate Finance Committee Vote",21,2,0,0,23
1243013,973310,2020-07-22,Senate,"Senate Rules Committee Vote",17,2,0,0,19
1243013,973434,2020-07-23,Assembly,"Assembly Floor Vote - Final Passage",113,28,0,4,145
1243013,973657,2020-07-23,Senate,"Senate Floor Vote - Final Passage",38,22,0,0,60
1243295,868883,2019-05-21,Assembly,"Assembly Correction Committee: Favorable",8,2,0,3,13
1243343,882723,2019-06-17,Senate,"Senate Rules Committee Vote",19,0,0,0,19
1243343,883162,2019-06-17,Senate,"Senate Floor Vote - Final Passage",62,0,0,0,62
1243343,886330,2019-06-21,Assembly,"Assembly Floor Vote - Final Passage",141,3,0,6,150
1243355,864710,2019-05-14,Assembly,"Assembly Local Governments Committee: Favorable",18,0,0,1,19
1243355,870625,2019-05-22,Assembly,"Assembly Floor Vote - Final Passage",146,0,0,4,150
1243355,875205,2019-05-30,Senate,"Senate Floor Vote - Final Passage",58,0,0,4,62
1243374,833727,2019-04-02,Assembly,"Assembly Local Governments Committee: Favorable",17,0,0,2,19
1243374,838701,2019-04-08,Assembly,"Assembly Floor Vote - Final Passage",139,0,0,11,150
1243374,877608,2019-06-04,Senate,"Senate Floor Vote - Final Passage",62,0,0,0,62
1243405,882720,2019-06-17,Senate,"Senate Rules Committee Vote",19,0,0,0,19
1243405,883159,2019-06-17,Senate,"Senate Floor Vote - Final Passage",62,0,0,0,62
1243405,886347,2019-06-21,Assembly,"Assembly Floor Vote - Final Passage",140,4,0,6,150
1243416,859738,2019-05-06,Assembly,"Assembly Ways And Means Committee: Favorable refer to committee Rules",32,0,0,3,35
1243416,860027,2019-05-07,Assembly,"Assembly Rules Committee: Favorable",25,0,0,6,31
1243416,861134,2019-05-07,Assembly,"Assembly Floor Vote - Final Passage",136,0,0,14,150
1243416,861135,2019-05-08,Senate,"Senate Floor Vote - Final Passage",61,0,0,1,62
1243468,838447,2019-04-08,Senate,"Senate Alcoholism and Substance Abuse Committee Vote",7,0,0,0,7
1243468,856438,2019-04-30,Senate,"Senate Mental Health and Developmental Disabilities Committee Vote",7,0,0,0,7
1243468,863151,2019-05-13,Senate,"Senate Floor Vote - Final Passage",60,0,0,2,62
1243468,913956,2020-02-03,Senate,"Senate Rules Committee Vote",18,0,0,1,19
1243468,914711,2020-02-04,Senate,"Senate Floor Vote - Final Passage",61,0,0,1,62
1243468,972998,2020-07-21,Assembly,"Assembly Floor Vote - Final Passage",142,0,0,3,145
1243487,860689,2019-04-30,Senate,"Senate Veterans, Homeland Security and Military Affairs Committee Vote",9,0,0,0,9
1243487,860690,2019-05-07,Senate,"Senate Floor Vote - Final Passage",61,0,0,1,62
1243487,863400,2019-05-13,Assembly,"Assembly Floor Vote - Final Passage",141,0,0,9,150
1243535,855838,2019-04-08,Senate,"Senate Housing, Construction and Community Development Committee Vote",10,1,0,0,11
1243535,855839,2019-04-30,Senate,"Senate Floor Vote - Final Passage",43,19,0,0,62
1243535,921193,2020-02-11,Senate,"Senate Housing, Construction and Community Development Committee Vote",9,2,0,0,11
1243580,877277,2019-06-04,Senate,"Senate Floor Vote - Final Passage",40,22,0,0,62
1243580,877801,2019-06-04,Senate,"Senate Rules Committee Vote",14,5,0,0,19
1243585,878612,2019-05-29,Senate,"Senate Local Government Committee Vote",7,0,0,0,7
1243585,878863,2019-06-06,Senate,"Senate Floor Vote - Final Passage",58,3,0,1,62
1243585,885130,2019-06-19,Assembly,"Assembly Floor Vote - Final Passage",148,0,0,2,150
1243751,882296,2019-05-30,Senate,"Senate Judiciary Committee Vote",13,1,0,1,15
1243751,882297,2019-06-14,Senate,"Senate Floor Vote - Final Passage",51,11,0,0,62
1243751,933699,2020-02-25,Senate,"Senate Judiciary Committee Vote",12,2,0,1,15
1243751,972507,2020-07-21,Senate,"Senate Floor Vote - Final Passage",50,10,0,0,60
1243774,857534,2019-04-30,Assembly,"Assembly Consumer Affairs And Protection Committee: Favorable refer to committee Codes",16,0,0,0,16
1243774,859821,2019-05-07,Assembly,"Assembly Codes Committee: Favorable",20,0,0,2,22
1243774,865067,2019-05-15,Assembly,"Assembly Floor Vote - Final Passage",132,9,0,9,150
1243776,857065,2019-04-30,Assembly,"Assembly Judiciary Committee: Favorable refer to committee Codes",18,1,0,2,21
1243780,881485,2019-05-21,Senate,"Senate Health Committee Vote",15,0,0,0,15
1243780,881744,2019-06-13,Senate,"Senate Floor Vote - Final Passage",62,0,0,0,62
1243780,884313,2019-06-18,Assembly,"Assembly Floor Vote - Final Passage",146,0,0,4,150
1243812,878613,2019-05-20,Senate,"Senate Local Government Committee Vote",7,0,0,0,7
1243812,879080,2019-06-06,Senate,"Senate Floor Vote - Final Passage",59,2,0,1,62
1243812,883200,2019-06-17,Assembly,"Assembly Floor Vote - Final Passage",143,5,0,2,150
1243825,884763,2019-05-06,Senate,"Senate Local Government Committee Vote",5,2,0,0,7
1243825,885288,2019-06-18,Senate,"Senate Floor Vote - Final Passage",48,14,0,0,62
1243913,878975,2019-05-30,Senate,"Senate Cultural Affairs, Tourism, Parks and Recreation Committee Vote",6,1,0,0,7
1243913,878976,2019-06-06,Senate,"Senate Floor Vote - Final Passage",46,15,0,1,62
1244022,876970,2019-04-30,Senate,"Senate Consumer Protection Committee Vote",7,0,0,0,7
1244022,876971,2019-06-03,Senate,"Senate Floor Vote - Final Passage",62,0,0,0,62
1244022,886303,2019-06-21,Assembly,"Assembly Floor Vote - Final Passage",144,0,0,6,150
1244500,857712,2019-04-09,Senate,"Senate Domestic Animal Welfare Committee Vote",7,0,0,0,7
1244500,875423,2019-05-30,Senate,"Senate Rules Committee Vote",18,0,0,1,19
1244500,882104,2019-06-14,Senate,"Senate Floor Vote - Final Passage",62,0,0,0,62
1244500,884364,2019-06-18,Assembly,"Assembly Floor Vote - Final Passage",146,0,0,4,150
1244506,940492,2020-03-02,Senate,"Senate Agriculture Committee Vote",9,0,0,0,9
1244521,868068,2019-05-21,Senate,"Senate Floor Vote - Final Passage",61,0,0,1,62
1244521,873133,2019-05-21,Senate,"Senate Consumer Protection Committee Vote",7,0,0,0,7
1244521,873134,2019-05-21,Senate,"Senate Rules Committee Vote",19,0,0,0,19
1244528,861024,2019-05-07,Senate,"Senate Health Committee Vote",15,0,0,0,15
1244538,885148,2019-06-19,Senate,"Senate Rules Committee Vote",19,0,0,0,19
1244538,886457,2019-06-19,Senate,"Senate Floor Vote - Final Passage",62,0,0,0,62
1244618,839621,2019-04-09,Senate,"Senate Social Services Committee Vote",7,0,0,0,7
1244618,863973,2019-05-14,Senate,"Senate Finance Committee Vote",18,4,0,1,23
1244618,882081,2019-06-14,Senate,"Senate Floor Vote - Final Passage",48,14,0,0,62
1244618,883333,2019-06-17,Assembly,"Assembly Floor Vote - Final Passage",98,48,0,4,150
1244715,839613,2019-04-09,Senate,"Senate Health Committee Vote",15,0,0,0,15
1244720,880077,2019-05-13,Senate,"Senate Investigations And Government Operations Committee Vote",7,0,0,0,7
1244720,880570,2019-06-11,Senate,"Senate Floor Vote - Final Passage",61,0,0,1,62
1244720,884071,2019-06-18,Assembly,"Assembly Floor Vote - Final Passage",144,3,0,3,150
1244824,877310,2019-06-04,Assembly,"Assembly Judiciary Committee: Favorable refer to committee Codes",15,6,0,0,21
1244824,881386,2019-06-13,Assembly,"Assembly Codes Committee: Favorable refer to committee Rules",14,6,0,2,22
1244824,884666,2019-06-19,Assembly,"Assembly Rules Committee: Favorable",27,0,0,4,31
1244955,972697,2020-07-20,Senate,"Senate Housing, Construction and Community Development Committee Vote",8,3,0,0,11
1244955,973469,2020-07-22,Senate,"Senate Floor Vote - Final Passage",42,18,0,0,60
1244955,973829,2020-07-21,Senate,"Senate Rules Committee Vote",13,6,0,0,19
1245180,886105,2019-06-20,Assembly,"Assembly Rules Committee: Favorable",27,0,0,4,31
1245180,886106,2019-06-20,Assembly,"Assembly Ways And Means Committee: Favorable refer to committee Rules",33,0,0,2,35
1245185,877900,2019-06-05,Assembly,"Assembly Governmental Employees Committee: Favorable refer to committee Ways and Means",14,0,0,0,14
1245185,881576,2019-06-13,Assembly,"Assembly Ways And Means Committee: Favorable refer to committee Rules",28,1,0,6,35
1245185,882454,2019-06-17,Assembly,"Assembly Rules Committee: Favorable",26,0,0,5,31
1245185,884491,2019-06-18,Assembly,"Assembly Floor Vote - Final Passage",144,3,0,3,150
1245185,885538,2019-06-18,Senate,"Senate Floor Vote - Final Passage",62,0,0,0,62
1245189,970779,2020-07-13,Assembly,"Assembly Health Committee: Held for Consideration",18,6,0,2,26
1245209,877495,2019-06-04,Assembly,"Assembly Economic Development Committee: Favorable refer to committee Codes",23,1,0,2,26
1245209,880461,2019-06-11,Assembly,"Assembly Codes Committee: Favorable refer to committee Rules",22,0,0,0,22
1245209,882463,2019-06-17,Assembly,"Assembly Rules Committee: Favorable",26,0,0,5,31
1245213,881947,2019-06-12,Senate,"Senate Floor Vote - Final Passage",62,0,0,0,62
1245213,881948,2019-06-12,Senate,"Senate Rules Committee Vote",19,0,0,0,19
1245218,877018,2019-04-30,Senate,"Senate Mental Health and Developmental Disabilities Committee Vote",7,0,0,0,7
1245218,877019,2019-06-03,Senate,"Senate Floor Vote - Final Passage",62,0,0,0,62
1245218,902947,2020-01-15,Senate,"Senate Mental Health and Developmental Disabilities Committee Vote",7,0,0,0,7
1245218,909861,2020-01-29,Senate,"Senate Floor Vote - Final Passage",58,0,0,4,62
1245242,878702,2019-06-06,Assembly,"Assembly Environmental Conservation Committee: Held for Consideration",21,7,0,2,30
1245251,971644,2020-07-16,Assembly,"Assembly Governmental Operations Committee: Held for Consideration",10,4,0,0,14
1245284,879156,2019-06-05,Assembly,"Assembly Transportation Committee: Held for Consideration",19,7,0,0,26
1245319,869983,2019-04-30,Senate,"Senate Health Committee Vote",14,1,0,0,15
1245319,869984,2019-05-22,Senate,"Senate Floor Vote - Final Passage",55,6,0,1,62
1245319,886516,2019-06-20,Assembly,"Assembly Floor Vote - Final Passage",122,24,0,4,150
1245342,971109,2020-07-14,Assembly,"Assembly Environmental Conservation Committee: Held for Consideration",19,8,0,1,28
1245374,879163,2019-06-05,Assembly,"Assembly Transportation Committee: Held for Consideration",19,7,0,0,26
1245412,883057,2019-06-17,Senate,"Senate Floor Vote - Final Passage",48,14,0,0,62
1245412,883058,2019-06-17,Senate,"Senate Rules Committee Vote",16,3,0,0,19
1245453,833696,2019-04-02,Assembly,"Assembly Health Committee: Favorable",24,0,0,2,26
1245453,838891,2019-04-08,Assembly,"Assembly Floor Vote - Final Passage",139,0,0,11,150
1245453,839914,2019-04-09,Senate,"Senate Floor Vote - Final Passage",41,19,0,2,62
1245604,885124,2019-06-18,Senate,"Senate Floor Vote - Final Passage",48,14,0,0,62
1245604,886438,2019-06-18,Senate,"Senate Rules Committee Vote",19,0,0,0,19
1245893,884112,2019-04-08,Senate,"Senate Elections Committee Vote",6,1,0,0,7
1245893,885080,2019-06-18,Senate,"Senate Floor Vote - Final Passage",58,4,0,0,62
1245893,918937,2020-02-10,Senate,"Senate Elections Committee Vote",6,1,0,0,7
1245906,885203,2019-06-19,Senate,"Senate Rules Committee Vote",19,0,0,0,19
1245906,886498,2019-06-19,Senate,"Senate Floor Vote - Final Passage",62,0,0,0,62
1245906,886499,2019-06-21,Assembly,"Assembly Floor Vote - Final Passage",103,38,0,9,150
1246069,877000,2019-04-30,Senate,"Senate Higher Education Committee Vote",11,0,0,0,11
1246069,877001,2019-06-03,Senate,"Senate Floor Vote - Final Passage",60,2,0,0,62
1246069,902655,2020-01-14,Senate,"Senate Higher Education Committee Vote",10,0,0,1,11
1246069,904538,2020-01-22,Senate,"Senate Floor Vote - Final Passage",60,1,0,1,62
1246097,839135,2019-04-09,Assembly,"Assembly Environmental Conservation Committee: Favorable refer to committee Ways and Means",29,0,0,1,30
1246097,864862,2019-05-14,Assembly,"Assembly Ways And Means Committee: Favorable",32,0,0,3,35
1246097,875653,2019-05-30,Assembly,"Assembly Floor Vote - Final Passage",143,0,0,7,150
1246097,880561,2019-06-11,Senate,"Senate Floor Vote - Final Passage",61,0,0,1,62
1246119,856756,2019-04-30,Senate,"Senate Transportation Committee Vote",13,2,0,0,15
1246132,875635,2019-05-30,Senate,"Senate Environmental Conservation Committee Vote",10,0,0,1,11
1246132,877325,2019-06-03,Senate,"Senate Rules Committee Vote",19,0,0,0,19
1246132,880155,2019-06-11,Senate,"Senate Floor Vote - Final Passage",61,0,0,1,62
1246132,884434,2019-06-18,Assembly,"Assembly Floor Vote - Final Passage",148,0,0,2,150
1246238,876831,2019-05-21,Senate,"Senate Mental Health and Developmental Disabilities Committee Vote",7,0,0,0,7
1246238,876832,2019-06-03,Senate,"Senate Floor Vote - Final Passage",62,0,0,0,62
1246238,914217,2020-02-04,Senate,"Senate Mental Health and Developmental Disabilities Committee Vote",7,0,0,0,7
1246293,856711,2019-04-30,Senate,"Senate Committee Vote",6,1,0,0,7
1246691,867975,2019-05-21,Assembly,"Assembly Health Committee: Favorable refer to committee Ways and Means",26,0,0,0,26
1246691,879381,2019-06-06,Assembly,"Assembly Ways And Means Committee: Favorable refer to committee Rules",31,0,0,4,35
1246691,880500,2019-06-11,Assembly,"Assembly Rules Committee: Favorable",25,0,0,6,31
1246696,857064,2019-04-30,Assembly,"Assembly Health Committee: Favorable refer to committee Ways and Means",25,0,0,1,26
1246696,878583,2019-06-05,Assembly,"Assembly Ways And Means Committee: Favorable refer to committee Rules",31,0,0,4,35
1246696,884855,2019-06-19,Assembly,"Assembly Rules Committee: Favorable",27,0,0,4,31
1246702,971335,2020-07-15,Assembly,"Assembly Small Business Committee: Held for Consideration",10,3,0,3,16
1246711,882237,2019-05-20,Senate,"Senate Local Government Committee Vote",5,2,0,0,7
1246711,882238,2019-06-14,Senate,"Senate Floor Vote - Final Passage",45,17,0,0,62
1246711,906665,2020-01-27,Senate,"Senate Local Government Committee Vote",5,2,0,0,7
1246711,920228,2020-02-11,Senate,"Senate Floor Vote - Final Passage",43,19,0,0,62
1246717,971077,2020-07-14,Assembly,"Assembly Judiciary Committee: Favorable refer to committee Rules",21,0,0,0,21
1246717,972795,2020-07-21,Assembly,"Assembly Rules Committee: Favorable",26,0,0,4,30
1246719,875470,2019-05-14,Senate,"Senate Judiciary Committee Vote",15,0,0,0,15
1246719,875471,2019-05-30,Senate,"Senate Floor Vote - Final Passage",58,0,0,4,62
1246719,877314,2019-06-03,Assembly,"Assembly Floor Vote - Final Passage",141,0,0,9,150
1246722,971235,2020-07-14,Assembly,"Assembly Education Committee: Held for Consideration",23,6,0,2,31
1246764,874166,2019-05-29,Senate,"Senate Civil Service and Pensions Committee Vote",6,1,0,0,7
1246764,881936,2019-06-12,Senate,"Senate Floor Vote - Final Passage",49,13,0,0,62
1246764,881937,2019-06-12,Senate,"Senate Rules Committee Vote",17,2,0,0,19
1246790,881156,2019-05-06,Senate,"Senate Local Government Committee Vote",7,0,0,0,7
1246790,881157,2019-06-11,Senate,"Senate Floor Vote - Final Passage",61,0,0,1,62
1246790,884015,2019-06-18,Assembly,"Assembly Floor Vote - Final Passage",114,31,0,5,150
1246801,832505,2019-03-31,Assembly,"Assembly Rules Committee: Favorable",26,0,0,5,31
1246801,832506,2019-03-31,Assembly,"Assembly Ways And Means Committee: Favorable refer to committee Rules",33,0,0,2,35
1246801,832536,2019-03-31,Assembly,"Assembly Floor Vote - Final Passage",147,1,0,2,150
1246801,832846,2019-04-01,Senate,"Senate Floor Vote - Final Passage",61,0,0,1,62
1246852,870258,2019-05-21,Assembly,"Assembly Governmental Employees Committee: Favorable refer to committee Ways and Means",14,0,0,0,14
1246852,882027,2019-06-14,Assembly,"Assembly Ways And Means Committee: Favorable refer to committee Rules",29,1,0,5,35
1246852,884951,2019-06-19,Assembly,"Assembly Rules Committee: Favorable",27,0,0,4,31
1246852,886212,2019-06-21,Assembly,"Assembly Floor Vote - Final Passage",142,2,0,6,150
1246852,963706,2020-06-09,Assembly,"Assembly Rules Committee: Favorable",27,0,0,4,31
1246852,963707,2020-06-09,Assembly,"Assembly Ways And Means Committee: Favorable refer to committee Rules",29,3,0,3,35
1246868,869195,2019-05-21,Senate,"Senate Rules Committee Vote",19,0,0,0,19
1246868,869196,2019-05-22,Senate,"Senate Floor Vote - Final Passage",61,0,0,1,62
1246912,971810,2020-07-16,Assembly,"Assembly Governmental Employees Committee: Held for Consideration",10,4,0,0,14
1246919,870262,2019-05-21,Assembly,"Assembly Governmental Employees Committee: Favorable refer to committee Ways and Means",14,0,0,0,14
1246919,884921,2019-06-19,Assembly,"Assembly Rules Committee: Favorable",28,0,0,3,31
1246919,884922,2019-06-19,Assembly,"Assembly Ways And Means Committee: Favorable refer to committee Rules",32,1,0,2,35
1246958,882147,2019-06-14,Senate,"Senate Floor Vote - Final Passage",62,0,0,0,62
1246958,882148,2019-06-14,Senate,"Senate Rules Committee Vote",19,0,0,0,19
1246958,884422,2019-06-18,Assembly,"Assembly Floor Vote - Final Passage",145,1,0,4,150
1247053,883804,2019-04-30,Senate,"Senate Health Committee Vote",13,2,0,0,15
1247053,885528,2019-06-18,Senate,"Senate Floor Vote - Final Passage",43,19,0,0,62
1247053,950287,2020-03-10,Senate,"Senate Health Committee Vote",11,3,0,1,15
1247129,881873,2019-06-12,Senate,"Senate Floor Vote - Final Passage",62,0,0,0,62
1247129,881874,2019-06-12,Senate,"Senate Rules Committee Vote",19,0,0,0,19
1247129,883133,2019-06-17,Assembly,"Assembly Floor Vote - Final Passage",122,25,0,3,150
1247178,868472,2019-04-30,Senate,"Senate Mental Health And Developmental Disabilities Committee Vote",7,0,0,0,7
1247178,868473,2019-05-21,Senate,"Senate Floor Vote - Final Passage",61,0,0,1,62
1247178,875594,2019-05-30,Assembly,"Assembly Floor Vote - Final Passage",143,0,0,7,150
1247185,875460,2019-05-30,Senate,"Senate Health Committee Vote",15,0,0,0,15
1247185,920315,2020-02-11,Senate,"Senate Health Committee Vote",15,0,0,0,15
1247185,941318,2020-03-03,Senate,"Senate Finance Committee Vote",23,0,0,0,23
1247277,919842,2020-02-11,Senate,"Senate Housing, Construction and Community Development Committee Vote",10,1,0,0,11
1247277,919843,2020-02-11,Senate,"Senate Rules Committee Vote",18,1,0,0,19
1247277,922003,2020-02-12,Senate,"Senate Floor Vote - Final Passage",51,9,0,2,62
1247499,839116,2019-04-09,Senate,"Senate Floor Vote - Final Passage",32,28,0,2,62
1247499,839117,2019-04-09,Senate,"Senate Rules Committee Vote",16,2,0,1,19
1247499,840739,2019-04-09,Assembly,"Assembly Floor Vote - Final Passage",95,51,0,4,150
1247720,880915,2019-05-30,Senate,"Senate Judiciary Committee Vote",14,0,0,1,15
1247720,882128,2019-06-12,Senate,"Senate Floor Vote - Final Passage",62,0,0,0,62
1247720,883355,2019-06-17,Assembly,"Assembly Floor Vote - Final Passage",148,0,0,2,150
1247724,839075,2019-04-09,Assembly,"Assembly Codes Committee: Favorable refer to committee Ways and Means",21,1,0,0,22
1247724,864280,2019-05-14,Assembly,"Assembly Ways And Means Committee: Favorable",22,10,0,3,35
1247732,880141,2019-06-03,Senate,"Senate Rules Committee Vote",18,1,0,0,19
1247732,880142,2019-06-11,Senate,"Senate Floor Vote - Final Passage",61,0,0,1,62
1247732,881668,2019-06-13,Assembly,"Assembly Floor Vote - Final Passage",125,15,0,10,150
1247786,882736,2019-06-12,Senate,"Senate Rules Committee Vote",19,0,0,0,19
1247786,882737,2019-06-17,Senate,"Senate Floor Vote - Final Passage",62,0,0,0,62
1247786,885199,2019-06-19,Assembly,"Assembly Floor Vote - Final Passage",146,1,0,3,150
1247843,839407,2019-04-09,Senate,"Senate Education Committee Vote",15,0,0,0,15
1247843,861236,2019-05-07,Senate,"Senate Finance Committee Vote",23,0,0,0,23
1247843,864700,2019-05-15,Senate,"Senate Floor Vote - Final Passage",57,1,0,4,62
1247843,883174,2019-06-17,Senate,"Senate Floor Vote - Final Passage",62,0,0,0,62
1247843,884066,2019-06-18,Assembly,"Assembly Floor Vote - Final Passage",147,1,0,2,150
1247935,854233,2019-04-29,Senate,"Senate Women's Issues Committee Vote",7,0,0,0,7
1247935,918817,2020-02-10,Senate,"Senate Women's Issues Committee Vote",7,0,0,0,7
1247959,839410,2019-04-09,Senate,"Senate Education Committee Vote",15,0,0,0,15
1247959,861256,2019-05-07,Senate,"Senate Finance Committee Vote",23,0,0,0,23
1247959,864696,2019-05-15,Senate,"Senate Floor Vote - Final Passage",58,0,0,4,62
1247959,878647,2019-06-05,Assembly,"Assembly Floor Vote - Final Passage",145,0,0,5,150
1248311,881981,2019-06-12,Senate,"Senate Floor Vote - Final Passage",62,0,0,0,62
1248311,881982,2019-06-12,Senate,"Senate Rules Committee Vote",19,0,0,0,19
1248311,908613,2020-01-28,Senate,"Senate Health Committee Vote",15,0,0,0,15
1248338,860700,2019-05-06,Senate,"Senate Agriculture Committee Vote",8,1,0,0,9
1248338,868613,2019-05-21,Senate,"Senate Finance Committee Vote",23,0,0,0,23
1248338,876656,2019-06-03,Senate,"Senate Floor Vote - Final Passage",62,0,0,0,62
1248371,870034,2019-04-30,Senate,"Senate Investigations and Government Operations Committee Vote",7,0,0,0,7
1248371,870035,2019-05-22,Senate,"Senate Floor Vote - Final Passage",61,0,0,1,62
1248371,884348,2019-06-18,Assembly,"Assembly Floor Vote - Final Passage",145,1,0,4,150
1248384,860913,2019-04-30,Senate,"Senate Transportation Committee Vote",15,0,0,0,15
1248384,861401,2019-05-08,Senate,"Senate Floor Vote - Final Passage",61,0,0,1,62
1248436,879993,2019-05-21,Senate,"Senate Consumer Protection Committee Vote",7,0,0,0,7
1248436,880557,2019-06-11,Senate,"Senate Floor Vote - Final Passage",61,0,0,1,62
1248436,902985,2020-01-15,Senate,"Senate Consumer Protection Committee Vote",7,0,0,0,7
1248436,906453,2020-01-27,Senate,"Senate Floor Vote - Final Passage",61,0,0,1,62
1248472,870269,2019-05-21,Assembly,"Assembly Governmental Employees Committee: Favorable refer to committee Ways and Means",14,0,0,0,14
1248472,886781,2019-06-19,Assembly,"Assembly Rules Committee: Favorable",28,0,0,3,31
1248472,886782,2019-06-19,Assembly,"Assembly Ways And Means Committee: Favorable refer to committee Rules",32,1,0,2,35
1248486,857666,2019-04-30,Assembly,"Assembly Corporations, Authorities And Commissions Committee: Favorable refer to committee Ways and Means",19,6,0,1,26
1248486,863702,2019-05-14,Assembly,"Assembly Ways And Means Committee: Favorable",29,3,0,3,35
1248493,878032,2019-06-05,Assembly,"Assembly Local Governments Committee: Favorable refer to committee Ways and Means",18,0,0,1,19
1248493,879335,2019-06-06,Assembly,"Assembly Ways And Means Committee: Favorable refer to committee Rules",31,0,0,4,35
1248493,882498,2019-06-17,Assembly,"Assembly Rules Committee: Favorable",26,0,0,5,31
1248500,971003,2020-07-14,Assembly,"Assembly Energy Committee: Held for Consideration",11,4,0,0,15
1248509,970817,2020-07-13,Assembly,"Assembly Economic Development Committee: Favorable refer to committee Rules",24,0,0,1,25
1248509,972232,2020-07-20,Assembly,"Assembly Rules Committee: Favorable",27,0,0,3,30
1248518,875247,2019-05-30,Assembly,"Assembly Judiciary Committee: Favorable",13,7,0,1,21
1248542,881136,2019-06-13,Assembly,"Assembly Health Committee: Favorable refer to committee Rules",26,0,0,0,26
1248542,882461,2019-06-17,Assembly,"Assembly Rules Committee: Favorable",26,0,0,5,31
1248542,884044,2019-06-18,Assembly,"Assembly Floor Vote - Final Passage",147,0,0,3,150
1248542,942792,2020-03-04,Senate,"Senate Floor Vote - Final Passage",62,0,0,0,62
1248578,885576,2019-06-18,Senate,"Senate Floor Vote - Final Passage",62,0,0,0,62
1248578,886705,2019-06-18,Senate,"Senate Rules Committee Vote",18,1,0,0,19
1248578,919623,2020-02-10,Senate,"Senate Higher Education Committee Vote",11,0,0,0,11
1248578,932187,2020-02-24,Senate,"Senate Floor Vote - Final Passage",59,0,0,3,62
1248594,838977,2019-04-09,Senate,"Senate Environmental Conservation Committee Vote",11,0,0,0,11
1248594,877304,2019-06-03,Senate,"Senate Rules Committee Vote",19,0,0,0,19
1248597,882756,2019-06-17,Assembly,"Assembly Local Governments Committee: Favorable refer to committee Rules",18,0,0,1,19
1248597,883994,2019-06-18,Assembly,"Assembly Rules Committee: Favorable",25,0,0,6,31
1248604,869089,2019-05-07,Senate,"Senate Children and Families Committee Vote",7,0,0,0,7
1248604,869090,2019-05-22,Senate,"Senate Floor Vote - Final Passage",56,5,0,1,62
1248604,878130,2019-06-04,Assembly,"Assembly Floor Vote - Final Passage",145,1,0,4,150
1248629,857514,2019-04-30,Assembly,"Assembly Real Property Taxation Committee: Favorable refer to committee Ways and Means",9,0,0,1,10
1248660,882862,2019-06-17,Assembly,"Assembly Ways And Means Committee: Favorable refer to committee Rules",33,0,0,2,35
1248660,882863,2019-06-17,Assembly,"Assembly Real Property Taxation Committee: Favorable refer to committee Ways and Means",10,0,0,0,10
1248660,883557,2019-06-18,Assembly,"Assembly Rules Committee: Favorable",25,0,0,6,31
1248660,885032,2019-06-19,Assembly,"Assembly Floor Vote - Final Passage",148,0,0,2,150
1248660,964485,2020-06-09,Senate,"Senate Floor Vote - Final Passage",60,2,0,0,62
1248712,867915,2019-05-21,Assembly,"Assembly Governmental Employees Committee: Favorable refer to committee Ways and Means",14,0,0,0,14
1248734,874751,2019-05-30,Assembly,"Assembly Codes Committee: Favorable",14,5,0,3,22
1248734,881717,2019-06-13,Assembly,"Assembly Floor Vote - Final Passage",103,37,0,10,150
1248746,882257,2019-06-14,Assembly,"Assembly Governmental Employees Committee: Favorable refer to committee Ways and Means",13,0,0,1,14
1248746,882657,2019-06-17,Assembly,"Assembly Rules Committee: Favorable",25,0,0,6,31
1248746,882658,2019-06-17,Assembly,"Assembly Ways And Means Committee: Favorable refer to committee Rules",32,1,0,2,35
1248751,880164,2019-05-29,Senate,"Senate Civil Service and Pensions Committee Vote",7,0,0,0,7
1248751,880165,2019-06-11,Senate,"Senate Floor Vote - Final Passage",61,0,0,1,62
1248756,875393,2019-05-30,Senate,"Senate Veterans, Homeland Security and Military Affairs Committee Vote",9,0,0,0,9
1248756,882064,2019-06-14,Senate,"Senate Floor Vote - Final Passage",62,0,0,0,62
1248756,882065,2019-06-14,Senate,"Senate Rules Committee Vote",19,0,0,0,19
1248765,971204,2020-07-14,Assembly,"Assembly Correction Committee: Held for Consideration",10,2,0,1,13
1248771,860728,2019-05-07,Assembly,"Assembly Environmental Conservation Committee: Favorable",28,0,0,2,30
1248771,865276,2019-05-15,Assembly,"Assembly Floor Vote - Final Passage",141,0,0,9,150
1248771,879145,2019-06-06,Senate,"Senate Floor Vote - Final Passage",61,0,0,1,62
1248803,885760,2019-06-18,Senate,"Senate Floor Vote - Final Passage",40,22,0,0,62
1248803,886585,2019-06-18,Senate,"Senate Rules Committee Vote",12,7,0,0,19
1248816,881135,2019-06-13,Assembly,"Assembly Health Committee: Favorable refer to committee Rules",26,0,0,0,26
1248816,883596,2019-06-18,Assembly,"Assembly Rules Committee: Favorable",25,0,0,6,31
1248816,885030,2019-06-19,Assembly,"Assembly Floor Vote - Final Passage",148,0,0,2,150
1248816,942686,2020-03-04,Senate,"Senate Floor Vote - Final Passage",62,0,0,0,62
1248833,972306,2019-05-06,Senate,"Senate Local Government Committee Vote",7,0,0,0,7
1248833,972307,2020-07-20,Senate,"Senate Local Government Committee Vote",5,2,0,0,7
1248833,974129,2020-07-22,Senate,"Senate Rules Committee Vote",14,5,0,0,19
1248833,974130,2020-07-23,Senate,"Senate Floor Vote - Final Passage",42,18,0,0,60
1248854,881965,2019-06-12,Senate,"Senate Floor Vote - Final Passage",62,0,0,0,62
1248854,881966,2019-06-12,Senate,"Senate Rules Committee Vote",19,0,0,0,19
1248854,883179,2019-06-17,Assembly,"Assembly Floor Vote - Final Passage",145,0,0,5,150
1248890,885926,2019-06-20,Assembly,"Assembly Ways And Means Committee: Favorable refer to committee Rules",34,0,0,1,35
1248890,886433,2019-06-20,Assembly,"Assembly Rules Committee: Favorable",27,0,0,4,31
1248890,886434,2019-06-21,Assembly,"Assembly Floor Vote - Final Passage",134,1,0,15,150
1248901,856042,2019-04-30,Senate,"Senate Health Committee Vote",15,0,0,0,15
1248914,863984,2019-05-14,Senate,"Senate Education Committee Vote",14,1,0,0,15
1248962,856183,2019-04-30,Senate,"Senate Mental Health and Developmental Disabilities Committee Vote",7,0,0,0,7
1248962,914162,2020-02-04,Senate,"Senate Mental Health and Developmental Disabilities Committee Vote",7,0,0,0,7
1248962,941902,2020-03-03,Senate,"Senate Finance Committee Vote",23,0,0,0,23
1248976,882145,2019-06-14,Senate,"Senate Floor Vote - Final Passage",42,20,0,0,62
1248976,882146,2019-06-14,Senate,"Senate Rules Committee Vote",13,6,0,0,19
1248976,973585,2020-07-22,Senate,"Senate Floor Vote - Final Passage",43,17,0,0,60
1248976,973956,2020-07-20,Senate,"Senate Judiciary Committee Vote",12,3,0,0,15
1248976,973957,2020-07-21,Senate,"Senate Rules Committee Vote",14,5,0,0,19
1249017,859583,2019-05-06,Senate,"Senate Corporations, Authorities and Commissions Committee Vote",7,0,0,0,7
1249017,863807,2019-05-14,Senate,"Senate Finance Committee Vote",22,0,0,1,23
1249017,875499,2019-05-30,Senate,"Senate Floor Vote - Final Passage",58,0,0,4,62
1249017,904240,2020-01-21,Senate,"Senate Corporations, Authorities and Commissions Committee Vote",7,0,0,0,7
1249041,875578,2019-05-30,Senate,"Senate New York City Education Committee Vote",7,0,0,0,7
1249120,857339,2019-04-30,Assembly,"Assembly Corporations, Authorities And Commissions Committee: Favorable refer to committee Ways and Means",25,0,0,1,26
1249120,863627,2019-05-14,Assembly,"Assembly Ways And Means Committee: Favorable",32,0,0,3,35
1249175,839155,2019-04-09,Assembly,"Assembly Governmental Operations Committee: Favorable",13,0,0,1,14
1249312,839095,2019-04-09,Senate,"Senate Rules Committee Vote",18,0,0,1,19
1249312,840044,2019-04-09,Senate,"Senate Floor Vote - Final Passage",60,0,0,2,62
1249312,870313,2019-05-22,Assembly,"Assembly Floor Vote - Final Passage",145,1,0,4,150
1249316,839055,2019-04-09,Assembly,"Assembly Rules Committee: Favorable",26,0,0,5,31
1249316,839056,2019-04-09,Assembly,"Assembly Ways And Means Committee: Favorable refer to committee Rules",32,0,0,3,35
1249316,839057,2019-04-09,Assembly,"Assembly Codes Committee: Favorable refer to committee Ways and Means",22,0,0,0,22
1249316,839058,2019-04-09,Assembly,"Assembly Governmental Operations Committee: Favorable refer to committee Codes",13,0,0,1,14
1249316,840796,2019-04-09,Assembly,"Assembly Floor Vote - Final Passage",93,53,0,4,150
1249316,883178,2019-06-17,Senate,"Senate Floor Vote - Final Passage",62,0,0,0,62
1249363,883644,2019-06-18,Assembly,"Assembly Local Governments Committee: Favorable refer to committee Ways and Means",17,0,0,2,19
1249363,886300,2019-06-20,Assembly,"Assembly Rules Committee: Favorable",27,0,0,4,31
1249363,886301,2019-06-20,Assembly,"Assembly Ways And Means Committee: Favorable refer to committee Rules",33,0,0,2,35
1249376,875764,2019-05-30,Assembly,"Assembly Agriculture Committee: Favorable refer to committee Codes",19,0,0,2,21
1249376,877182,2019-06-04,Assembly,"Assembly Codes Committee: Favorable refer to committee Rules",22,0,0,0,22
1249376,880397,2019-06-11,Assembly,"Assembly Rules Committee: Favorable",25,0,0,6,31
1249376,883382,2019-06-17,Assembly,"Assembly Floor Vote - Final Passage",148,0,0,2,150
1249376,886655,2019-06-20,Senate,"Senate Floor Vote - Final Passage",62,0,0,0,62
1249381,877972,2019-06-05,Assembly,"Assembly Local Governments Committee: Favorable refer to committee Ways and Means",18,0,0,1,19
1249381,879318,2019-06-06,Assembly,"Assembly Ways And Means Committee: Favorable refer to committee Rules",31,0,0,4,35
1249381,882475,2019-06-17,Assembly,"Assembly Rules Committee: Favorable",26,0,0,5,31
1249388,838835,2019-04-09,Assembly,"Assembly Governmental Operations Committee: Favorable refer to committee Codes",13,0,0,1,14
1249388,839098,2019-04-09,Assembly,"Assembly Rules Committee: Favorable",26,0,0,5,31
1249388,839099,2019-04-09,Assembly,"Assembly Ways And Means Committee: Favorable refer to committee Rules",32,0,0,3,35
1249388,839100,2019-04-09,Assembly,"Assembly Codes Committee: Favorable refer to committee Ways and Means",22,0,0,0,22
1249388,840707,2019-04-09,Assembly,"Assembly Floor Vote - Final Passage",146,0,0,4,150
1249388,877392,2019-06-04,Senate,"Senate Floor Vote - Final Passage",62,0,0,0,62
1249401,971469,2020-07-16,Assembly,"Assembly Transportation Committee: Held for Consideration",16,6,0,2,24
1249404,874635,2019-05-29,Assembly,"Assembly Environmental Conservation Committee: Favorable refer to committee Ways and Means",29,0,0,1,30
1249424,870411,2019-05-21,Assembly,"Assembly Education Committee: Favorable refer to committee Ways and Means",31,0,0,0,31
1249424,874761,2019-05-30,Assembly,"Assembly Ways And Means Committee: Favorable",31,0,0,4,35
1249425,863464,2019-05-14,Assembly,"Assembly Labor Committee: Favorable refer to committee Codes",26,0,0,3,29
1249428,882721,2019-06-17,Assembly,"Assembly Judiciary Committee: Favorable refer to committee Rules",17,1,0,3,21
1249428,884722,2019-06-19,Assembly,"Assembly Rules Committee: Favorable",27,0,0,4,31
1249434,839133,2019-04-09,Assembly,"Assembly Insurance Committee: Favorable refer to committee Codes",24,0,0,0,24
1249434,857403,2019-04-30,Assembly,"Assembly Codes Committee: Favorable",20,0,0,2,22
1249434,864942,2019-05-15,Assembly,"Assembly Floor Vote - Final Passage",141,0,0,9,150
1249434,881756,2019-06-12,Senate,"Senate Floor Vote - Final Passage",62,0,0,0,62
1249442,878474,2019-06-04,Assembly,"Assembly Governmental Operations Committee: Favorable refer to committee Ways and Means",12,0,0,2,14
1249737,839090,2019-04-09,Assembly,"Assembly Rules Committee: Favorable",26,0,0,5,31
1249737,839091,2019-04-09,Assembly,"Assembly Ways And Means Committee: Favorable refer to committee Rules",22,10,0,3,35
1249756,875425,2019-05-30,Senate,"Senate Floor Vote - Final Passage",58,0,0,4,62
1249756,875426,2019-05-30,Senate,"Senate Rules Committee Vote",18,0,0,1,19
1249758,868932,2019-05-21,Assembly,"Assembly Insurance Committee: Favorable refer to committee Codes",17,6,0,1,24
1249758,875096,2019-05-30,Assembly,"Assembly Codes Committee: Favorable",15,4,0,3,22
1249758,972850,2020-07-21,Assembly,"Assembly Floor Vote - Final Passage",108,34,0,3,145
1249771,857010,2019-04-30,Assembly,"Assembly Social Services Committee: Favorable refer to committee Ways and Means",13,5,0,0,18
1249807,840054,2019-04-09,Senate,"Senate Floor Vote - Final Passage",60,0,0,2,62
1249807,840055,2019-04-09,Senate,"Senate Rules Committee Vote",18,0,0,1,19
1249807,857313,2019-05-01,Assembly,"Assembly Floor Vote - Final Passage",141,0,0,9,150
1249817,840060,2019-04-09,Senate,"Senate Floor Vote - Final Passage",53,7,0,2,62
1249817,840061,2019-04-09,Senate,"Senate Rules Committee Vote",18,0,0,1,19
1249817,883999,2019-06-17,Assembly,"Assembly Floor Vote - Final Passage",110,37,0,3,150
1249902,861056,2019-04-30,Senate,"Senate Committee Vote",5,2,0,0,7
1249902,861057,2019-05-08,Senate,"Senate Floor Vote - Final Passage",39,22,0,1,62
1249902,870249,2019-05-22,Assembly,"Assembly Floor Vote - Final Passage",87,58,0,5,150
1249920,875823,2019-05-30,Senate,"Senate Higher Education Committee Vote",10,0,0,1,11
1249920,877037,2019-06-03,Senate,"Senate Floor Vote - Final Passage",62,0,0,0,62
1249920,877320,2019-06-03,Senate,"Senate Rules Committee Vote",19,0,0,0,19
1249920,920008,2020-02-10,Senate,"Senate Higher Education Committee Vote",11,0,0,0,11
1249926,886519,2019-06-19,Senate,"Senate Floor Vote - Final Passage",47,15,0,0,62
1249926,887355,2019-06-19,Senate,"Senate Rules Committee Vote",14,5,0,0,19
1249926,902700,2020-01-14,Senate,"Senate Education Committee Vote",12,3,0,0,15
1249926,951094,2020-03-11,Senate,"Senate Floor Vote - Final Passage",40,18,0,4,62
1249970,882263,2019-05-21,Senate,"Senate Housing, Construction and Community Development Committee Vote",10,1,0,0,11
1249970,882264,2019-06-14,Senate,"Senate Floor Vote - Final Passage",48,14,0,0,62
1249970,886170,2019-06-20,Assembly,"Assembly Floor Vote - Final Passage",122,24,0,4,150
1249972,868901,2019-05-21,Assembly,"Assembly Correction Committee: Favorable refer to committee Ways and Means",10,0,0,3,13
1249972,874781,2019-05-30,Assembly,"Assembly Ways And Means Committee: Favorable",31,0,0,4,35
1249981,882289,2019-04-30,Senate,"Senate Investigations and Government Operations Committee Vote",6,1,0,0,7
1249981,882290,2019-06-14,Senate,"Senate Floor Vote - Final Passage",53,9,0,0,62
1249981,884426,2019-06-18,Assembly,"Assembly Floor Vote - Final Passage",113,33,0,4,150
1250004,882271,2019-04-30,Senate,"Senate Investigations and Government Operations Committee Vote",6,1,0,0,7
1250004,882272,2019-06-14,Senate,"Senate Floor Vote - Final Passage",53,9,0,0,62
1250004,883304,2019-06-17,Assembly,"Assembly Floor Vote - Final Passage",119,29,0,2,150
1250018,971130,2020-07-14,Assembly,"Assembly Insurance Committee: Favorable refer to committee Rules",20,0,0,2,22
1250018,973774,2020-07-21,Assembly,"Assembly Rules Committee: Favorable",26,0,0,4,30
1250030,870728,2019-05-21,Assembly,"Assembly Education Committee: Favorable",31,0,0,0,31
1250041,971233,2020-07-14,Assembly,"Assembly Education Committee: Held for Consideration",23,6,0,2,31
1250062,882279,2019-04-30,Senate,"Senate Investigations and Government Operations Committee Vote",6,1,0,0,7
1250062,882280,2019-06-14,Senate,"Senate Floor Vote - Final Passage",53,9,0,0,62
1250062,884361,2019-06-18,Assembly,"Assembly Floor Vote - Final Passage",118,29,0,3,150
1250072,971028,2020-07-14,Assembly,"Assembly Education Committee: Favorable refer to committee Rules",29,0,0,2,31
1250072,972225,2020-07-20,Assembly,"Assembly Rules Committee: Favorable",27,0,0,3,30
1250080,886525,2019-06-20,Senate,"Senate Floor Vote - Final Passage",62,0,0,0,62
1250080,887339,2019-06-20,Senate,"Senate Rules Committee Vote",19,0,0,0,19
1250080,940879,2020-03-03,Senate,"Senate Committee Vote",7,0,0,0,7
1250205,883303,2019-05-07,Senate,"Senate Labor Committee Vote",12,0,0,1,13
1250205,885507,2019-06-18,Senate,"Senate Floor Vote - Final Passage",49,13,0,0,62
1250205,972751,2020-07-20,Senate,"Senate Labor Committee Vote",12,1,0,0,13
1250205,973476,2020-07-22,Senate,"Senate Floor Vote - Final Passage",45,15,0,0,60
1250205,973803,2020-07-21,Senate,"Senate Rules Committee Vote",15,4,0,0,19
1250206,856291,2019-04-30,Senate,"Senate Floor Vote - Final Passage",48,14,0,0,62
1250206,856292,2019-04-30,Senate,"Senate Rules Committee Vote",19,0,0,0,19
1250206,857061,2019-04-30,Assembly,"Assembly Floor Vote - Final Passage",123,21,0,6,150
1250215,882745,2019-06-17,Assembly,"Assembly Education Committee: Favorable refer to committee Ways and Means",27,0,0,4,31
1250215,883577,2019-06-18,Assembly,"Assembly Rules Committee: Favorable",25,0,0,6,31
1250215,883578,2019-06-18,Assembly,"Assembly Ways And Means Committee: Favorable refer to committee Rules",33,0,0,2,35
1250216,864298,2019-05-14,Senate,"Senate Committee Vote",7,0,0,0,7
1250236,874079,2019-05-29,Senate,"Senate Civil Service and Pensions Committee Vote",7,0,0,0,7
1250236,877029,2019-06-03,Senate,"Senate Floor Vote - Final Passage",62,0,0,0,62
1250236,877307,2019-06-03,Senate,"Senate Rules Committee Vote",19,0,0,0,19
1250255,860082,2019-05-07,Assembly,"Assembly Governmental Employees Committee: Favorable refer to committee Ways and Means",14,0,0,0,14
1250255,879265,2019-06-06,Assembly,"Assembly Ways And Means Committee: Favorable refer to committee Rules",31,0,0,4,35
1250255,880235,2019-06-11,Assembly,"Assembly Rules Committee: Favorable",25,0,0,6,31
1250255,883274,2019-06-17,Assembly,"Assembly Floor Vote - Final Passage",148,0,0,2,150
1250278,861369,2019-04-30,Senate,"Senate Higher Education Committee Vote",11,0,0,0,11
1250278,861370,2019-05-08,Senate,"Senate Floor Vote - Final Passage",61,0,0,1,62
1250278,907102,2020-01-28,Senate,"Senate Higher Education Committee Vote",11,0,0,0,11
1250278,943820,2020-03-04,Senate,"Senate Floor Vote - Final Passage",62,0,0,0,62
1250364,936032,2020-02-26,Assembly,"Assembly Education Committee: Favorable",31,0,0,0,31
1250364,940783,2020-03-02,Assembly,"Assembly Floor Vote - Final Passage",138,0,0,9,147
1250397,868053,2019-05-07,Senate,"Senate Health Committee Vote",15,0,0,0,15
1250397,868857,2019-05-21,Senate,"Senate Floor Vote - Final Passage",49,12,0,1,62
1250397,877114,2019-06-03,Assembly,"Assembly Floor Vote - Final Passage",140,1,0,9,150
1250455,857259,2019-05-01,Assembly,"Assembly Election Law Committee: Favorable",16,0,0,0,16
1250455,861692,2019-05-08,Assembly,"Assembly Floor Vote - Final Passage",112,26,0,12,150
1250455,869254,2019-05-22,Senate,"Senate Floor Vote - Final Passage",40,21,0,1,62
1250477,857016,2019-05-01,Assembly,"Assembly Education Committee: Favorable refer to committee Ways and Means",28,0,0,3,31
1250477,868009,2019-05-21,Assembly,"Assembly Ways And Means Committee: Favorable",32,0,0,3,35
1250477,877468,2019-06-03,Assembly,"Assembly Floor Vote - Final Passage",141,1,0,8,150
1250480,880956,2019-05-30,Senate,"Senate Transportation Committee Vote",15,0,0,0,15
1250480,882010,2019-06-12,Senate,"Senate Floor Vote - Final Passage",62,0,0,0,62
1250480,884216,2019-06-18,Assembly,"Assembly Floor Vote - Final Passage",147,1,0,2,150
1250486,874162,2019-05-06,Senate,"Senate Agriculture Committee Vote",8,1,0,0,9
1250486,874163,2019-05-29,Senate,"Senate Floor Vote - Final Passage",56,4,0,2,62
1250486,877753,2019-06-04,Assembly,"Assembly Floor Vote - Final Passage",147,0,0,3,150
1250493,878459,2019-06-05,Assembly,"Assembly Education Committee: Favorable refer to committee Ways and Means",29,0,0,2,31
1250557,860093,2019-05-07,Assembly,"Assembly Governmental Employees Committee: Favorable",13,1,0,0,14
1250585,859774,2019-05-06,Assembly,"Assembly Insurance Committee: Favorable refer to committee Ways and Means",22,0,0,2,24
1250585,878589,2019-06-04,Assembly,"Assembly Ways And Means Committee: Favorable refer to committee Rules",33,0,0,2,35
1250585,880528,2019-06-11,Assembly,"Assembly Rules Committee: Favorable",25,0,0,6,31
1250815,868942,2019-04-30,Senate,"Senate Energy and Telecommunications Committee Vote",9,0,0,0,9
1250815,868943,2019-05-21,Senate,"Senate Floor Vote - Final Passage",61,0,0,1,62
1250815,914169,2020-02-03,Senate,"Senate Energy and Telecommunications Committee Vote",9,0,0,0,9
1250815,920050,2020-02-11,Senate,"Senate Floor Vote - Final Passage",57,5,0,0,62
1250872,863975,2019-05-14,Senate,"Senate Mental Health and Developmental Disabilities Committee Vote",7,0,0,0,7
1250872,882914,2019-06-12,Senate,"Senate Floor Vote - Final Passage",62,0,0,0,62
1250872,882915,2019-06-12,Senate,"Senate Rules Committee Vote",19,0,0,0,19
1250877,879097,2019-06-06,Senate,"Senate Floor Vote - Final Passage",61,0,0,1,62
1250877,879098,2019-06-06,Senate,"Senate Rules Committee Vote",19,0,0,0,19
1250877,884179,2019-06-18,Assembly,"Assembly Floor Vote - Final Passage",127,21,0,2,150
1250916,878194,2019-06-05,Assembly,"Assembly Governmental Employees Committee: Favorable refer to committee Ways and Means",14,0,0,0,14
1250916,884775,2019-06-19,Assembly,"Assembly Ways And Means Committee: Favorable refer to committee Rules",31,2,0,2,35
1250916,886089,2019-06-20,Assembly,"Assembly Rules Committee: Favorable",26,0,0,5,31
1250916,886561,2019-06-21,Assembly,"Assembly Floor Vote - Final Passage",134,0,0,16,150
1250935,860967,2019-05-07,Senate,"Senate Elections Committee Vote",6,0,0,1,7
1250935,863828,2019-05-14,Senate,"Senate Finance Committee Vote",22,0,0,1,23
1250935,869184,2019-05-22,Senate,"Senate Floor Vote - Final Passage",40,21,0,1,62
1250946,868990,2019-05-21,Assembly,"Assembly Governmental Operations Committee: Favorable refer to committee Codes",12,2,0,0,14
1250946,874855,2019-05-30,Assembly,"Assembly Codes Committee: Favorable refer to committee Ways and Means",14,5,0,3,22
1250946,877176,2019-06-04,Assembly,"Assembly Ways And Means Committee: Favorable refer to committee Rules",22,11,0,2,35
1250946,880175,2019-06-11,Assembly,"Assembly Rules Committee: Favorable",25,0,0,6,31
1250946,886308,2019-06-20,Assembly,"Assembly Floor Vote - Final Passage",128,20,0,2,150
1250947,881907,2019-06-13,Senate,"Senate Floor Vote - Final Passage",61,1,0,0,62
1250947,881908,2019-06-13,Senate,"Senate Rules Committee Vote",19,0,0,0,19
1250953,870398,2019-05-21,Assembly,"Assembly Education Committee: Favorable refer to committee Ways and Means",31,0,0,0,31
1250953,878388,2019-06-05,Assembly,"Assembly Ways And Means Committee: Favorable refer to committee Rules",31,0,0,4,35
1250953,882468,2019-06-17,Assembly,"Assembly Rules Committee: Favorable",26,0,0,5,31
1250961,868887,2019-05-21,Assembly,"Assembly Economic Development Committee: Favorable refer to committee Codes",23,1,0,2,26
1250961,875075,2019-05-30,Assembly,"Assembly Codes Committee: Favorable",19,0,0,3,22
1250961,878602,2019-06-05,Assembly,"Assembly Floor Vote - Final Passage",142,3,0,5,150
1250961,881758,2019-06-12,Senate,"Senate Floor Vote - Final Passage",62,0,0,0,62
1250962,864533,2019-05-14,Assembly,"Assembly Health Committee: Favorable refer to committee Codes",24,0,0,2,26
1250962,884387,2019-06-17,Assembly,"Assembly Codes Committee: Favorable refer to committee Rules",20,0,0,2,22
1250962,885220,2019-06-20,Assembly,"Assembly Rules Committee: Favorable",27,0,0,4,31
1250962,886508,2019-06-21,Assembly,"Assembly Floor Vote - Final Passage",141,0,0,9,150
1250968,878201,2019-06-05,Assembly,"Assembly Governmental Employees Committee: Favorable refer to committee Rules",10,4,0,0,14
1250968,881701,2019-06-14,Assembly,"Assembly Rules Committee: Favorable",25,0,0,6,31
1251036,881787,2019-05-14,Senate,"Senate Civil Service and Pensions Committee Vote",6,0,0,1,7
1251036,882246,2019-06-14,Senate,"Senate Floor Vote - Final Passage",62,0,0,0,62
1251036,885345,2019-06-19,Assembly,"Assembly Floor Vote - Final Passage",146,2,0,2,150
1251037,878420,2019-05-07,Senate,"Senate Health Committee Vote",15,0,0,0,15
1251037,878421,2019-06-05,Senate,"Senate Floor Vote - Final Passage",44,18,0,0,62
1251049,875802,2019-05-30,Senate,"Senate Higher Education Committee Vote",10,0,0,1,11
1251070,857052,2019-04-30,Assembly,"Assembly Codes Committee: Favorable refer to committee Ways and Means",20,0,0,2,22
1251070,875620,2019-05-30,Assembly,"Assembly Ways And Means Committee: Favorable",29,2,0,4,35
1251070,878620,2019-06-05,Assembly,"Assembly Floor Vote - Final Passage",145,0,0,5,150
1251070,882779,2019-06-17,Senate,"Senate Floor Vote - Final Passage",62,0,0,0,62
1251076,874636,2019-05-29,Assembly,"Assembly Local Governments Committee: Favorable refer to committee Ways and Means",17,0,0,2,19
1251076,878397,2019-06-05,Assembly,"Assembly Ways And Means Committee: Favorable refer to committee Rules",25,6,0,4,35
1251076,882426,2019-06-17,Assembly,"Assembly Rules Committee: Favorable",26,0,0,5,31
1251320,914555,2019-06-19,Senate,"Senate Rules Committee Vote",19,0,0,0,19
1251320,914556,2020-02-03,Senate,"Senate Rules Committee Vote",18,0,0,1,19
1251320,914557,2020-02-04,Senate,"Senate Floor Vote - Final Passage",54,7,0,1,62
1251325,973656,2020-07-22,Senate,"Senate Floor Vote - Final Passage",46,14,0,0,60
1251325,973785,2020-07-21,Senate,"Senate Rules Committee Vote",18,1,0,0,19
1251325,973989,2020-07-21,Senate,"Senate Rules Committee Vote",18,1,0,0,19
1251345,884829,2019-05-07,Senate,"Senate Housing, Construction and Community Development Committee Vote",8,3,0,0,11
1251345,886247,2019-06-20,Assembly,"Assembly Floor Vote - Final Passage",103,44,0,3,150
1251345,886708,2019-06-19,Senate,"Senate Floor Vote - Final Passage",45,17,0,0,62
1251367,884440,2019-06-18,Senate,"Senate Rules Committee Vote",19,0,0,0,19
1251367,885497,2019-06-18,Senate,"Senate Floor Vote - Final Passage",62,0,0,0,62
1251396,857000,2019-04-30,Assembly,"Assembly Labor Committee: Favorable refer to committee Codes",19,8,0,2,29
1251396,860366,2019-05-07,Assembly,"Assembly Codes Committee: Favorable",13,7,0,2,22
1251398,878578,2019-06-05,Assembly,"Assembly Ways And Means Committee: Favorable refer to committee Rules",30,1,0,4,35
1251398,882448,2019-06-17,Assembly,"Assembly Rules Committee: Favorable",26,0,0,5,31
1251406,880947,2019-05-29,Senate,"Senate Insurance Committee Vote",11,0,0,0,11
1251406,882116,2019-06-12,Senate,"Senate Floor Vote - Final Passage",61,1,0,0,62
1251406,940498,2020-03-02,Senate,"Senate Insurance Committee Vote",11,0,0,0,11
1251424,884399,2019-06-18,Senate,"Senate Rules Committee Vote",18,1,0,0,19
1251424,885473,2019-06-18,Senate,"Senate Floor Vote - Final Passage",58,4,0,0,62
1251424,944540,2020-03-04,Senate,"Senate Consumer Protection Committee Vote",6,1,0,0,7
1251424,972506,2020-07-21,Senate,"Senate Floor Vote - Final Passage",57,3,0,0,60
1251437,881656,2019-05-29,Senate,"Senate Local Government Committee Vote",7,0,0,0,7
1251437,881932,2019-06-13,Senate,"Senate Floor Vote - Final Passage",54,8,0,0,62
1251437,884145,2019-06-18,Assembly,"Assembly Floor Vote - Final Passage",147,1,0,2,150
1251462,886193,2019-06-20,Assembly,"Assembly Floor Vote - Final Passage",105,41,0,4,150
1251462,886675,2019-06-18,Senate,"Senate Rules Committee Vote",19,0,0,0,19
1251462,886676,2019-06-19,Senate,"Senate Floor Vote - Final Passage",62,0,0,0,62
1251514,868015,2019-05-21,Assembly,"Assembly Rules Committee: Favorable",20,8,0,3,31
1251514,868016,2019-05-21,Assembly,"Assembly Ways And Means Committee: Favorable refer to committee Rules",21,11,0,3,35
1251538,902558,2020-01-14,Assembly,"Assembly Judiciary Committee: Favorable refer to committee Codes",17,4,0,0,21
1251538,907566,2020-01-28,Assembly,"Assembly Codes Committee: Favorable",21,0,0,1,22
1251538,914612,2020-01-28,Assembly,"Assembly Codes Committee: Favorable",21,0,0,1,22
1251544,875265,2019-05-14,Senate,"Senate Higher Education Committee Vote",11,0,0,0,11
1251544,875266,2019-05-30,Senate,"Senate Floor Vote - Final Passage",57,1,0,4,62
1251549,855398,2019-04-30,Senate,"Senate Investigations and Government Operations Committee Vote",7,0,0,0,7
1251549,941634,2020-03-03,Senate,"Senate Investigations and Government Operations Committee Vote",7,0,0,0,7
1251552,875566,2019-05-30,Senate,"Senate Health Committee Vote",13,2,0,0,15
1251561,875608,2019-05-30,Assembly,"Assembly Ways And Means Committee: Favorable",22,9,0,4,35
1251758,885245,2019-06-19,Assembly,"Assembly Ways And Means Committee: Favorable refer to committee Rules",33,0,0,2,35
1251758,885246,2019-06-20,Assembly,"Assembly Rules Committee: Favorable",27,0,0,4,31
1251784,970756,2020-07-13,Assembly,"Assembly Health Committee: Favorable refer to committee Rules",24,0,0,2,26
1251787,884252,2019-06-18,Assembly,"Assembly Local Governments Committee: Favorable refer to committee Ways and Means",17,0,0,2,19
1251787,884821,2019-06-19,Assembly,"Assembly Ways And Means Committee: Favorable refer to committee Rules",33,0,0,2,35
1251787,885240,2019-06-20,Assembly,"Assembly Rules Committee: Favorable",27,0,0,4,31
1251819,878972,2019-06-06,Assembly,"Assembly Environmental Conservation Committee: Favorable refer to committee Ways and Means",28,0,0,2,30
1251819,882066,2019-06-14,Assembly,"Assembly Ways And Means Committee: Favorable refer to committee Rules",30,0,0,5,35
1251819,882445,2019-06-17,Assembly,"Assembly Rules Committee: Favorable",26,0,0,5,31
1251819,884424,2019-06-18,Assembly,"Assembly Floor Vote - Final Passage",148,0,0,2,150
1251824,860299,2019-05-07,Assembly,"Assembly Small Business Committee: Favorable",15,0,0,2,17
1251824,864954,2019-05-15,Assembly,"Assembly Floor Vote - Final Passage",139,2,0,9,150
1251824,868281,2019-05-21,Senate,"Senate Floor Vote - Final Passage",61,0,0,1,62
1251829,878464,2019-06-04,Assembly,"Assembly Mental Health Committee: Favorable refer to committee Rules",12,0,0,1,13
1251829,880517,2019-06-11,Assembly,"Assembly Rules Committee: Favorable",25,0,0,6,31
1251875,863893,2019-04-30,Senate,"Senate Education Committee Vote",15,0,0,0,15
1251875,863894,2019-05-14,Senate,"Senate Floor Vote - Final Passage",59,0,0,3,62
1251875,883290,2019-06-17,Assembly,"Assembly Floor Vote - Final Passage",147,1,0,2,150
1251900,881804,2019-06-14,Assembly,"Assembly Transportation Committee: Favorable refer to committee Rules",24,0,0,1,25
1251900,883552,2019-06-18,Assembly,"Assembly Rules Committee: Favorable",25,0,0,6,31
1251900,885065,2019-06-19,Assembly,"Assembly Floor Vote - Final Passage",148,0,0,2,150
1252002,883354,2019-05-29,Senate,"Senate Elections Committee Vote",6,1,0,0,7
1252002,885200,2019-06-18,Senate,"Senate Floor Vote - Final Passage",62,0,0,0,62
1252002,904589,2020-01-21,Senate,"Senate Elections Committee Vote",7,0,0,0,7
1252002,921289,2020-02-11,Senate,"Senate Floor Vote - Final Passage",62,0,0,0,62
1252002,972257,2020-07-20,Assembly,"Assembly Floor Vote - Final Passage",141,0,0,4,145
1252040,870405,2019-05-21,Assembly,"Assembly Education Committee: Favorable refer to committee Ways and Means",31,0,0,0,31
1252040,874785,2019-05-30,Assembly,"Assembly Ways And Means Committee: Favorable",31,0,0,4,35
1252040,878833,2019-06-05,Assembly,"Assembly Floor Vote - Final Passage",145,0,0,5,150
1252040,885300,2019-06-18,Senate,"Senate Floor Vote - Final Passage",62,0,0,0,62
1252055,877033,2019-06-03,Senate,"Senate Floor Vote - Final Passage",60,2,0,0,62
1252055,877322,2019-06-03,Senate,"Senate Rules Committee Vote",18,1,0,0,19
1252055,883181,2019-06-17,Assembly,"Assembly Floor Vote - Final Passage",125,23,0,2,150
1252064,880002,2019-05-30,Senate,"Senate Environmental Conservation Committee Vote",9,1,0,1,11
1252064,880463,2019-06-11,Senate,"Senate Floor Vote - Final Passage",49,12,0,1,62
1252064,914461,2020-02-04,Senate,"Senate Environmental Conservation Committee Vote",10,1,0,0,11
1252064,949108,2020-03-11,Senate,"Senate Floor Vote - Final Passage",47,11,0,4,62
1252100,855438,2019-04-30,Senate,"Senate Education Committee Vote",15,0,0,0,15
1252100,868586,2019-05-21,Senate,"Senate Finance Committee Vote",23,0,0,0,23
1252178,874631,2019-05-29,Assembly,"Assembly Local Governments Committee: Favorable refer to committee Ways and Means",17,0,0,2,19
1252178,883249,2019-06-17,Assembly,"Assembly Ways And Means Committee: Favorable refer to committee Rules",33,0,0,2,35
1252178,883512,2019-06-18,Assembly,"Assembly Rules Committee: Favorable",25,0,0,6,31
1252178,885015,2019-06-19,Assembly,"Assembly Floor Vote - Final Passage",148,0,0,2,150
1252178,886733,2019-06-20,Senate,"Senate Floor Vote - Final Passage",62,0,0,0,62
1252254,881916,2019-06-06,Senate,"Senate Rules Committee Vote",19,0,0,0,19
1252254,881917,2019-06-14,Senate,"Senate Floor Vote - Final Passage",62,0,0,0,62
1252254,972648,2020-07-20,Senate,"Senate Civil Service and Pensions Committee Vote",7,0,0,0,7
1252254,972649,2020-07-21,Senate,"Senate Finance Committee Vote",23,0,0,0,23
1252254,973640,2020-07-22,Senate,"Senate Floor Vote - Final Passage",60,0,0,0,60
1252254,973778,2020-07-21,Senate,"Senate Finance Committee Vote",23,0,0,0,23
1252272,855049,2019-04-30,Senate,"Senate Civil Service and Pensions Committee Vote",6,1,0,0,7
1252272,880021,2019-06-11,Senate,"Senate Rules Committee Vote",18,1,0,0,19
1252272,880448,2019-06-11,Senate,"Senate Floor Vote - Final Passage",59,2,0,1,62
1252272,886253,2019-06-21,Assembly,"Assembly Floor Vote - Final Passage",139,2,0,9,150
1252278,886567,2019-06-19,Senate,"Senate Floor Vote - Final Passage",62,0,0,0,62
1252278,886568,2019-06-21,Assembly,"Assembly Floor Vote - Final Passage",141,0,0,9,150
1252278,887362,2019-06-19,Senate,"Senate Rules Committee Vote",19,0,0,0,19
1252316,885098,2019-06-18,Senate,"Senate Floor Vote - Final Passage",44,18,0,0,62
1252316,886374,2019-06-18,Senate,"Senate Rules Committee Vote",16,3,0,0,19
1252316,886375,2019-06-21,Assembly,"Assembly Floor Vote - Final Passage",132,3,0,15,150
1252343,884545,2019-05-29,Senate,"Senate Civil Service And Pensions Committee Vote",7,0,0,0,7
1252343,886395,2019-06-19,Senate,"Senate Floor Vote - Final Passage",46,16,0,0,62
1252364,881391,2019-05-30,Senate,"Senate Aging Committee Vote",7,0,0,0,7
1252364,882077,2019-06-13,Senate,"Senate Floor Vote - Final Passage",62,0,0,0,62
1252364,904621,2020-01-22,Senate,"Senate Aging Committee Vote",7,0,0,0,7
1252364,932087,2020-02-24,Senate,"Senate Floor Vote - Final Passage",59,0,0,3,62
1252445,864092,2019-05-14,Senate,"Senate Committee Vote",7,0,0,0,7
1252489,864089,2019-05-14,Senate,"Senate Committee Vote",7,0,0,0,7
1252495,886527,2019-06-20,Senate,"Senate Floor Vote - Final Passage",61,1,0,0,62
1252495,887349,2019-06-20,Senate,"Senate Rules Committee Vote",19,0,0,0,19
1252564,882120,2019-06-12,Senate,"Senate Floor Vote - Final Passage",62,0,0,0,62
1252564,882121,2019-06-12,Senate,"Senate Rules Committee Vote",19,0,0,0,19
1252733,882948,2019-06-17,Senate,"Senate Floor Vote - Final Passage",62,0,0,0,62
1252733,882949,2019-06-17,Senate,"Senate Rules Committee Vote",19,0,0,0,19
1252733,884244,2019-06-18,Assembly,"Assembly Floor Vote - Final Passage",138,8,0,4,150
1252758,863027,2019-05-13,Senate,"Senate Transportation Committee Vote",14,0,0,1,15
1252758,863545,2019-05-14,Senate,"Senate Rules Committee Vote",18,0,0,1,19
1252758,864305,2019-05-15,Senate,"Senate Floor Vote - Final Passage",58,0,0,4,62
1252758,935073,2020-02-25,Senate,"Senate Transportation Committee Vote",15,0,0,0,15
1252758,949309,2020-03-11,Senate,"Senate Floor Vote - Final Passage",58,0,0,4,62
1252765,886594,2019-06-18,Senate,"Senate Rules Committee Vote",14,5,0,0,19
1252765,886595,2019-06-20,Senate,"Senate Floor Vote - Final Passage",56,6,0,0,62
1252765,886596,2019-06-20,Assembly,"Assembly Floor Vote - Final Passage",125,22,0,3,150
1252778,862994,2019-05-06,Senate,"Senate Local Government Committee Vote",7,0,0,0,7
1252778,862995,2019-05-13,Senate,"Senate Floor Vote - Final Passage",58,2,0,2,62
1252778,877186,2019-06-03,Assembly,"Assembly Floor Vote - Final Passage",142,0,0,8,150
1252805,874861,2019-05-20,Senate,"Senate Local Government Committee Vote",7,0,0,0,7
1252805,875388,2019-05-30,Senate,"Senate Floor Vote - Final Passage",55,3,0,4,62
1252805,878703,2019-06-05,Assembly,"Assembly Floor Vote - Final Passage",144,1,0,5,150
1252810,863000,2019-05-06,Senate,"Senate Local Government Committee Vote",7,0,0,0,7
1252810,863001,2019-05-13,Senate,"Senate Floor Vote - Final Passage",58,2,0,2,62
1252810,878869,2019-06-05,Assembly,"Assembly Floor Vote - Final Passage",144,1,0,5,150
1252820,875192,2019-05-20,Senate,"Senate Local Government Committee Vote",7,0,0,0,7
1252820,875193,2019-05-30,Senate,"Senate Floor Vote - Final Passage",55,3,0,4,62
1252820,877099,2019-06-03,Assembly,"Assembly Floor Vote - Final Passage",142,0,0,8,150
1252963,870082,2019-05-21,Assembly,"Assembly Corporations, Authorities And Commissions Committee: Favorable refer to committee Codes",25,0,0,1,26
1252963,875146,2019-05-30,Assembly,"Assembly Codes Committee: Favorable",19,0,0,3,22
1252968,971923,2020-07-17,Assembly,"Assembly Codes Committee: Held for Consideration",15,6,0,1,22
1252970,860252,2019-05-07,Assembly,"Assembly Higher Education Committee: Favorable",23,0,0,3,26
1252970,874884,2019-05-29,Assembly,"Assembly Floor Vote - Final Passage",140,1,0,9,150
1252970,878898,2019-06-06,Senate,"Senate Floor Vote - Final Passage",61,0,0,1,62
1252977,971626,2020-07-16,Assembly,"Assembly Governmental Operations Committee: Held for Consideration",10,4,0,0,14
1252982,864025,2019-05-14,Assembly,"Assembly Health Committee: Favorable",24,0,0,2,26
1252982,870378,2019-05-22,Assembly,"Assembly Floor Vote - Final Passage",146,0,0,4,150
1252982,881779,2019-06-12,Senate,"Senate Floor Vote - Final Passage",62,0,0,0,62
1252985,881829,2019-05-29,Senate,"Senate Commerce, Economic Development and Small Business Committee Vote",9,0,0,0,9
1252985,881830,2019-06-13,Senate,"Senate Floor Vote - Final Passage",62,0,0,0,62
1252994,867743,2019-05-07,Senate,"Senate Commerce, Economic Development and Small Business Committee Vote",9,0,0,0,9
1252994,867744,2019-05-20,Senate,"Senate Floor Vote - Final Passage",60,0,0,2,62
1252994,902763,2020-01-14,Senate,"Senate Commerce, Economic Development and Small Business Committee Vote",9,0,0,0,9
1252994,904577,2020-01-22,Senate,"Senate Finance Committee Vote",23,0,0,0,23
1252995,857012,2019-04-30,Assembly,"Assembly Corporations, Authorities And Commissions Committee: Favorable",25,0,0,1,26
1252995,861725,2019-05-08,Assembly,"Assembly Floor Vote - Final Passage",138,0,0,12,150
1252995,878482,2019-06-05,Senate,"Senate Floor Vote - Final Passage",62,0,0,0,62
1253001,875564,2019-05-29,Senate,"Senate Investigations and Government Operations Committee Vote",7,0,0,0,7
1253001,879104,2019-06-06,Senate,"Senate Floor Vote - Final Passage",61,0,0,1,62
1253001,879105,2019-06-06,Senate,"Senate Rules Committee Vote",19,0,0,0,19
1253001,902639,2020-01-14,Senate,"Senate Investigations and Government Operations Committee Vote",7,0,0,0,7
1253001,904447,2020-01-22,Senate,"Senate Finance Committee Vote",23,0,0,0,23
1253002,868944,2019-05-21,Assembly,"Assembly Veterans' Affairs Committee: Favorable refer to committee Ways and Means",17,0,0,2,19
1253002,878629,2019-06-05,Assembly,"Assembly Ways And Means Committee: Favorable refer to committee Rules",31,0,0,4,35
1253002,880544,2019-06-11,Assembly,"Assembly Rules Committee: Favorable",25,0,0,6,31
1253002,883258,2019-06-17,Assembly,"Assembly Floor Vote - Final Passage",147,1,0,2,150
1253002,886319,2019-06-19,Senate,"Senate Floor Vote - Final Passage",62,0,0,0,62
1253007,884448,2019-06-17,Assembly,"Assembly Local Governments Committee: Favorable refer to committee Rules",18,0,0,1,19
1253015,878116,2019-06-05,Assembly,"Assembly Energy Committee: Favorable refer to committee Ways and Means",13,4,0,0,17
1253025,884637,2019-05-21,Senate,"Senate Cities Committee Vote",7,0,0,0,7
1253025,886404,2019-06-19,Senate,"Senate Floor Vote - Final Passage",62,0,0,0,62
1253025,886405,2019-06-21,Assembly,"Assembly Floor Vote - Final Passage",139,1,0,10,150
1253027,860191,2019-05-07,Assembly,"Assembly Governmental Employees Committee: Favorable",14,0,0,0,14
1253038,870270,2019-05-21,Assembly,"Assembly Governmental Employees Committee: Favorable refer to committee Ways and Means",14,0,0,0,14
1253038,883547,2019-06-18,Assembly,"Assembly Rules Committee: Favorable",25,0,0,6,31
1253038,883548,2019-06-18,Assembly,"Assembly Ways And Means Committee: Favorable refer to committee Rules",32,1,0,2,35
1253038,886258,2019-06-21,Assembly,"Assembly Floor Vote - Final Passage",141,3,0,6,150
1253038,933496,2020-02-25,Assembly,"Assembly Governmental Employees Committee: Favorable refer to committee Ways and Means",13,0,0,1,14
1253049,878095,2019-06-05,Assembly,"Assembly Governmental Employees Committee: Favorable refer to committee Ways and Means",14,0,0,0,14
1253049,880356,2019-06-11,Assembly,"Assembly Ways And Means Committee: Favorable refer to committee Rules",33,0,0,2,35
1253049,881706,2019-06-14,Assembly,"Assembly Rules Committee: Favorable",25,0,0,6,31
1253069,882640,2019-06-17,Assembly,"Assembly Rules Committee: Favorable",25,0,0,6,31
1253069,882641,2019-06-17,Assembly,"Assembly Codes Committee: Favorable refer to committee Ways and Means",20,0,0,2,22
1253069,885002,2019-06-19,Assembly,"Assembly Floor Vote - Final Passage",148,0,0,2,150
1253069,886726,2019-06-20,Senate,"Senate Floor Vote - Final Passage",62,0,0,0,62
1253074,886769,2019-06-20,Senate,"Senate Floor Vote - Final Passage",62,0,0,0,62
1253074,887179,2019-06-20,Senate,"Senate Rules Committee Vote",19,0,0,0,19
1253079,868396,2019-05-21,Assembly,"Assembly Health Committee: Favorable refer to committee Ways and Means",26,0,0,0,26
1253079,882703,2019-06-17,Assembly,"Assembly Rules Committee: Favorable",25,0,0,6,31
1253079,882704,2019-06-17,Assembly,"Assembly Ways And Means Committee: Favorable refer to committee Rules",33,0,0,2,35
1253203,882804,2019-05-07,Senate,"Senate Labor Committee Vote",12,0,0,1,13
1253203,882805,2019-06-17,Senate,"Senate Floor Vote - Final Passage",61,1,0,0,62
1253203,886348,2019-06-20,Assembly,"Assembly Floor Vote - Final Passage",138,9,0,3,150
1253236,880689,2019-06-06,Senate,"Senate Rules Committee Vote",19,0,0,0,19
1253236,881919,2019-06-12,Senate,"Senate Floor Vote - Final Passage",62,0,0,0,62
1253236,884154,2019-06-18,Assembly,"Assembly Floor Vote - Final Passage",148,0,0,2,150
1253574,868516,2019-05-21,Assembly,"Assembly Real Property Taxation Committee: Favorable refer to committee Ways and Means",10,0,0,0,10
1253574,874758,2019-05-30,Assembly,"Assembly Ways And Means Committee: Favorable",28,3,0,4,35
1253574,878616,2019-06-05,Assembly,"Assembly Floor Vote - Final Passage",142,3,0,5,150
1253574,880413,2019-06-11,Senate,"Senate Floor Vote - Final Passage",61,0,0,1,62
1253578,882726,2019-06-17,Assembly,"Assembly Real Property Taxation Committee: Favorable refer to committee Ways and Means",10,0,0,0,10
1253587,869374,2019-05-21,Assembly,"Assembly Real Property Taxation Committee: Favorable refer to committee Ways and Means",10,0,0,0,10
1253587,878633,2019-06-05,Assembly,"Assembly Ways And Means Committee: Favorable refer to committee Rules",31,0,0,4,35
1253587,882424,2019-06-17,Assembly,"Assembly Rules Committee: Favorable",26,0,0,5,31
1253587,884501,2019-06-18,Assembly,"Assembly Floor Vote - Final Passage",148,0,0,2,150
1253587,973493,2020-07-22,Senate,"Senate Floor Vote - Final Passage",59,1,0,0,60
1253594,878417,2019-06-05,Assembly,"Assembly Transportation Committee: Favorable refer to committee Ways and Means",26,0,0,0,26
1253594,882076,2019-06-14,Assembly,"Assembly Ways And Means Committee: Favorable refer to committee Rules",30,0,0,5,35
1253594,882515,2019-06-17,Assembly,"Assembly Rules Committee: Favorable",26,0,0,5,31
1253599,868497,2019-05-21,Assembly,"Assembly Economic Development Committee: Favorable",24,0,0,2,26
1253609,877930,2019-06-05,Assembly,"Assembly Education Committee: Favorable refer to committee Rules",29,0,0,2,31
1253609,880526,2019-06-11,Assembly,"Assembly Rules Committee: Favorable",25,0,0,6,31
1253689,972940,2020-07-20,Senate,"Senate Environmental Conservation Committee Vote",10,1,0,0,11
1253689,973223,2020-07-22,Senate,"Senate Rules Committee Vote",16,3,0,0,19
1253689,973568,2020-07-23,Senate,"Senate Floor Vote - Final Passage",42,18,0,0,60
1253697,877594,2019-05-06,Senate,"Senate Local Government Committee Vote",7,0,0,0,7
1253697,877595,2019-06-04,Senate,"Senate Floor Vote - Final Passage",62,0,0,0,62
1253697,881921,2019-06-14,Senate,"Senate Floor Vote - Final Passage",62,0,0,0,62
1253697,886460,2019-06-21,Assembly,"Assembly Floor Vote - Final Passage",118,17,0,15,150
1253708,886148,2019-06-21,Assembly,"Assembly Floor Vote - Final Passage",137,4,0,9,150
1253708,886639,2019-06-18,Senate,"Senate Rules Committee Vote",17,2,0,0,19
1253708,886640,2019-06-19,Senate,"Senate Floor Vote - Final Passage",56,6,0,0,62
1253722,863897,2019-05-14,Senate,"Senate Civil Service and Pensions Committee Vote",6,0,0,1,7
1253722,875416,2019-05-30,Senate,"Senate Floor Vote - Final Passage",58,0,0,4,62
1253722,875417,2019-05-30,Senate,"Senate Rules Committee Vote",18,0,0,1,19
1253735,868025,2019-05-21,Assembly,"Assembly Codes Committee: Favorable",21,0,0,1,22
1253735,868026,2019-05-21,Assembly,"Assembly Governmental Operations Committee: Favorable refer to committee Codes",11,3,0,0,14
1253735,911314,2020-01-29,Assembly,"Assembly Floor Vote - Final Passage",95,42,0,11,148
1253735,934725,2020-02-25,Senate,"Senate Floor Vote - Final Passage",51,9,0,2,62
1253755,972002,2020-07-17,Assembly,"Assembly Codes Committee: Held for Consideration",15,6,0,1,22
1253774,857697,2019-04-30,Assembly,"Assembly Real Property Taxation Committee: Favorable refer to committee Ways and Means",9,0,0,1,10
1253774,875614,2019-05-30,Assembly,"Assembly Ways And Means Committee: Favorable",31,0,0,4,35
1253775,857022,2019-04-30,Assembly,"Assembly Real Property Taxation Committee: Favorable refer to committee Ways and Means",9,0,0,1,10
1253775,875618,2019-05-30,Assembly,"Assembly Ways And Means Committee: Favorable",31,0,0,4,35
1253782,857699,2019-04-30,Assembly,"Assembly Real Property Taxation Committee: Favorable refer to committee Ways and Means",9,0,0,1,10
1253782,869025,2019-05-21,Assembly,"Assembly Ways And Means Committee: Favorable",32,0,0,3,35
1253784,857034,2019-04-30,Assembly,"Assembly Real Property Taxation Committee: Favorable refer to committee Ways and Means",9,0,0,1,10
1253784,869042,2019-05-21,Assembly,"Assembly Ways And Means Committee: Favorable",32,0,0,3,35
1253808,868334,2019-05-14,Senate,"Senate Civil Service and Pensions Committee Vote",6,0,0,1,7
1253808,868335,2019-05-21,Senate,"Senate Floor Vote - Final Passage",61,0,0,1,62
1253808,880824,2019-06-11,Assembly,"Assembly Floor Vote - Final Passage",121,20,0,9,150
1254009,878808,2019-05-29,Senate,"Senate Energy and Telecommunications Committee Vote",9,0,0,0,9
1254009,878809,2019-06-06,Senate,"Senate Floor Vote - Final Passage",45,16,0,1,62
1254059,864091,2019-05-14,Senate,"Senate Committee Vote",7,0,0,0,7
1254059,868398,2019-05-21,Senate,"Senate Finance Committee Vote",23,0,0,0,23
1254059,877020,2019-06-03,Senate,"Senate Floor Vote - Final Passage",62,0,0,0,62
1254059,877300,2019-06-03,Assembly,"Assembly Floor Vote - Final Passage",141,0,0,9,150
1254163,875821,2019-05-29,Senate,"Senate Local Government Committee Vote",7,0,0,0,7
1254163,885426,2019-06-18,Senate,"Senate Floor Vote - Final Passage",59,3,0,0,62
1254163,886644,2019-06-18,Senate,"Senate Rules Committee Vote",17,2,0,0,19
1254163,906027,2020-01-27,Senate,"Senate Local Government Committee Vote",7,0,0,0,7
1254163,914118,2020-02-03,Senate,"Senate Rules Committee Vote",16,2,0,1,19
1254163,920604,2020-02-11,Senate,"Senate Floor Vote - Final Passage",59,3,0,0,62
1254343,857071,2019-04-30,Assembly,"Assembly Real Property Taxation Committee: Favorable refer to committee Ways and Means",9,0,0,1,10
1254343,868034,2019-05-21,Assembly,"Assembly Ways And Means Committee: Favorable",32,0,0,3,35
1254343,877077,2019-06-03,Assembly,"Assembly Floor Vote - Final Passage",142,0,0,8,150
1254343,879019,2019-06-06,Senate,"Senate Floor Vote - Final Passage",59,2,0,1,62
1254350,971258,2020-07-14,Assembly,"Assembly Education Committee: Held for Consideration",23,6,0,2,31
1254363,881765,2019-05-14,Senate,"Senate Mental Health and Developmental Disabilities Committee Vote",7,0,0,0,7
1254363,882236,2019-06-14,Senate,"Senate Floor Vote - Final Passage",62,0,0,0,62
1254363,883549,2019-06-17,Assembly,"Assembly Floor Vote - Final Passage",148,0,0,2,150
1254372,877829,2019-06-05,Assembly,"Assembly Energy Committee: Favorable refer to committee Codes",13,4,0,0,17
1254372,880156,2019-06-11,Assembly,"Assembly Codes Committee: Favorable refer to committee Rules",17,5,0,0,22
1254372,934708,2020-02-25,Assembly,"Assembly Codes Committee: Favorable",15,6,0,1,22
1254389,860323,2019-05-07,Assembly,"Assembly Alcoholism And Drug Abuse Committee: Favorable",13,1,0,0,14
1254389,865183,2019-05-15,Assembly,"Assembly Floor Vote - Final Passage",137,3,0,10,150
1254389,886613,2019-06-19,Senate,"Senate Floor Vote - Final Passage",62,0,0,0,62
1254436,972048,2020-07-17,Assembly,"Assembly Ways And Means Committee: Held for Consideration",22,10,0,2,34
1254528,859198,2019-05-06,Senate,"Senate Corporations, Authorities And Commissions Committee Vote",7,0,0,0,7
1254554,973401,2020-03-10,Senate,"Senate Energy and Telecommunications Committee Vote",9,0,0,0,9
1254554,973730,2020-07-23,Senate,"Senate Floor Vote - Final Passage",60,0,0,0,60
1254691,884441,2019-06-18,Senate,"Senate Rules Committee Vote",19,0,0,0,19
1254691,884909,2019-06-19,Assembly,"Assembly Floor Vote - Final Passage",149,0,0,1,150
1254691,885489,2019-06-18,Senate,"Senate Floor Vote - Final Passage",62,0,0,0,62
1254693,878642,2019-05-30,Senate,"Senate Transportation Committee Vote",15,0,0,0,15
1254693,879129,2019-06-06,Senate,"Senate Floor Vote - Final Passage",61,0,0,1,62
1254693,883202,2019-06-17,Assembly,"Assembly Floor Vote - Final Passage",147,1,0,2,150
1254722,922284,2019-05-20,Senate,"Senate Corporations, Authorities And Commissions Committee Vote",7,0,0,0,7
1254722,922285,2020-01-21,Senate,"Senate Corporations, Authorities and Commissions Committee Vote",7,0,0,0,7
1254722,923136,2020-02-13,Senate,"Senate Floor Vote - Final Passage",57,0,0,5,62
1254748,881115,2019-06-12,Assembly,"Assembly Real Property Taxation Committee: Favorable refer to committee Ways and Means",9,0,0,1,10
1254748,882056,2019-06-14,Assembly,"Assembly Ways And Means Committee: Favorable refer to committee Rules",30,0,0,5,35
1254748,883622,2019-06-18,Assembly,"Assembly Rules Committee: Favorable",25,0,0,6,31
1254774,971151,2020-07-14,Assembly,"Assembly Correction Committee: Held for Consideration",10,2,0,1,13
1254779,855192,2019-04-30,Senate,"Senate Floor Vote - Final Passage",44,18,0,0,62
1254779,856570,2019-04-30,Senate,"Senate Rules Committee Vote",16,3,0,0,19
1254779,857060,2019-04-30,Assembly,"Assembly Floor Vote - Final Passage",94,50,0,6,150
1254783,972931,2020-07-20,Senate,"Senate Housing, Construction and Community Development Committee Vote",11,0,0,0,11
1254783,973872,2020-07-21,Senate,"Senate Rules Committee Vote",19,0,0,0,19
1254783,973873,2020-07-22,Senate,"Senate Floor Vote - Final Passage",60,0,0,0,60
1254786,869035,2019-05-21,Assembly,"Assembly Ways And Means Committee: Favorable",32,0,0,3,35
1254809,860822,2019-05-07,Assembly,"Assembly Environmental Conservation Committee: Favorable",28,0,0,2,30
1254811,855175,2019-04-30,Senate,"Senate Floor Vote - Final Passage",57,5,0,0,62
1254811,856280,2019-04-30,Senate,"Senate Rules Committee Vote",17,2,0,0,19
1254811,864929,2019-05-15,Assembly,"Assembly Floor Vote - Final Passage",140,1,0,9,150
1254812,874924,2019-05-30,Senate,"Senate Transportation Committee Vote",13,2,0,0,15
1254812,885072,2019-06-19,Senate,"Senate Rules Committee Vote",14,5,0,0,19
1254812,886659,2019-06-19,Senate,"Senate Floor Vote - Final Passage",41,21,0,0,62
1254812,972616,2020-07-21,Senate,"Senate Finance Committee Vote",16,7,0,0,23
1254812,973639,2020-07-22,Senate,"Senate Floor Vote - Final Passage",39,21,0,0,60
1254812,973983,2020-07-21,Senate,"Senate Rules Committee Vote",13,6,0,0,19
1254812,973984,2020-07-21,Senate,"Senate Finance Committee Vote",16,7,0,0,23
1254849,885272,2019-06-18,Senate,"Senate Floor Vote - Final Passage",43,19,0,0,62
1254849,886534,2019-06-18,Senate,"Senate Rules Committee Vote",16,3,0,0,19
1254849,886535,2019-06-20,Assembly,"Assembly Floor Vote - Final Passage",102,44,0,4,150
1254852,972304,2020-07-20,Senate,"Senate Consumer Protection Committee Vote",6,0,0,0,6
1254852,973387,2020-07-22,Senate,"Senate Floor Vote - Final Passage",58,2,0,0,60
1254852,973981,2020-07-21,Senate,"Senate Rules Committee Vote",18,1,0,0,19
1254855,881309,2019-05-30,Senate,"Senate Health Committee Vote",15,0,0,0,15
1254855,881980,2019-06-13,Senate,"Senate Floor Vote - Final Passage",62,0,0,0,62
1254855,883172,2019-06-17,Assembly,"Assembly Floor Vote - Final Passage",147,1,0,2,150
1254864,882299,2019-05-21,Senate,"Senate Housing, Construction and Community Development Committee Vote",7,4,0,0,11
1254864,882300,2019-06-14,Senate,"Senate Floor Vote - Final Passage",45,17,0,0,62
1254864,904602,2020-01-21,Senate,"Senate Housing, Construction and Community Development Committee Vote",9,2,0,0,11
1254864,972378,2020-07-21,Senate,"Senate Floor Vote - Final Passage",43,17,0,0,60
1254875,881860,2019-06-13,Senate,"Senate Floor Vote - Final Passage",62,0,0,0,62
1254875,881861,2019-06-13,Senate,"Senate Rules Committee Vote",19,0,0,0,19
1254875,884113,2019-06-18,Assembly,"Assembly Floor Vote - Final Passage",146,0,0,4,150
1254927,878020,2019-06-05,Senate,"Senate Floor Vote - Final Passage",62,0,0,0,62
1254927,878021,2019-06-05,Senate,"Senate Rules Committee Vote",19,0,0,0,19
1254927,884133,2019-06-18,Assembly,"Assembly Floor Vote - Final Passage",111,37,0,2,150
1254942,885728,2019-06-18,Senate,"Senate Floor Vote - Final Passage",58,4,0,0,62
1254942,886282,2019-06-18,Senate,"Senate Rules Committee Vote",17,2,0,0,19
1254966,868043,2019-05-21,Assembly,"Assembly Corporations, Authorities And Commissions Committee: Favorable refer to committee Codes",25,0,0,1,26
1254966,875067,2019-05-30,Assembly,"Assembly Codes Committee: Favorable",19,0,0,3,22
1254966,878599,2019-06-05,Assembly,"Assembly Floor Vote - Final Passage",131,14,0,5,150
1254969,859912,2019-05-06,Senate,"Senate Internet and Technology Committee Vote",6,1,0,0,7
1254979,878040,2019-06-05,Senate,"Senate Floor Vote - Final Passage",61,1,0,0,62
1254979,878041,2019-06-05,Senate,"Senate Rules Committee Vote",19,0,0,0,19
1254979,883307,2019-06-17,Assembly,"Assembly Floor Vote - Final Passage",146,1,0,3,150
1254981,883867,2019-05-21,Senate,"Senate Higher Education Committee Vote",11,0,0,0,11
1254981,885384,2019-06-18,Senate,"Senate Floor Vote - Final Passage",53,9,0,0,62
1254987,861181,2019-05-07,Senate,"Senate Social Services Committee Vote",7,0,0,0,7
1254987,882168,2019-06-14,Senate,"Senate Floor Vote - Final Passage",62,0,0,0,62
1254987,882169,2019-06-14,Senate,"Senate Rules Committee Vote",19,0,0,0,19
1254987,884905,2019-06-19,Assembly,"Assembly Floor Vote - Final Passage",148,1,0,1,150
1254998,860331,2019-05-07,Assembly,"Assembly Higher Education Committee: Favorable refer to committee Ways and Means",22,1,0,3,26
1254998,874755,2019-05-30,Assembly,"Assembly Ways And Means Committee: Favorable",28,3,0,4,35
1255019,971324,2020-07-15,Assembly,"Assembly Labor Committee: Favorable refer to committee Codes",21,4,0,3,28
1255019,971872,2020-07-17,Assembly,"Assembly Codes Committee: Favorable refer to committee Rules",15,6,0,1,22
1255044,878579,2019-06-05,Assembly,"Assembly Ways And Means Committee: Favorable refer to committee Codes",25,6,0,4,35
1255044,881415,2019-06-13,Assembly,"Assembly Codes Committee: Favorable refer to committee Rules",15,5,0,2,22
1255044,882533,2019-06-17,Assembly,"Assembly Rules Committee: Favorable",26,0,0,5,31
1255044,883966,2019-06-18,Senate,"Senate Floor Vote - Final Passage",46,16,0,0,62
1255044,883967,2019-06-18,Assembly,"Assembly Floor Vote - Final Passage",106,42,0,2,150
1255066,884882,2019-06-18,Assembly,"Assembly Banks Committee: Favorable refer to committee Codes",28,1,0,2,31
1255171,885174,2019-06-19,Senate,"Senate Rules Committee Vote",19,0,0,0,19
1255171,886796,2019-06-20,Senate,"Senate Floor Vote - Final Passage",62,0,0,0,62
1255171,972731,2020-07-20,Senate,"Senate Civil Service and Pensions Committee Vote",6,1,0,0,7
1255171,972732,2020-07-21,Senate,"Senate Finance Committee Vote",22,1,0,0,23
1255171,973435,2020-07-22,Senate,"Senate Floor Vote - Final Passage",57,3,0,0,60
1255171,973791,2020-07-21,Senate,"Senate Finance Committee Vote",22,1,0,0,23
1255199,880145,2019-06-03,Senate,"Senate Rules Committee Vote",15,4,0,0,19
1255199,880146,2019-06-11,Senate,"Senate Floor Vote - Final Passage",39,22,0,1,62
1255212,876610,2019-05-21,Senate,"Senate Higher Education Committee Vote",11,0,0,0,11
1255212,877027,2019-06-03,Senate,"Senate Floor Vote - Final Passage",56,6,0,0,62
1255212,878074,2019-06-04,Assembly,"Assembly Floor Vote - Final Passage",143,3,0,4,150
1255253,881900,2019-05-29,Senate,"Senate Local Government Committee Vote",7,0,0,0,7
1255253,881901,2019-06-14,Senate,"Senate Floor Vote - Final Passage",59,3,0,0,62
1255253,886513,2019-06-21,Assembly,"Assembly Floor Vote - Final Passage",134,1,0,15,150
1255296,875156,2019-05-30,Senate,"Senate Transportation Committee Vote",14,1,0,0,15
1255296,886514,2019-06-20,Senate,"Senate Floor Vote - Final Passage",62,0,0,0,62
1255296,886515,2019-06-20,Assembly,"Assembly Floor Vote - Final Passage",124,22,0,4,150
1255296,887356,2019-06-20,Senate,"Senate Rules Committee Vote",19,0,0,0,19
1255350,878634,2019-05-29,Senate,"Senate Local Government Committee Vote",7,0,0,0,7
1255350,879119,2019-06-06,Senate,"Senate Floor Vote - Final Passage",61,0,0,1,62
1255393,867752,2019-05-07,Senate,"Senate Labor Committee Vote",12,0,0,1,13
1255393,867753,2019-05-20,Senate,"Senate Floor Vote - Final Passage",56,4,0,2,62
1255393,903429,2020-01-14,Senate,"Senate Labor Committee Vote",12,1,0,0,13
1255393,933577,2020-02-25,Senate,"Senate Floor Vote - Final Passage",57,3,0,2,62
1255393,973186,2020-07-22,Assembly,"Assembly Floor Vote - Final Passage",134,8,0,3,145
1255411,878614,2019-05-29,Senate,"Senate Local Government Committee Vote",7,0,0,0,7
1255411,879082,2019-06-06,Senate,"Senate Floor Vote - Final Passage",61,0,0,1,62
1255411,933151,2020-02-24,Senate,"Senate Local Government Committee Vote",7,0,0,0,7
1255431,919567,2019-05-21,Senate,"Senate Elections Committee Vote",7,0,0,0,7
1255431,919568,2020-02-10,Senate,"Senate Elections Committee Vote",7,0,0,0,7
1255680,884048,2019-06-18,Assembly,"Assembly Floor Vote - Final Passage",105,43,0,2,150
1255680,884592,2019-06-18,Senate,"Senate Rules Committee Vote",17,2,0,0,19
1255680,885071,2019-06-18,Senate,"Senate Floor Vote - Final Passage",45,17,0,0,62
1255687,880008,2019-06-11,Senate,"Senate Rules Committee Vote",14,5,0,0,19
1255687,880488,2019-06-11,Senate,"Senate Floor Vote - Final Passage",41,21,0,0,62
1255687,913951,2020-02-04,Senate,"Senate Banks Committee Vote",6,4,0,1,11
1255687,922465,2020-02-13,Senate,"Senate Floor Vote - Final Passage",39,18,0,5,62
1255700,881390,2019-05-29,Senate,"Senate Agriculture Committee Vote",9,0,0,0,9
1255700,881775,2019-06-13,Senate,"Senate Floor Vote - Final Passage",62,0,0,0,62
1255700,905003,2020-01-23,Senate,"Senate Agriculture Committee Vote",9,0,0,0,9
1255700,941774,2020-03-02,Senate,"Senate Floor Vote - Final Passage",61,0,0,1,62
1255714,885202,2019-05-14,Senate,"Senate Mental Health and Developmental Disabilities Committee Vote",7,0,0,0,7
1255714,886495,2019-06-19,Senate,"Senate Floor Vote - Final Passage",61,1,0,0,62
1255718,883029,2019-06-17,Senate,"Senate Floor Vote - Final Passage",62,0,0,0,62
1255718,883030,2019-06-17,Senate,"Senate Rules Committee Vote",19,0,0,0,19
1255718,884502,2019-06-18,Assembly,"Assembly Floor Vote - Final Passage",145,3,0,2,150
1255782,875937,2019-05-30,Senate,"Senate Alcoholism and Substance Abuse Committee Vote",6,1,0,0,7
1255782,933280,2020-02-24,Senate,"Senate Alcoholism and Substance Abuse Committee Vote",7,0,0,0,7
1255782,941374,2020-03-03,Senate,"Senate Finance Committee Vote",23,0,0,0,23
1255784,863551,2019-05-07,Senate,"Senate Crime Victims, Crime and Correction Committee Vote",7,0,0,0,7
1255784,863552,2019-05-14,Senate,"Senate Floor Vote - Final Passage",59,0,0,3,62
1255784,863553,2019-05-14,Senate,"Senate Rules Committee Vote",18,0,0,1,19
1255784,904767,2020-01-21,Senate,"Senate Crime Victims, Crime and Correction Committee Vote",7,0,0,0,7
1255784,919796,2020-02-11,Senate,"Senate Floor Vote - Final Passage",62,0,0,0,62
1255784,973003,2020-07-21,Assembly,"Assembly Floor Vote - Final Passage",140,2,0,3,145
1255786,885522,2019-06-18,Senate,"Senate Floor Vote - Final Passage",55,7,0,0,62
1255786,886686,2019-06-18,Senate,"Senate Rules Committee Vote",19,0,0,0,19
1255791,863532,2019-05-07,Senate,"Senate Crime Victims, Crime and Correction Committee Vote",7,0,0,0,7
1255791,863533,2019-05-14,Senate,"Senate Floor Vote - Final Passage",59,0,0,3,62
1255791,863534,2019-05-14,Senate,"Senate Rules Committee Vote",18,0,0,1,19
1255791,884256,2019-06-18,Assembly,"Assembly Floor Vote - Final Passage",146,0,0,4,150
1255801,874800,2019-05-20,Senate,"Senate Local Government Committee Vote",6,1,0,0,7
1255801,875406,2019-05-30,Senate,"Senate Floor Vote - Final Passage",56,2,0,4,62
1255801,884265,2019-06-18,Assembly,"Assembly Floor Vote - Final Passage",146,0,0,4,150
1255827,880790,2019-06-12,Assembly,"Assembly Ways And Means Committee: Favorable refer to committee Rules",30,0,0,5,35
1255827,880791,2019-06-12,Assembly,"Assembly Real Property Taxation Committee: Favorable refer to committee Ways and Means",9,0,0,1,10
1255827,881693,2019-06-14,Assembly,"Assembly Rules Committee: Favorable",25,0,0,6,31
1255831,878001,2019-06-05,Senate,"Senate Floor Vote - Final Passage",62,0,0,0,62
1255831,878002,2019-06-05,Senate,"Senate Rules Committee Vote",19,0,0,0,19
1255831,884250,2019-06-18,Assembly,"Assembly Floor Vote - Final Passage",148,0,0,2,150
1255839,880697,2019-05-30,Senate,"Senate Alcoholism and Substance Abuse Committee Vote",7,0,0,0,7
1255839,881954,2019-06-12,Senate,"Senate Floor Vote - Final Passage",62,0,0,0,62
1255839,902019,2020-01-13,Senate,"Senate Alcoholism and Substance Abuse Committee Vote",7,0,0,0,7
1255839,915083,2020-02-04,Senate,"Senate Floor Vote - Final Passage",61,0,0,1,62
1255869,859822,2019-05-07,Assembly,"Assembly Codes Committee: Favorable",20,0,0,2,22
1255869,859823,2019-05-07,Assembly,"Assembly Judiciary Committee: Favorable refer to committee Codes",19,1,0,1,21
1255869,864359,2019-05-14,Assembly,"Assembly Floor Vote - Final Passage",136,5,0,9,150
1255869,878411,2019-06-05,Senate,"Senate Floor Vote - Final Passage",62,0,0,0,62
1255886,878667,2019-05-20,Senate,"Senate Corporations, Authorities and Commissions Committee Vote",7,0,0,0,7
1255886,879140,2019-06-06,Senate,"Senate Floor Vote - Final Passage",61,0,0,1,62
1255886,940540,2020-03-02,Senate,"Senate Corporations, Authorities and Commissions Committee Vote",6,0,0,1,7
1255889,874443,2019-05-29,Senate,"Senate Civil Service and Pensions Committee Vote",7,0,0,0,7
1255892,868434,2019-05-21,Assembly,"Assembly Correction Committee: Favorable",10,0,0,3,13
1255892,877262,2019-06-03,Assembly,"Assembly Floor Vote - Final Passage",135,6,0,9,150
1255894,920963,2020-02-11,Senate,"Senate Social Services Committee Vote",7,0,0,0,7
1255897,879146,2019-06-05,Assembly,"Assembly Local Governments Committee: Favorable refer to committee Ways and Means",18,0,0,1,19
1255897,882050,2019-06-14,Assembly,"Assembly Ways And Means Committee: Favorable refer to committee Rules",30,0,0,5,35
1255897,882439,2019-06-17,Assembly,"Assembly Rules Committee: Favorable",26,0,0,5,31
1255916,870458,2019-05-21,Senate,"Senate Elections Committee Vote",7,0,0,0,7
1255916,878011,2019-06-05,Senate,"Senate Floor Vote - Final Passage",52,10,0,0,62
1255916,878012,2019-06-05,Senate,"Senate Rules Committee Vote",17,2,0,0,19
1255916,919698,2020-02-10,Senate,"Senate Elections Committee Vote",6,1,0,0,7
1255916,949547,2020-03-11,Senate,"Senate Floor Vote - Final Passage",47,11,0,4,62
1255925,874190,2019-05-29,Assembly,"Assembly Local Governments Committee: Favorable refer to committee Ways and Means",17,0,0,2,19
1255925,882012,2019-06-14,Assembly,"Assembly Ways And Means Committee: Favorable refer to committee Rules",30,0,0,5,35
1255925,882434,2019-06-17,Assembly,"Assembly Rules Committee: Favorable",26,0,0,5,31
1255927,882990,2019-06-17,Senate,"Senate Floor Vote - Final Passage",62,0,0,0,62
1255927,882991,2019-06-17,Senate,"Senate Rules Committee Vote",19,0,0,0,19
1255927,884497,2019-06-18,Assembly,"Assembly Floor Vote - Final Passage",145,1,0,4,150
1255932,882183,2019-06-14,Senate,"Senate Floor Vote - Final Passage",62,0,0,0,62
1255932,882184,2019-06-14,Senate,"Senate Rules Committee Vote",19,0,0,0,19
1255932,884436,2019-06-18,Assembly,"Assembly Floor Vote - Final Passage",148,0,0,2,150
1255935,972673,2020-07-21,Senate,"Senate Banks Committee Vote",9,2,0,0,11
1255935,973282,2020-07-22,Senate,"Senate Rules Committee Vote",15,4,0,0,19
1255935,973380,2020-07-23,Assembly,"Assembly Floor Vote - Final Passage",125,16,0,4,145
1255935,973721,2020-07-23,Senate,"Senate Floor Vote - Final Passage",43,17,0,0,60
1255949,880092,2019-05-29,Senate,"Senate Local Government Committee Vote",7,0,0,0,7
1255949,880582,2019-06-11,Senate,"Senate Floor Vote - Final Passage",44,17,0,1,62
1255949,882891,2019-06-17,Senate,"Senate Floor Vote - Final Passage",56,6,0,0,62
1255949,931863,2020-02-24,Senate,"Senate Local Government Committee Vote",7,0,0,0,7
1255949,937330,2020-02-27,Senate,"Senate Floor Vote - Final Passage",56,3,0,3,62
1255953,868399,2019-05-21,Assembly,"Assembly Transportation Committee: Held for Consideration",18,7,0,0,25
1255983,868547,2019-05-21,Assembly,"Assembly Judiciary Committee: Favorable",21,0,0,0,21
1255992,877974,2019-06-05,Assembly,"Assembly Local Governments Committee: Favorable refer to committee Ways and Means",17,1,0,1,19
1255992,879334,2019-06-06,Assembly,"Assembly Ways And Means Committee: Favorable refer to committee Rules",26,5,0,4,35
1255992,880476,2019-06-11,Assembly,"Assembly Rules Committee: Favorable",25,0,0,6,31
1255997,971199,2020-07-14,Assembly,"Assembly Election Law Committee: Held for Consideration",12,4,0,0,16
1256007,883907,2019-06-18,Assembly,"Assembly Ways And Means Committee: Favorable refer to committee Rules",32,1,0,2,35
1256007,884924,2019-06-19,Assembly,"Assembly Rules Committee: Favorable",27,0,0,4,31
1256012,869049,2019-05-21,Assembly,"Assembly Ways And Means Committee: Favorable",27,5,0,3,35
1256012,877068,2019-06-03,Assembly,"Assembly Floor Vote - Final Passage",118,24,0,8,150
1256012,882141,2019-06-14,Senate,"Senate Floor Vote - Final Passage",54,8,0,0,62
1256013,971037,2020-07-14,Assembly,"Assembly Insurance Committee: Favorable refer to committee Codes",20,0,0,2,22
1256013,971725,2020-07-17,Assembly,"Assembly Ways And Means Committee: Favorable refer to committee Rules",29,3,0,2,34
1256013,971726,2020-07-17,Assembly,"Assembly Codes Committee: Favorable refer to committee Ways and Means",19,2,0,1,22
1256120,880108,2019-05-30,Senate,"Senate Environmental Conservation Committee Vote",10,0,0,1,11
1256120,880594,2019-06-11,Senate,"Senate Floor Vote - Final Passage",60,1,0,1,62
1256154,882086,2019-05-29,Senate,"Senate Elections Committee Vote",7,0,0,0,7
1256154,882087,2019-06-14,Senate,"Senate Floor Vote - Final Passage",59,3,0,0,62
1256154,884322,2019-06-18,Assembly,"Assembly Floor Vote - Final Passage",146,0,0,4,150
1256160,874108,2019-05-13,Senate,"Senate Racing, Gaming and Wagering Committee Vote",7,0,0,0,7
1256160,874109,2019-05-29,Senate,"Senate Floor Vote - Final Passage",60,0,0,2,62
1256160,918427,2020-02-10,Senate,"Senate Racing, Gaming and Wagering Committee Vote",6,0,0,1,7
1256160,937344,2020-02-27,Senate,"Senate Floor Vote - Final Passage",59,0,0,3,62
1256176,869081,2019-05-21,Senate,"Senate Health Committee Vote",15,0,0,0,15
1256176,881967,2019-06-12,Senate,"Senate Floor Vote - Final Passage",62,0,0,0,62
1256176,881968,2019-06-12,Senate,"Senate Rules Committee Vote",19,0,0,0,19
1256176,902723,2020-01-14,Senate,"Senate Health Committee Vote",14,0,0,0,14
1256176,914120,2020-02-03,Senate,"Senate Rules Committee Vote",18,0,0,1,19
1256176,915495,2020-02-04,Senate,"Senate Floor Vote - Final Passage",61,0,0,1,62
1256215,882106,2019-05-30,Senate,"Senate Health Committee Vote",15,0,0,0,15
1256215,882107,2019-06-14,Senate,"Senate Floor Vote - Final Passage",62,0,0,0,62
1256215,886645,2019-06-21,Assembly,"Assembly Floor Vote - Final Passage",144,0,0,6,150
1256263,886565,2019-06-20,Senate,"Senate Floor Vote - Final Passage",62,0,0,0,62
1256263,886566,2019-06-20,Assembly,"Assembly Floor Vote - Final Passage",145,1,0,4,150
1256263,887363,2019-06-19,Senate,"Senate Rules Committee Vote",19,0,0,0,19
1256267,881883,2019-06-13,Senate,"Senate Floor Vote - Final Passage",59,3,0,0,62
1256267,881884,2019-06-13,Senate,"Senate Rules Committee Vote",19,0,0,0,19
1256267,886323,2019-06-21,Assembly,"Assembly Floor Vote - Final Passage",135,0,0,15,150
1256528,916247,2020-02-04,Senate,"Senate Children and Families Committee Vote",6,1,0,0,7
1256554,864029,2019-05-14,Senate,"Senate Civil Service and Pensions Committee Vote",6,0,0,1,7
1256576,869148,2019-05-14,Senate,"Senate Judiciary Committee Vote",15,0,0,0,15
1256576,869149,2019-05-22,Senate,"Senate Floor Vote - Final Passage",61,0,0,1,62
1256576,877405,2019-06-03,Assembly,"Assembly Floor Vote - Final Passage",141,0,0,9,150
1256579,877745,2019-06-04,Assembly,"Assembly Ways And Means Committee: Favorable refer to committee Rules",27,6,0,2,35
1256579,880486,2019-06-11,Assembly,"Assembly Rules Committee: Favorable",24,1,0,6,31
1256579,883263,2019-06-17,Assembly,"Assembly Floor Vote - Final Passage",111,37,0,2,150
1256579,883813,2019-06-18,Senate,"Senate Floor Vote - Final Passage",46,16,0,0,62
1256582,971816,2020-07-16,Assembly,"Assembly Governmental Employees Committee: Held for Consideration",10,4,0,0,14
1256585,948149,2020-03-10,Assembly,"Assembly Governmental Operations Committee: Held for Consideration",10,4,0,0,14
1256587,971907,2020-07-17,Assembly,"Assembly Codes Committee: Favorable refer to committee Rules",15,6,0,1,22
1256595,877706,2019-06-03,Assembly,"Assembly Aging Committee: Favorable refer to committee Rules",28,0,0,2,30
1256595,880541,2019-06-11,Assembly,"Assembly Rules Committee: Favorable",25,0,0,6,31
1256597,875150,2019-05-14,Senate,"Senate Judiciary Committee Vote",15,0,0,0,15
1256597,875151,2019-05-30,Senate,"Senate Floor Vote - Final Passage",58,0,0,4,62
1256597,877378,2019-06-03,Assembly,"Assembly Floor Vote - Final Passage",141,0,0,9,150
1256600,881806,2019-06-14,Assembly,"Assembly Transportation Committee: Favorable refer to committee Codes",24,0,0,1,25
1256600,882980,2019-06-17,Assembly,"Assembly Codes Committee: Favorable refer to committee Rules",16,4,0,2,22
1256600,885248,2019-06-20,Assembly,"Assembly Rules Committee: Favorable",27,0,0,4,31
1256604,869132,2019-05-14,Senate,"Senate Judiciary Committee Vote",15,0,0,0,15
1256604,869133,2019-05-22,Senate,"Senate Floor Vote - Final Passage",61,0,0,1,62
1256604,877109,2019-06-03,Assembly,"Assembly Floor Vote - Final Passage",141,0,0,9,150
1256610,881314,2019-05-29,Senate,"Senate Investigations and Government Operations Committee Vote",7,0,0,0,7
1256610,882014,2019-06-13,Senate,"Senate Floor Vote - Final Passage",62,0,0,0,62
1256610,902553,2020-01-14,Senate,"Senate Investigations and Government Operations Committee Vote",7,0,0,0,7
1256616,874426,2019-05-29,Senate,"Senate Agriculture Committee Vote",6,3,0,0,9
1256616,877955,2019-06-05,Senate,"Senate Rules Committee Vote",19,0,0,0,19
1256616,878506,2019-06-05,Senate,"Senate Floor Vote - Final Passage",60,2,0,0,62
1256616,886458,2019-06-21,Assembly,"Assembly Floor Vote - Final Passage",144,0,0,6,150
1256620,868490,2019-05-21,Assembly,"Assembly Real Property Taxation Committee: Favorable refer to committee Ways and Means",10,0,0,0,10
1256620,878638,2019-06-05,Assembly,"Assembly Ways And Means Committee: Favorable refer to committee Rules",31,0,0,4,35
1256620,880556,2019-06-11,Assembly,"Assembly Rules Committee: Favorable",25,0,0,6,31
1256620,883308,2019-06-17,Assembly,"Assembly Floor Vote - Final Passage",147,0,0,3,150
1256620,885388,2019-06-18,Senate,"Senate Floor Vote - Final Passage",58,4,0,0,62
1256628,920821,2020-02-11,Assembly,"Assembly Consumer Affairs And Protection Committee: Favorable refer to committee Codes",13,3,0,0,16
1256628,934716,2020-02-25,Assembly,"Assembly Codes Committee: Favorable",19,2,0,1,22
1256629,877902,2019-06-05,Assembly,"Assembly Governmental Employees Committee: Favorable refer to committee Ways and Means",14,0,0,0,14
1256629,884640,2019-06-19,Assembly,"Assembly Ways And Means Committee: Favorable refer to committee Rules",32,1,0,2,35
1256629,885165,2019-06-20,Assembly,"Assembly Rules Committee: Favorable",27,0,0,4,31
1256632,883609,2019-05-14,Senate,"Senate Children And Families Committee Vote",7,0,0,0,7
1256632,884017,2019-06-18,Assembly,"Assembly Floor Vote - Final Passage",148,0,0,2,150
1256632,885740,2019-06-18,Senate,"Senate Floor Vote - Final Passage",60,2,0,0,62
1256637,868519,2019-05-21,Assembly,"Assembly Libraries And Education Technology Committee: Favorable refer to committee Ways and Means",9,0,0,0,9
1256637,882609,2019-06-17,Assembly,"Assembly Rules Committee: Favorable",25,0,0,6,31
1256637,882610,2019-06-17,Assembly,"Assembly Ways And Means Committee: Favorable refer to committee Rules",33,0,0,2,35
1256638,876552,2019-05-20,Senate,"Senate Codes Committee Vote",13,0,0,0,13
1256638,876979,2019-06-03,Senate,"Senate Floor Vote - Final Passage",62,0,0,0,62
1256638,901965,2020-01-13,Senate,"Senate Codes Committee Vote",13,0,0,0,13
1256638,904433,2020-01-22,Senate,"Senate Floor Vote - Final Passage",61,0,0,1,62
1256640,971402,2020-07-16,Assembly,"Assembly Governmental Employees Committee: Held for Consideration",10,4,0,0,14
1256646,879224,2019-06-06,Assembly,"Assembly Environmental Conservation Committee: Favorable refer to committee Ways and Means",28,0,0,2,30
1256646,879225,2019-06-06,Assembly,"Assembly Ways And Means Committee: Favorable refer to committee Rules",31,0,0,4,35
1256646,881711,2019-06-14,Assembly,"Assembly Rules Committee: Favorable",25,0,0,6,31
1256646,884127,2019-06-18,Assembly,"Assembly Floor Vote - Final Passage",146,0,0,4,150
1256646,886575,2019-06-19,Senate,"Senate Floor Vote - Final Passage",61,1,0,0,62
1256655,874201,2019-05-29,Assembly,"Assembly Local Governments Committee: Favorable refer to committee Ways and Means",17,0,0,2,19
1256655,877155,2019-06-04,Assembly,"Assembly Ways And Means Committee: Favorable refer to committee Rules",33,0,0,2,35
1256655,880553,2019-06-11,Assembly,"Assembly Rules Committee: Favorable",25,0,0,6,31
1256656,882170,2019-06-14,Senate,"Senate Floor Vote - Final Passage",62,0,0,0,62
1256656,882171,2019-06-14,Senate,"Senate Rules Committee Vote",19,0,0,0,19
1256656,883389,2019-06-17,Assembly,"Assembly Floor Vote - Final Passage",148,0,0,2,150
1256686,878008,2019-06-05,Senate,"Senate Floor Vote - Final Passage",62,0,0,0,62
1256686,878009,2019-06-05,Senate,"Senate Rules Committee Vote",19,0,0,0,19
1256686,882827,2019-06-17,Senate,"Senate Floor Vote - Final Passage",62,0,0,0,62
1256686,885093,2019-06-19,Assembly,"Assembly Floor Vote - Final Passage",148,0,0,2,150
1256734,868478,2019-05-21,Assembly,"Assembly Economic Development Committee: Favorable refer to committee Codes",17,7,0,2,26
1256734,875138,2019-05-30,Assembly,"Assembly Codes Committee: Favorable",15,4,0,3,22
1256741,868630,2019-05-21,Assembly,"Assembly Economic Development Committee: Favorable refer to committee Codes",24,0,0,2,26
1256741,875031,2019-05-30,Assembly,"Assembly Codes Committee: Favorable",15,4,0,3,22
1256741,884351,2019-06-18,Assembly,"Assembly Floor Vote - Final Passage",103,45,0,2,150
1256744,877385,2019-06-03,Senate,"Senate Rules Committee Vote",16,3,0,0,19
1256744,877386,2019-06-04,Senate,"Senate Floor Vote - Final Passage",50,12,0,0,62
1256744,877783,2019-06-04,Assembly,"Assembly Floor Vote - Final Passage",113,31,0,6,150
1256746,867967,2019-05-21,Assembly,"Assembly Health Committee: Favorable refer to committee Codes",22,4,0,0,26
1256748,884877,2019-06-19,Assembly,"Assembly Codes Committee: Favorable refer to committee Rules",13,9,0,0,22
1256748,971744,2020-07-17,Assembly,"Assembly Ways And Means Committee: Favorable refer to committee Rules",22,10,0,2,34
1256748,971745,2020-07-17,Assembly,"Assembly Codes Committee: Favorable refer to committee Ways and Means",15,6,0,1,22
1256748,972180,2020-07-20,Assembly,"Assembly Rules Committee: Favorable",20,7,0,3,30
1256748,972720,2020-07-21,Assembly,"Assembly Floor Vote - Final Passage",91,51,0,3,145
1256748,973635,2020-07-22,Senate,"Senate Floor Vote - Final Passage",39,21,0,0,60
1256757,878991,2019-06-06,Senate,"Senate Floor Vote - Final Passage",60,1,0,1,62
1256757,878992,2019-06-06,Senate,"Senate Rules Committee Vote",19,0,0,0,19
1256785,881398,2019-05-30,Senate,"Senate Education Committee Vote",14,0,0,1,15
1256785,881820,2019-06-13,Senate,"Senate Floor Vote - Final Passage",62,0,0,0,62
1256813,863325,2019-05-14,Senate,"Senate Mental Health and Developmental Disabilities Committee Vote",7,0,0,0,7
1256813,868082,2019-05-21,Senate,"Senate Finance Committee Vote",23,0,0,0,23
1256813,869192,2019-05-21,Senate,"Senate Finance Committee Vote",23,0,0,0,23
1256813,874298,2019-05-29,Senate,"Senate Floor Vote - Final Passage",60,0,0,2,62
1256813,902979,2020-01-15,Senate,"Senate Mental Health and Developmental Disabilities Committee Vote",7,0,0,0,7
1256813,906300,2020-01-27,Senate,"Senate Floor Vote - Final Passage",61,0,0,1,62
1256813,933164,2020-02-24,Assembly,"Assembly Floor Vote - Final Passage",132,0,0,15,147
1256815,863475,2019-05-14,Assembly,"Assembly Mental Health Committee: Favorable refer to committee Ways and Means",12,0,0,1,13
1256815,868804,2019-05-21,Assembly,"Assembly Ways And Means Committee: Favorable",32,0,0,3,35
1256815,874973,2019-05-29,Assembly,"Assembly Floor Vote - Final Passage",140,0,0,10,150
1256815,878186,2019-06-05,Senate,"Senate Floor Vote - Final Passage",62,0,0,0,62
1256817,863547,2019-05-14,Assembly,"Assembly Ways And Means Committee: Favorable",32,0,0,3,35
1256817,874726,2019-05-29,Assembly,"Assembly Floor Vote - Final Passage",140,0,0,10,150
1256817,882276,2019-06-14,Senate,"Senate Floor Vote - Final Passage",62,0,0,0,62
1256822,863495,2019-05-14,Assembly,"Assembly Local Governments Committee: Favorable refer to committee Codes",18,0,0,1,19
1256822,868367,2019-05-21,Assembly,"Assembly Codes Committee: Favorable",21,0,0,1,22
1256853,972284,2020-07-20,Senate,"Senate Local Government Committee Vote",7,0,0,0,7
1256853,973557,2020-07-22,Senate,"Senate Floor Vote - Final Passage",58,2,0,0,60
1256853,973921,2020-07-21,Senate,"Senate Rules Committee Vote",19,0,0,0,19
1256869,863471,2019-05-14,Assembly,"Assembly Local Governments Committee: Favorable refer to committee Codes",18,0,0,1,19
1256869,868438,2019-05-21,Assembly,"Assembly Codes Committee: Favorable refer to committee Ways and Means",21,0,0,1,22
1256869,878630,2019-06-05,Assembly,"Assembly Ways And Means Committee: Favorable refer to committee Rules",31,0,0,4,35
1256869,881698,2019-06-14,Assembly,"Assembly Rules Committee: Favorable",25,0,0,6,31
1256882,874517,2019-05-29,Senate,"Senate Social Services Committee Vote",7,0,0,0,7
1256882,886013,2019-06-19,Senate,"Senate Rules Committee Vote",14,5,0,0,19
1256882,886502,2019-06-19,Senate,"Senate Floor Vote - Final Passage",44,18,0,0,62
1256882,902740,2020-01-14,Senate,"Senate Social Services Committee Vote",7,0,0,0,7
1256906,875164,2019-05-30,Assembly,"Assembly Insurance Committee: Favorable refer to committee Codes",24,0,0,0,24
1256906,877196,2019-06-04,Assembly,"Assembly Codes Committee: Favorable refer to committee Ways and Means",22,0,0,0,22
1256909,881853,2019-06-13,Senate,"Senate Floor Vote - Final Passage",59,3,0,0,62
1256909,881854,2019-06-13,Senate,"Senate Rules Committee Vote",19,0,0,0,19
1256909,883113,2019-06-17,Senate,"Senate Floor Vote - Final Passage",62,0,0,0,62
1256909,884038,2019-06-18,Assembly,"Assembly Floor Vote - Final Passage",142,4,0,4,150
1256912,863394,2019-05-14,Senate,"Senate Civil Service and Pensions Committee Vote",5,1,0,1,7
1256989,863346,2019-05-14,Senate,"Senate Higher Education Committee Vote",8,3,0,0,11
1257000,868467,2019-05-21,Assembly,"Assembly Cities Committee: Favorable refer to committee Ways and Means",15,0,0,0,15
1257000,877834,2019-06-04,Assembly,"Assembly Ways And Means Committee: Favorable refer to committee Rules",33,0,0,2,35
1257000,880702,2019-06-12,Assembly,"Assembly Rules Committee: Favorable",27,0,0,4,31
1257025,877599,2019-06-04,Assembly,"Assembly Mental Health Committee: Favorable refer to committee Ways and Means",12,0,0,1,13
1257039,868024,2019-05-14,Senate,"Senate Aging Committee Vote",7,0,0,0,7
1257039,868849,2019-05-21,Senate,"Senate Floor Vote - Final Passage",61,0,0,1,62
1257039,904596,2020-01-22,Senate,"Senate Aging Committee Vote",7,0,0,0,7
1257039,910221,2020-01-29,Senate,"Senate Floor Vote - Final Passage",58,0,0,4,62
1257042,877132,2019-06-04,Assembly,"Assembly Mental Health Committee: Favorable refer to committee Ways and Means",12,0,0,1,13
1257042,878302,2019-06-05,Assembly,"Assembly Ways And Means Committee: Favorable refer to committee Rules",31,0,0,4,35
1257042,880754,2019-06-12,Assembly,"Assembly Rules Committee: Favorable",27,0,0,4,31
1257058,863563,2019-05-14,Assembly,"Assembly Health Committee: Favorable refer to committee Ways and Means",24,0,0,2,26
1257058,868805,2019-05-21,Assembly,"Assembly Ways And Means Committee: Favorable",32,0,0,3,35
1257058,874972,2019-05-29,Assembly,"Assembly Floor Vote - Final Passage",134,6,0,10,150
1257058,882258,2019-06-14,Senate,"Senate Floor Vote - Final Passage",61,1,0,0,62
1257064,964138,2020-06-09,Senate,"Senate Floor Vote - Final Passage",62,0,0,0,62
1257064,967744,2020-05-28,Senate,"Senate Rules Committee Vote",19,0,0,0,19
1257064,967745,2020-06-08,Senate,"Senate Local Government Committee Vote",7,0,0,0,7
1257084,879268,2019-06-05,Assembly,"Assembly Transportation Committee: Favorable refer to committee Ways and Means",26,0,0,0,26
1257084,879269,2019-06-06,Assembly,"Assembly Ways And Means Committee: Favorable refer to committee Rules",31,0,0,4,35
1257084,880742,2019-06-12,Assembly,"Assembly Rules Committee: Favorable",27,0,0,4,31
1257084,883185,2019-06-17,Assembly,"Assembly Floor Vote - Final Passage",147,1,0,2,150
1257084,883725,2019-06-18,Senate,"Senate Floor Vote - Final Passage",62,0,0,0,62
1257114,877948,2019-05-30,Senate,"Senate Judiciary Committee Vote",14,0,0,1,15
1257114,878443,2019-06-05,Senate,"Senate Floor Vote - Final Passage",62,0,0,0,62
1257114,903170,2020-01-14,Senate,"Senate Judiciary Committee Vote",15,0,0,0,15
1257114,919581,2020-02-10,Senate,"Senate Floor Vote - Final Passage",61,0,0,1,62
1257117,882232,2019-05-14,Senate,"Senate Health Committee Vote",15,0,0,0,15
1257117,882233,2019-06-14,Senate,"Senate Floor Vote - Final Passage",50,12,0,0,62
1257117,883475,2019-06-17,Assembly,"Assembly Floor Vote - Final Passage",147,1,0,2,150
1257118,878322,2019-05-30,Senate,"Senate Consumer Protection Committee Vote",7,0,0,0,7
1257118,878323,2019-06-05,Senate,"Senate Floor Vote - Final Passage",42,20,0,0,62
1257118,882814,2019-06-17,Senate,"Senate Floor Vote - Final Passage",41,21,0,0,62
1257118,883101,2019-06-17,Assembly,"Assembly Floor Vote - Final Passage",147,1,0,2,150
1257169,879008,2019-06-06,Assembly,"Assembly Corporations, Authorities And Commissions Committee: Favorable refer to committee Rules",25,0,0,1,26
1257169,880751,2019-06-12,Assembly,"Assembly Rules Committee: Favorable",27,0,0,4,31
1257169,883186,2019-06-17,Assembly,"Assembly Floor Vote - Final Passage",148,0,0,2,150
1257169,885209,2019-06-18,Senate,"Senate Floor Vote - Final Passage",62,0,0,0,62
1257173,886090,2019-06-18,Senate,"Senate Floor Vote - Final Passage",58,4,0,0,62
1257173,886558,2019-06-18,Senate,"Senate Rules Committee Vote",18,1,0,0,19
1257173,972634,2020-07-20,Senate,"Senate Environmental Conservation Committee Vote",10,1,0,0,11
1257173,972635,2020-07-21,Senate,"Senate Finance Committee Vote",21,2,0,0,23
1257173,974105,2020-07-22,Senate,"Senate Rules Committee Vote",18,1,0,0,19
1257173,974106,2020-07-23,Senate,"Senate Floor Vote - Final Passage",55,5,0,0,60
1257178,870547,2019-05-21,Assembly,"Assembly Education Committee: Favorable refer to committee Ways and Means",31,0,0,0,31
1257178,874772,2019-05-30,Assembly,"Assembly Ways And Means Committee: Favorable",31,0,0,4,35
1257179,885606,2019-06-18,Senate,"Senate Floor Vote - Final Passage",62,0,0,0,62
1257179,886597,2019-06-18,Senate,"Senate Rules Committee Vote",19,0,0,0,19
1257183,883631,2019-06-17,Assembly,"Assembly Local Governments Committee: Favorable refer to committee Rules",18,0,0,1,19
1257183,883632,2019-06-18,Assembly,"Assembly Rules Committee: Favorable",25,0,0,6,31
1257183,885043,2019-06-19,Assembly,"Assembly Floor Vote - Final Passage",148,0,0,2,150
1257183,964160,2020-06-09,Senate,"Senate Floor Vote - Final Passage",62,0,0,0,62
1257190,971384,2020-07-15,Assembly,"Assembly Labor Committee: Favorable refer to committee Rules",23,2,0,3,28
1257190,973770,2020-07-21,Assembly,"Assembly Rules Committee: Favorable",19,7,0,4,30
1257195,878729,2019-05-20,Senate,"Senate Corporations, Authorities and Commissions Committee Vote",7,0,0,0,7
1257195,879173,2019-06-06,Senate,"Senate Floor Vote - Final Passage",61,0,0,1,62
1257195,884260,2019-06-18,Assembly,"Assembly Floor Vote - Final Passage",146,0,0,4,150
1257215,863518,2019-05-14,Senate,"Senate Higher Education Committee Vote",9,2,0,0,11
1257228,877434,2019-06-04,Assembly,"Assembly Judiciary Committee: Favorable refer to committee Codes",14,7,0,0,21
1257228,881397,2019-06-13,Assembly,"Assembly Codes Committee: Favorable refer to committee Rules",14,6,0,2,22
1257228,882467,2019-06-17,Assembly,"Assembly Rules Committee: Favorable",26,0,0,5,31
1257398,885739,2019-05-20,Senate,"Senate Corporations, Authorities And Commissions Committee Vote",7,0,0,0,7
1257398,886768,2019-06-20,Senate,"Senate Floor Vote - Final Passage",62,0,0,0,62
1257398,941757,2020-03-02,Senate,"Senate Corporations, Authorities and Commissions Committee Vote",6,0,0,1,7
1257407,882181,2019-06-14,Senate,"Senate Floor Vote - Final Passage",59,3,0,0,62
1257407,882182,2019-06-14,Senate,"Senate Rules Committee Vote",18,1,0,0,19
1257407,904473,2020-01-22,Senate,"Senate Committee Vote",7,0,0,0,7
1257407,935391,2020-02-25,Senate,"Senate Finance Committee Vote",21,1,0,1,23
1257407,948155,2020-03-10,Senate,"Senate Floor Vote - Final Passage",56,3,0,3,62
1257423,882294,2019-05-29,Senate,"Senate Local Government Committee Vote",7,0,0,0,7
1257423,882295,2019-06-14,Senate,"Senate Floor Vote - Final Passage",62,0,0,0,62
1257427,877276,2019-06-04,Senate,"Senate Floor Vote - Final Passage",59,3,0,0,62
1257427,877772,2019-06-04,Senate,"Senate Rules Committee Vote",19,0,0,0,19
1257427,885035,2019-06-19,Assembly,"Assembly Floor Vote - Final Passage",146,2,0,2,150
1257433,884579,2019-06-18,Senate,"Senate Rules Committee Vote",19,0,0,0,19
1257433,885063,2019-06-18,Senate,"Senate Floor Vote - Final Passage",60,2,0,0,62
1257433,886332,2019-06-21,Assembly,"Assembly Floor Vote - Final Passage",144,0,0,6,150
1257459,867374,2019-05-20,Senate,"Senate Corporations, Authorities and Commissions Committee Vote",7,0,0,0,7
1257483,972856,2020-07-22,Assembly,"Assembly Ways And Means Committee: Favorable refer to committee Rules",32,0,0,2,34
1257483,973078,2020-07-22,Assembly,"Assembly Rules Committee: Favorable",29,0,0,1,30
1257498,914747,2020-02-04,Assembly,"Assembly Health Committee: Favorable",23,0,0,3,26
1257498,919586,2020-02-10,Assembly,"Assembly Floor Vote - Final Passage",141,2,0,4,147
1257522,886528,2019-06-20,Senate,"Senate Floor Vote - Final Passage",62,0,0,0,62
1257522,886529,2019-06-21,Assembly,"Assembly Floor Vote - Final Passage",137,3,0,10,150
1257522,887341,2019-06-20,Senate,"Senate Rules Committee Vote",19,0,0,0,19
1257553,863643,2019-05-14,Assembly,"Assembly Aging Committee: Favorable refer to committee Ways and Means",29,0,0,1,30
1257553,874770,2019-05-30,Assembly,"Assembly Ways And Means Committee: Favorable",31,0,0,4,35
1257553,878831,2019-06-05,Assembly,"Assembly Floor Vote - Final Passage",145,0,0,5,150
1257557,874809,2019-05-21,Senate,"Senate Health Committee Vote",15,0,0,0,15
1257557,875520,2019-05-30,Senate,"Senate Floor Vote - Final Passage",58,0,0,4,62
1257557,883379,2019-06-17,Assembly,"Assembly Floor Vote - Final Passage",148,0,0,2,150
1257565,868425,2019-05-21,Assembly,"Assembly Governmental Employees Committee: Favorable",14,0,0,0,14
1257565,877887,2019-06-04,Assembly,"Assembly Floor Vote - Final Passage",144,2,0,4,150
1257565,878900,2019-06-06,Senate,"Senate Floor Vote - Final Passage",61,0,0,1,62
1257604,868502,2019-05-21,Assembly,"Assembly Judiciary Committee: Favorable refer to committee Ways and Means",19,2,0,0,21
1257607,971179,2020-07-14,Assembly,"Assembly Judiciary Committee: Favorable refer to committee Rules",15,6,0,0,21
1257613,868566,2019-05-21,Assembly,"Assembly Judiciary Committee: Favorable",21,0,0,0,21
1257613,877408,2019-06-03,Assembly,"Assembly Floor Vote - Final Passage",141,0,0,9,150
1257613,886709,2019-06-19,Senate,"Senate Floor Vote - Final Passage",62,0,0,0,62
1257616,868591,2019-05-21,Assembly,"Assembly Judiciary Committee: Favorable",21,0,0,0,21
1257619,868523,2019-05-21,Assembly,"Assembly Judiciary Committee: Favorable",19,2,0,0,21
1257624,868493,2019-05-21,Assembly,"Assembly Judiciary Committee: Favorable",21,0,0,0,21
1257633,868941,2019-05-21,Assembly,"Assembly Governmental Operations Committee: Favorable refer to committee Codes",14,0,0,0,14
1257633,877398,2019-06-04,Assembly,"Assembly Codes Committee: Favorable refer to committee Ways and Means",22,0,0,0,22
1257633,880367,2019-06-11,Assembly,"Assembly Ways And Means Committee: Favorable refer to committee Rules",33,0,0,2,35
1257633,881704,2019-06-14,Assembly,"Assembly Rules Committee: Favorable",25,0,0,6,31
1257640,868482,2019-05-21,Assembly,"Assembly Judiciary Committee: Favorable refer to committee Codes",21,0,0,0,21
1257643,868553,2019-05-21,Assembly,"Assembly Judiciary Committee: Favorable",21,0,0,0,21
1257650,868460,2019-05-21,Assembly,"Assembly Judiciary Committee: Favorable refer to committee Codes",15,6,0,0,21
1257650,875070,2019-05-30,Assembly,"Assembly Codes Committee: Favorable",15,4,0,3,22
1257651,875159,2019-05-30,Assembly,"Assembly Judiciary Committee: Favorable",15,5,0,1,21
1257655,868618,2019-05-21,Assembly,"Assembly Judiciary Committee: Favorable refer to committee Codes",18,3,0,0,21
1257655,875034,2019-05-30,Assembly,"Assembly Codes Committee: Favorable",17,2,0,3,22
1257790,879393,2019-06-06,Assembly,"Assembly Ways And Means Committee: Favorable refer to committee Rules",24,7,0,4,35
1257791,883574,2019-06-17,Assembly,"Assembly Education Committee: Favorable refer to committee Rules",27,0,0,4,31
1257791,883575,2019-06-18,Assembly,"Assembly Rules Committee: Favorable",25,0,0,6,31
1257808,885121,2019-06-19,Senate,"Senate Rules Committee Vote",16,3,0,0,19
1257808,886439,2019-06-19,Senate,"Senate Floor Vote - Final Passage",51,11,0,0,62
1257808,914583,2020-02-04,Senate,"Senate Environmental Conservation Committee Vote",9,2,0,0,11
1257808,935331,2020-02-25,Senate,"Senate Finance Committee Vote",16,6,0,1,23
1257808,973072,2020-07-21,Senate,"Senate Floor Vote - Final Passage",43,17,0,0,60
1257813,877274,2019-06-04,Senate,"Senate Floor Vote - Final Passage",60,2,0,0,62
1257813,878051,2019-06-04,Senate,"Senate Rules Committee Vote",19,0,0,0,19
1257813,914021,2020-02-04,Senate,"Senate Environmental Conservation Committee Vote",11,0,0,0,11
1257813,972464,2020-07-21,Senate,"Senate Floor Vote - Final Passage",58,2,0,0,60
1257827,972839,2020-07-22,Assembly,"Assembly Ways And Means Committee: Favorable refer to committee Rules",31,1,0,2,34
1257827,973109,2020-07-22,Assembly,"Assembly Rules Committee: Favorable",29,0,0,1,30
1257827,973572,2020-07-23,Assembly,"Assembly Floor Vote - Final Passage",141,0,0,4,145
1257833,875198,2019-05-30,Assembly,"Assembly Governmental Operations Committee: Favorable refer to committee Ways and Means",12,0,0,2,14
1257839,876874,2019-06-03,Assembly,"Assembly Consumer Affairs And Protection Committee: Favorable refer to committee Codes",14,1,0,1,16
1257839,880199,2019-06-11,Assembly,"Assembly Codes Committee: Favorable refer to committee Rules",21,1,0,0,22
1257839,881713,2019-06-14,Assembly,"Assembly Rules Committee: Favorable",25,0,0,6,31
1257842,868496,2019-05-21,Assembly,"Assembly Health Committee: Favorable",26,0,0,0,26
1257846,874074,2019-05-29,Senate,"Senate Civil Service and Pensions Committee Vote",7,0,0,0,7
1257848,878221,2019-06-05,Assembly,"Assembly Small Business Committee: Favorable refer to committee Codes",16,0,0,1,17
1257848,880239,2019-06-11,Assembly,"Assembly Codes Committee: Favorable refer to committee Rules",22,0,0,0,22
1257848,882416,2019-06-17,Assembly,"Assembly Rules Committee: Favorable",26,0,0,5,31
1257848,883485,2019-06-18,Senate,"Senate Floor Vote - Final Passage",62,0,0,0,62
1257848,883983,2019-06-18,Assembly,"Assembly Floor Vote - Final Passage",147,1,0,2,150
1257850,883238,2019-06-17,Assembly,"Assembly Local Governments Committee: Favorable refer to committee Codes",13,5,0,1,19
1257850,883763,2019-06-18,Assembly,"Assembly Codes Committee: Favorable refer to committee Ways and Means",18,4,0,0,22
1257850,884953,2019-06-19,Assembly,"Assembly Rules Committee: Favorable",28,0,0,3,31
1257850,884954,2019-06-19,Assembly,"Assembly Ways And Means Committee: Favorable refer to committee Rules",33,0,0,2,35
1257852,885990,2019-06-18,Senate,"Senate Floor Vote - Final Passage",62,0,0,0,62
1257852,886481,2019-06-18,Senate,"Senate Rules Committee Vote",19,0,0,0,19
1257852,941742,2020-03-03,Senate,"Senate Environmental Conservation Committee Vote",11,0,0,0,11
1257869,882185,2019-06-14,Senate,"Senate Floor Vote - Final Passage",47,15,0,0,62
1257869,882186,2019-06-14,Senate,"Senate Rules Committee Vote",17,2,0,0,19
1257870,877606,2019-06-04,Assembly,"Assembly Tourism, Arts And Sports Development Committee: Favorable refer to committee Ways and Means",19,0,0,1,20
1257870,882063,2019-06-14,Assembly,"Assembly Ways And Means Committee: Favorable refer to committee Rules",30,0,0,5,35
1257870,882436,2019-06-17,Assembly,"Assembly Rules Committee: Favorable",26,0,0,5,31
1257889,868498,2019-05-21,Senate,"Senate Mental Health and Developmental Disabilities Committee Vote",7,0,0,0,7
1257889,914170,2020-02-04,Senate,"Senate Mental Health and Developmental Disabilities Committee Vote",7,0,0,0,7
1257893,878253,2019-06-05,Assembly,"Assembly Education Committee: Favorable refer to committee Ways and Means",28,1,0,2,31
1257893,882049,2019-06-14,Assembly,"Assembly Ways And Means Committee: Favorable refer to committee Rules",30,0,0,5,35
1257893,884932,2019-06-19,Assembly,"Assembly Rules Committee: Favorable",27,0,0,4,31
1257894,877614,2019-06-04,Assembly,"Assembly Economic Development Committee: Favorable refer to committee Codes",22,2,0,2,26
1257894,880352,2019-06-11,Assembly,"Assembly Codes Committee: Favorable refer to committee Rules",19,3,0,0,22
1257894,881705,2019-06-14,Assembly,"Assembly Rules Committee: Favorable",25,0,0,6,31
1257897,877403,2019-06-04,Assembly,"Assembly Judiciary Committee: Favorable refer to committee Rules",21,0,0,0,21
1257897,880730,2019-06-12,Assembly,"Assembly Rules Committee: Favorable",27,0,0,4,31
1257897,883407,2019-06-17,Assembly,"Assembly Floor Vote - Final Passage",148,0,0,2,150
1257898,881800,2019-06-14,Assembly,"Assembly Transportation Committee: Favorable refer to committee Ways and Means",24,0,0,1,25
1257898,882738,2019-06-17,Assembly,"Assembly Rules Committee: Favorable",25,0,0,6,31
1257898,882739,2019-06-17,Assembly,"Assembly Ways And Means Committee: Favorable refer to committee Rules",33,0,0,2,35
1257905,882149,2019-06-14,Senate,"Senate Floor Vote - Final Passage",48,14,0,0,62
1257905,882150,2019-06-14,Senate,"Senate Rules Committee Vote",17,2,0,0,19
1257905,886641,2019-06-21,Assembly,"Assembly Floor Vote - Final Passage",131,13,0,6,150
1257909,867929,2019-05-21,Assembly,"Assembly Veterans' Affairs Committee: Favorable",17,0,0,2,19
1257909,877062,2019-06-03,Assembly,"Assembly Floor Vote - Final Passage",141,0,0,9,150
1257912,868563,2019-05-21,Assembly,"Assembly Real Property Taxation Committee: Favorable refer to committee Ways and Means",10,0,0,0,10
1257912,877147,2019-06-04,Assembly,"Assembly Ways And Means Committee: Favorable refer to committee Rules",33,0,0,2,35
1257912,880704,2019-06-12,Assembly,"Assembly Rules Committee: Favorable",27,0,0,4,31
1257923,971470,2020-07-15,Assembly,"Assembly Labor Committee: Favorable refer to committee Rules",24,1,0,3,28
1257923,972587,2020-07-21,Assembly,"Assembly Floor Vote - Final Passage",142,0,0,3,145
1257923,972588,2020-07-21,Assembly,"Assembly Rules Committee: Favorable",26,0,0,4,30
1257923,973704,2020-07-22,Senate,"Senate Floor Vote - Final Passage",60,0,0,0,60
1257924,883018,2019-06-17,Senate,"Senate Floor Vote - Final Passage",62,0,0,0,62
1257924,883019,2019-06-17,Senate,"Senate Rules Committee Vote",19,0,0,0,19
1257930,880883,2019-05-30,Senate,"Senate Education Committee Vote",14,0,0,1,15
1257930,882004,2019-06-12,Senate,"Senate Floor Vote - Final Passage",62,0,0,0,62
1257930,883486,2019-06-17,Assembly,"Assembly Floor Vote - Final Passage",148,0,0,2,150
1257931,880900,2019-06-12,Assembly,"Assembly Local Governments Committee: Favorable refer to committee Codes",17,0,0,2,19
1257931,881570,2019-06-13,Assembly,"Assembly Codes Committee: Favorable refer to committee Rules",20,0,0,2,22
1257931,882446,2019-06-17,Assembly,"Assembly Rules Committee: Favorable",26,0,0,5,31
1257934,941825,2020-03-03,Assembly,"Assembly Banks Committee: Favorable refer to committee Codes",19,7,0,5,31
1257934,971723,2020-07-17,Assembly,"Assembly Codes Committee: Favorable refer to committee Rules",15,6,0,1,22
1257934,973011,2020-07-22,Assembly,"Assembly Rules Committee: Favorable",19,6,0,5,30
1257937,869050,2019-05-21,Assembly,"Assembly Ways And Means Committee: Favorable",32,0,0,3,35
1257937,877072,2019-06-03,Assembly,"Assembly Floor Vote - Final Passage",141,0,0,9,150
1257937,882292,2019-06-14,Senate,"Senate Floor Vote - Final Passage",62,0,0,0,62
1257943,885108,2019-06-19,Assembly,"Assembly Floor Vote - Final Passage",148,0,0,2,150
1257943,885894,2019-06-18,Senate,"Senate Floor Vote - Final Passage",62,0,0,0,62
1257943,886380,2019-06-18,Senate,"Senate Rules Committee Vote",19,0,0,0,19
1257946,878209,2019-06-05,Assembly,"Assembly Health Committee: Favorable refer to committee Codes",25,0,0,1,26
1257946,880139,2019-06-11,Assembly,"Assembly Codes Committee: Favorable refer to committee Ways and Means",22,0,0,0,22
1257946,883560,2019-06-18,Assembly,"Assembly Rules Committee: Favorable",25,0,0,6,31
1257946,883561,2019-06-18,Assembly,"Assembly Ways And Means Committee: Favorable refer to committee Rules",33,0,0,2,35
1257955,935270,2020-02-26,Assembly,"Assembly Children And Families Committee: Favorable refer to committee Ways and Means",15,0,0,1,16
1257958,877418,2019-06-04,Assembly,"Assembly Judiciary Committee: Favorable refer to committee Rules",21,0,0,0,21
1257958,880749,2019-06-12,Assembly,"Assembly Rules Committee: Favorable",27,0,0,4,31
1257970,874773,2019-05-29,Assembly,"Assembly Environmental Conservation Committee: Favorable refer to committee Ways and Means",29,0,0,1,30
1257970,874774,2019-05-30,Assembly,"Assembly Ways And Means Committee: Favorable",28,3,0,4,35
1257970,878948,2019-06-05,Assembly,"Assembly Floor Vote - Final Passage",134,10,0,6,150
1257970,885575,2019-06-18,Senate,"Senate Floor Vote - Final Passage",62,0,0,0,62
1257981,882273,2019-05-20,Senate,"Senate Local Government Committee Vote",7,0,0,0,7
1257981,882274,2019-06-14,Senate,"Senate Floor Vote - Final Passage",59,3,0,0,62
1257981,884988,2019-06-19,Assembly,"Assembly Floor Vote - Final Passage",148,0,0,2,150
1257984,876619,2019-05-21,Senate,"Senate Mental Health And Developmental Disabilities Committee Vote",7,0,0,0,7
1257984,877044,2019-06-03,Senate,"Senate Floor Vote - Final Passage",62,0,0,0,62
1257984,883151,2019-06-17,Assembly,"Assembly Floor Vote - Final Passage",148,0,0,2,150
1257985,878921,2019-06-06,Assembly,"Assembly Corporations, Authorities And Commissions Committee: Favorable refer to committee Codes",20,5,0,1,26
1257985,880134,2019-06-11,Assembly,"Assembly Codes Committee: Favorable refer to committee Ways and Means",20,2,0,0,22
1257985,884654,2019-06-19,Assembly,"Assembly Ways And Means Committee: Favorable refer to committee Rules",22,11,0,2,35
1257985,885214,2019-06-20,Assembly,"Assembly Rules Committee: Favorable",24,3,0,4,31
1257988,881292,2019-05-22,Senate,"Senate Energy and Telecommunications Committee Vote",7,2,0,0,9
1257988,882108,2019-06-13,Senate,"Senate Floor Vote - Final Passage",42,20,0,0,62
1257988,973364,2020-07-22,Senate,"Senate Rules Committee Vote",15,4,0,0,19
1257988,973728,2020-07-23,Senate,"Senate Floor Vote - Final Passage",44,16,0,0,60
1257989,878986,2019-06-06,Assembly,"Assembly Environmental Conservation Committee: Favorable refer to committee Codes",27,1,0,2,30
1257989,880225,2019-06-11,Assembly,"Assembly Codes Committee: Favorable refer to committee Rules",22,0,0,0,22
1257990,877615,2019-06-04,Assembly,"Assembly Mental Health Committee: Favorable refer to committee Rules",12,0,0,1,13
1257990,880728,2019-06-12,Assembly,"Assembly Rules Committee: Favorable",27,0,0,4,31
1257990,882964,2019-06-17,Senate,"Senate Floor Vote - Final Passage",62,0,0,0,62
1257990,883406,2019-06-17,Assembly,"Assembly Floor Vote - Final Passage",148,0,0,2,150
1257991,882261,2019-05-29,Senate,"Senate Investigations and Government Operations Committee Vote",7,0,0,0,7
1257991,882262,2019-06-14,Senate,"Senate Floor Vote - Final Passage",62,0,0,0,62
1257991,884243,2019-06-18,Assembly,"Assembly Floor Vote - Final Passage",141,5,0,4,150
1257995,877523,2019-06-04,Assembly,"Assembly Real Property Taxation Committee: Favorable refer to committee Ways and Means",10,0,0,0,10
1257995,879383,2019-06-06,Assembly,"Assembly Ways And Means Committee: Favorable refer to committee Rules",31,0,0,4,35
1257995,880741,2019-06-12,Assembly,"Assembly Rules Committee: Favorable",27,0,0,4,31
1257995,883168,2019-06-17,Assembly,"Assembly Floor Vote - Final Passage",147,0,0,3,150
1257995,886000,2019-06-18,Senate,"Senate Floor Vote - Final Passage",59,3,0,0,62
1258002,882164,2019-06-14,Senate,"Senate Floor Vote - Final Passage",42,20,0,0,62
1258002,882165,2019-06-14,Senate,"Senate Rules Committee Vote",13,6,0,0,19
1258002,972934,2020-07-21,Senate,"Senate Finance Committee Vote",17,6,0,0,23
1258002,973591,2020-07-22,Senate,"Senate Floor Vote - Final Passage",43,17,0,0,60
1258002,973953,2020-07-21,Senate,"Senate Finance Committee Vote",17,6,0,0,23
1258011,881831,2019-06-14,Assembly,"Assembly Governmental Employees Committee: Favorable refer to committee Ways and Means",13,0,0,1,14
1258011,933758,2020-02-25,Assembly,"Assembly Governmental Employees Committee: Favorable refer to committee Ways and Means",13,0,0,1,14
1258013,868575,2019-05-21,Assembly,"Assembly Libraries And Education Technology Committee: Favorable",9,0,0,0,9
1258013,877383,2019-06-03,Assembly,"Assembly Floor Vote - Final Passage",141,0,0,9,150
1258013,878912,2019-06-06,Senate,"Senate Floor Vote - Final Passage",61,0,0,1,62
1258015,877870,2019-06-05,Assembly,"Assembly Local Governments Committee: Favorable refer to committee Ways and Means",18,0,0,1,19
1258015,884288,2019-06-18,Assembly,"Assembly Ways And Means Committee: Favorable refer to committee Rules",33,0,0,2,35
1258015,884920,2019-06-19,Assembly,"Assembly Rules Committee: Favorable",27,0,0,4,31
1258017,878179,2019-05-30,Senate,"Senate Higher Education Committee Vote",10,0,0,1,11
1258017,878180,2019-06-05,Senate,"Senate Floor Vote - Final Passage",62,0,0,0,62
1258291,862173,2019-02-05,Assembly,"Assembly Veterans' Affairs Committee: Favorable",17,0,0,2,19
1258400,862178,2019-03-31,Assembly,"Assembly Floor Vote - Final Passage",99,49,0,2,150
1258564,862186,2019-03-19,Assembly,"Assembly Judiciary Committee: Favorable",20,0,0,1,21
1258806,862192,2019-03-31,Assembly,"Assembly Rules Committee: Favorable",18,8,0,5,31
1258806,862193,2019-03-31,Assembly,"Assembly Transportation Committee: Favorable refer to committee Rules",18,7,0,0,25
1258956,862197,2019-03-31,Assembly,"Assembly Rules Committee: Favorable",30,0,0,1,31
1258956,862198,2019-03-31,Assembly,"Assembly Ways And Means Committee: Favorable refer to committee Rules",24,10,0,1,35
1259679,862217,2019-04-01,Assembly,"Assembly Floor Vote - Final Passage",98,48,0,4,150
1259801,862221,2019-03-05,Assembly,"Assembly Floor Vote - Final Passage",42,106,0,2,150
1259801,862222,2019-03-05,Assembly,"Assembly Rules Committee: Favorable",21,6,0,4,31
1259801,862223,2019-03-05,Assembly,"Assembly Higher Education Committee: Favorable refer to committee Rules",18,5,0,3,26
1259801,862224,2019-03-05,Assembly,"Assembly Education Committee: Favorable refer to committee Higher Education",17,7,0,7,31
1260006,868489,2019-05-21,Assembly,"Assembly Codes Committee: Favorable",21,0,0,1,22
1260006,877272,2019-06-03,Assembly,"Assembly Floor Vote - Final Passage",138,3,0,9,150
1260006,884042,2019-06-18,Senate,"Senate Floor Vote - Final Passage",61,1,0,0,62
1260013,883051,2019-06-17,Senate,"Senate Floor Vote - Final Passage",48,14,0,0,62
1260013,883052,2019-06-17,Senate,"Senate Rules Committee Vote",15,4,0,0,19
1260013,972646,2020-07-21,Senate,"Senate Finance Committee Vote",19,4,0,0,23
1260040,874515,2019-05-29,Senate,"Senate Civil Service and Pensions Committee Vote",7,0,0,0,7
1260044,877997,2019-06-05,Senate,"Senate Floor Vote - Final Passage",59,3,0,0,62
1260044,877998,2019-06-05,Senate,"Senate Rules Committee Vote",19,0,0,0,19
1260047,948033,2020-03-10,Senate,"Senate Health Committee Vote",12,2,0,1,15
1260051,885964,2019-06-18,Senate,"Senate Floor Vote - Final Passage",62,0,0,0,62
1260051,886288,2019-06-18,Senate,"Senate Rules Committee Vote",19,0,0,0,19
1260051,902767,2020-01-14,Senate,"Senate Health Committee Vote",14,0,0,0,14
1260051,915012,2020-02-04,Senate,"Senate Floor Vote - Final Passage",61,0,0,1,62
1260067,880991,2019-05-20,Senate,"Senate Corporations, Authorities And Commissions Committee Vote",7,0,0,0,7
1260067,882008,2019-06-12,Senate,"Senate Floor Vote - Final Passage",62,0,0,0,62
1260067,884200,2019-06-18,Assembly,"Assembly Floor Vote - Final Passage",133,13,0,4,150
1260071,883732,2019-05-30,Senate,"Senate Transportation Committee Vote",14,1,0,0,15
1260071,885654,2019-06-18,Senate,"Senate Floor Vote - Final Passage",61,1,0,0,62
1260071,915038,2020-02-04,Senate,"Senate Transportation Committee Vote",14,1,0,0,15
1260071,972426,2020-07-21,Senate,"Senate Floor Vote - Final Passage",59,1,0,0,60
1260094,880928,2019-05-29,Senate,"Senate Commerce, Economic Development and Small Business Committee Vote",9,0,0,0,9
1260094,881906,2019-06-12,Senate,"Senate Floor Vote - Final Passage",62,0,0,0,62
1260094,884174,2019-06-18,Assembly,"Assembly Floor Vote - Final Passage",143,3,0,4,150
1260099,868676,2019-05-21,Assembly,"Assembly Corporations, Authorities And Commissions Committee: Favorable refer to committee Codes",20,5,0,1,26
1260099,874921,2019-05-30,Assembly,"Assembly Codes Committee: Favorable refer to committee Ways and Means",19,0,0,3,22
1260099,878196,2019-06-05,Assembly,"Assembly Ways And Means Committee: Favorable refer to committee Rules",26,5,0,4,35
1260099,882474,2019-06-17,Assembly,"Assembly Rules Committee: Favorable",26,0,0,5,31
1260099,884386,2019-06-18,Assembly,"Assembly Floor Vote - Final Passage",143,5,0,2,150
1260099,886723,2019-06-19,Senate,"Senate Floor Vote - Final Passage",61,1,0,0,62
1260103,884602,2019-06-18,Senate,"Senate Rules Committee Vote",17,2,0,0,19
1260103,885082,2019-06-18,Senate,"Senate Floor Vote - Final Passage",43,19,0,0,62
1260103,886368,2019-06-21,Assembly,"Assembly Floor Vote - Final Passage",105,39,0,6,150
1260107,876702,2019-06-03,Assembly,"Assembly Social Services Committee: Favorable refer to committee Rules",16,0,0,2,18
1260107,880757,2019-06-12,Assembly,"Assembly Rules Committee: Favorable",27,0,0,4,31
1260123,886542,2019-06-19,Senate,"Senate Floor Vote - Final Passage",58,4,0,0,62
1260123,887354,2019-06-19,Senate,"Senate Rules Committee Vote",19,0,0,0,19
1260123,964148,2020-06-09,Senate,"Senate Floor Vote - Final Passage",60,2,0,0,62
1260123,967748,2020-05-28,Senate,"Senate Rules Committee Vote",19,0,0,0,19
1260123,967749,2020-06-08,Senate,"Senate Local Government Committee Vote",7,0,0,0,7
1260143,882155,2019-06-14,Senate,"Senate Floor Vote - Final Passage",62,0,0,0,62
1260143,882156,2019-06-14,Senate,"Senate Rules Committee Vote",19,0,0,0,19
1260153,874692,2019-05-29,Senate,"Senate Civil Service and Pensions Committee Vote",7,0,0,0,7
1260153,877270,2019-06-04,Senate,"Senate Floor Vote - Final Passage",62,0,0,0,62
1260153,877806,2019-06-04,Senate,"Senate Rules Committee Vote",19,0,0,0,19
1260158,879102,2019-06-06,Senate,"Senate Floor Vote - Final Passage",61,0,0,1,62
1260158,879103,2019-06-06,Senate,"Senate Rules Committee Vote",19,0,0,0,19
1260158,885194,2019-06-19,Assembly,"Assembly Floor Vote - Final Passage",148,0,0,2,150
1260166,864195,2019-05-14,Senate,"Senate Rules Committee Vote",17,1,0,1,19
1260166,864196,2019-05-15,Senate,"Senate Floor Vote - Final Passage",40,18,0,4,62
1260166,877859,2019-06-04,Assembly,"Assembly Floor Vote - Final Passage",145,2,0,3,150
1260171,973534,2020-07-22,Senate,"Senate Floor Vote - Final Passage",46,14,0,0,60
1260171,973900,2020-07-20,Senate,"Senate Judiciary Committee Vote",14,1,0,0,15
1260171,973901,2020-07-21,Senate,"Senate Rules Committee Vote",16,3,0,0,19
1260227,874771,2019-05-21,Senate,"Senate Higher Education Committee Vote",11,0,0,0,11
1260227,875461,2019-05-30,Senate,"Senate Floor Vote - Final Passage",58,0,0,4,62
1260227,880597,2019-06-11,Senate,"Senate Floor Vote - Final Passage",61,0,0,1,62
1260227,886475,2019-06-21,Assembly,"Assembly Floor Vote - Final Passage",144,0,0,6,150
1260232,867294,2019-05-20,Senate,"Senate Corporations, Authorities and Commissions Committee Vote",7,0,0,0,7
1260232,867295,2019-05-20,Senate,"Senate Rules Committee Vote",18,0,0,1,19
1260232,869363,2019-05-22,Senate,"Senate Floor Vote - Final Passage",61,0,0,1,62
1260232,877808,2019-06-04,Assembly,"Assembly Floor Vote - Final Passage",146,0,0,4,150
1260237,882632,2019-06-17,Assembly,"Assembly Local Governments Committee: Favorable refer to committee Ways and Means",18,0,0,1,19
1260237,883558,2019-06-18,Assembly,"Assembly Rules Committee: Favorable",25,0,0,6,31
1260237,883559,2019-06-18,Assembly,"Assembly Ways And Means Committee: Favorable refer to committee Rules",26,7,0,2,35
1260246,883213,2019-05-30,Senate,"Senate Higher Education Committee Vote",9,1,0,1,11
1260246,883214,2019-06-17,Senate,"Senate Floor Vote - Final Passage",51,11,0,0,62
1260246,920327,2020-02-10,Senate,"Senate Higher Education Committee Vote",10,1,0,0,11
1260246,972509,2020-07-21,Senate,"Senate Floor Vote - Final Passage",45,15,0,0,60
1260249,886364,2019-06-19,Senate,"Senate Floor Vote - Final Passage",50,12,0,0,62
1260249,886365,2019-06-21,Assembly,"Assembly Floor Vote - Final Passage",113,27,0,10,150
1260249,887203,2019-06-19,Senate,"Senate Rules Committee Vote",17,2,0,0,19
1260276,885422,2019-06-18,Senate,"Senate Floor Vote - Final Passage",62,0,0,0,62
1260276,886589,2019-06-18,Senate,"Senate Rules Committee Vote",19,0,0,0,19
1260276,973153,2020-07-22,Senate,"Senate Floor Vote - Final Passage",60,0,0,0,60
1260276,973307,2020-07-22,Senate,"Senate Rules Committee Vote",19,0,0,0,19
1260284,880889,2019-05-30,Senate,"Senate Education Committee Vote",14,0,0,1,15
1260284,881855,2019-06-12,Senate,"Senate Floor Vote - Final Passage",62,0,0,0,62
1260284,885050,2019-06-19,Assembly,"Assembly Floor Vote - Final Passage",148,0,0,2,150
1260290,868362,2019-05-21,Senate,"Senate Higher Education Committee Vote",11,0,0,0,11
1260290,880034,2019-06-11,Senate,"Senate Rules Committee Vote",19,0,0,0,19
1260290,882189,2019-06-13,Senate,"Senate Floor Vote - Final Passage",62,0,0,0,62
1260290,940923,2020-03-03,Senate,"Senate Higher Education Committee Vote",11,0,0,0,11
1260291,884051,2019-05-30,Senate,"Senate Cities Committee Vote",7,0,0,0,7
1260291,884052,2019-06-17,Senate,"Senate Floor Vote - Final Passage",61,1,0,0,62
1260291,903176,2020-01-14,Senate,"Senate Cities Committee Vote",7,0,0,0,7
1260291,919477,2020-02-10,Senate,"Senate Floor Vote - Final Passage",60,1,0,1,62
1260303,876662,2019-06-03,Assembly,"Assembly Aging Committee: Favorable refer to committee Ways and Means",27,1,0,2,30
1260303,880369,2019-06-11,Assembly,"Assembly Ways And Means Committee: Favorable refer to committee Rules",33,0,0,2,35
1260303,881692,2019-06-14,Assembly,"Assembly Rules Committee: Favorable",25,0,0,6,31
1260303,884432,2019-06-18,Assembly,"Assembly Floor Vote - Final Passage",146,0,0,4,150
1260303,886661,2019-06-19,Senate,"Senate Floor Vote - Final Passage",61,1,0,0,62
1260315,867378,2019-05-20,Senate,"Senate Corporations, Authorities and Commissions Committee Vote",7,0,0,0,7
1260315,882172,2019-06-14,Senate,"Senate Floor Vote - Final Passage",62,0,0,0,62
1260315,882173,2019-06-14,Senate,"Senate Rules Committee Vote",19,0,0,0,19
1260315,884470,2019-06-18,Assembly,"Assembly Floor Vote - Final Passage",148,0,0,2,150
1260320,884350,2019-06-18,Senate,"Senate Rules Committee Vote",14,5,0,0,19
1260320,885597,2019-06-18,Senate,"Senate Floor Vote - Final Passage",44,18,0,0,62
1260341,867920,2019-05-21,Assembly,"Assembly Veterans' Affairs Committee: Favorable",17,0,0,2,19
1260341,877244,2019-06-03,Assembly,"Assembly Floor Vote - Final Passage",142,0,0,8,150
1260341,877968,2019-06-05,Senate,"Senate Floor Vote - Final Passage",62,0,0,0,62
1260348,882024,2019-05-20,Senate,"Senate Corporations, Authorities and Commissions Committee Vote",6,1,0,0,7
1260348,882025,2019-06-14,Senate,"Senate Floor Vote - Final Passage",45,17,0,0,62
1260348,903830,2020-01-21,Senate,"Senate Corporations, Authorities and Commissions Committee Vote",6,1,0,0,7
1260352,885175,2019-06-19,Senate,"Senate Rules Committee Vote",19,0,0,0,19
1260352,886612,2019-06-19,Senate,"Senate Floor Vote - Final Passage",62,0,0,0,62
1260381,868414,2019-05-21,Assembly,"Assembly Judiciary Committee: Favorable refer to committee Codes",20,1,0,0,21
1260381,875051,2019-05-30,Assembly,"Assembly Codes Committee: Favorable",19,0,0,3,22
1260381,878600,2019-06-05,Assembly,"Assembly Floor Vote - Final Passage",144,0,0,6,150
1260381,886717,2019-06-19,Senate,"Senate Floor Vote - Final Passage",62,0,0,0,62
1260397,876689,2019-06-03,Assembly,"Assembly Social Services Committee: Favorable refer to committee Ways and Means",16,0,0,2,18
1260397,878391,2019-06-05,Assembly,"Assembly Ways And Means Committee: Favorable refer to committee Rules",31,0,0,4,35
1260402,877374,2019-06-04,Assembly,"Assembly Judiciary Committee: Favorable refer to committee Rules",21,0,0,0,21
1260402,883506,2019-06-18,Assembly,"Assembly Rules Committee: Favorable",25,0,0,6,31
1260438,874214,2019-05-29,Assembly,"Assembly Banks Committee: Favorable",30,0,0,1,31
1260438,879258,2019-06-06,Assembly,"Assembly Floor Vote - Final Passage",139,0,0,11,150
1260438,880329,2019-06-11,Senate,"Senate Floor Vote - Final Passage",61,0,0,1,62
1260447,875167,2019-05-30,Assembly,"Assembly Social Services Committee: Favorable",11,5,0,2,18
1260451,877358,2019-06-04,Assembly,"Assembly Judiciary Committee: Favorable refer to committee Rules",16,5,0,0,21
1260451,883640,2019-06-18,Assembly,"Assembly Rules Committee: Favorable",25,0,0,6,31
1260463,868340,2019-05-21,Assembly,"Assembly Judiciary Committee: Favorable refer to committee Codes",15,6,0,0,21
1260463,875012,2019-05-30,Assembly,"Assembly Codes Committee: Favorable",15,4,0,3,22
1260470,877273,2019-06-04,Senate,"Senate Floor Vote - Final Passage",53,9,0,0,62
1260470,877768,2019-06-04,Senate,"Senate Rules Committee Vote",18,1,0,0,19
1260472,874749,2019-05-30,Assembly,"Assembly Judiciary Committee: Favorable refer to committee Codes",15,5,0,1,21
1260472,877433,2019-06-04,Assembly,"Assembly Codes Committee: Favorable refer to committee Rules",20,2,0,0,22
1260478,971215,2020-07-14,Assembly,"Assembly Judiciary Committee: Favorable refer to committee Codes",14,7,0,0,21
1260478,971856,2020-07-17,Assembly,"Assembly Codes Committee: Favorable refer to committee Rules",15,6,0,1,22
1260489,868432,2019-05-21,Assembly,"Assembly Judiciary Committee: Favorable",21,0,0,0,21
1260489,877342,2019-06-03,Assembly,"Assembly Floor Vote - Final Passage",141,0,0,9,150
1260508,869553,2019-05-22,Assembly,"Assembly Election Law Committee: Favorable",14,0,0,2,16
1260508,877110,2019-06-03,Assembly,"Assembly Floor Vote - Final Passage",141,0,0,9,150
1260508,878891,2019-06-06,Senate,"Senate Floor Vote - Final Passage",40,21,0,1,62
1260612,882101,2019-06-14,Assembly,"Assembly Governmental Employees Committee: Favorable refer to committee Ways and Means",13,0,0,1,14
1260612,882682,2019-06-17,Assembly,"Assembly Rules Committee: Favorable",25,0,0,6,31
1260612,882683,2019-06-17,Assembly,"Assembly Ways And Means Committee: Favorable refer to committee Rules",31,2,0,2,35
1260619,875383,2019-05-30,Senate,"Senate Health Committee Vote",15,0,0,0,15
1260619,882166,2019-06-14,Senate,"Senate Floor Vote - Final Passage",61,1,0,0,62
1260619,882167,2019-06-14,Senate,"Senate Rules Committee Vote",18,1,0,0,19
1260622,868512,2019-05-21,Assembly,"Assembly Governmental Employees Committee: Favorable refer to committee Ways and Means",14,0,0,0,14
1260630,881839,2019-06-14,Assembly,"Assembly Governmental Employees Committee: Favorable refer to committee Codes",13,0,0,1,14
1260630,883781,2019-06-18,Assembly,"Assembly Codes Committee: Favorable refer to committee Ways and Means",15,7,0,0,22
1260630,885229,2019-06-20,Assembly,"Assembly Rules Committee: Favorable",27,0,0,4,31
1260630,885230,2019-06-20,Assembly,"Assembly Ways And Means Committee: Favorable refer to committee Rules",28,6,0,1,35
1260631,878782,2019-05-29,Senate,"Senate Civil Service and Pensions Committee Vote",7,0,0,0,7
1260631,878783,2019-06-06,Senate,"Senate Floor Vote - Final Passage",57,4,0,1,62
1260631,880882,2019-06-11,Assembly,"Assembly Floor Vote - Final Passage",110,31,0,9,150
1260637,884671,2019-06-19,Assembly,"Assembly Ways And Means Committee: Favorable refer to committee Rules",30,3,0,2,35
1260637,885262,2019-06-20,Assembly,"Assembly Rules Committee: Favorable",27,0,0,4,31
1260639,881420,2019-06-13,Assembly,"Assembly Codes Committee: Favorable refer to committee Rules",19,1,0,2,22
1260639,882493,2019-06-17,Assembly,"Assembly Rules Committee: Favorable",26,0,0,5,31
1260683,883817,2019-06-11,Senate,"Senate Rules Committee Vote",19,0,0,0,19
1260683,885086,2019-06-18,Senate,"Senate Floor Vote - Final Passage",59,3,0,0,62
1260685,878968,2019-06-06,Assembly,"Assembly Corporations, Authorities And Commissions Committee: Favorable refer to committee Rules",25,0,0,1,26
1260685,881703,2019-06-14,Assembly,"Assembly Rules Committee: Favorable",25,0,0,6,31
1260698,877605,2019-06-04,Assembly,"Assembly Mental Health Committee: Favorable refer to committee Rules",12,0,0,1,13
1260698,880737,2019-06-12,Assembly,"Assembly Rules Committee: Favorable",27,0,0,4,31
1260710,919711,2020-02-11,Assembly,"Assembly Social Services Committee: Favorable refer to committee Codes",13,4,0,0,17
1260720,943076,2020-03-03,Senate,"Senate Committee Vote",7,0,0,0,7
1260733,877401,2019-06-04,Assembly,"Assembly Cities Committee: Favorable refer to committee Ways and Means",14,1,0,0,15
1260733,882035,2019-06-14,Assembly,"Assembly Ways And Means Committee: Favorable refer to committee Rules",30,0,0,5,35
1260733,883617,2019-06-18,Assembly,"Assembly Rules Committee: Favorable",25,0,0,6,31
1260740,876867,2019-06-03,Assembly,"Assembly Higher Education Committee: Favorable refer to committee Codes",25,0,0,1,26
1260740,883147,2019-06-17,Assembly,"Assembly Codes Committee: Favorable refer to committee Rules",18,2,0,2,22
1260740,914926,2020-02-04,Assembly,"Assembly Codes Committee: Favorable",15,4,0,3,22
1260764,880745,2019-06-12,Assembly,"Assembly Cities Committee: Favorable refer to committee Ways and Means",14,0,0,1,15
1260764,881580,2019-06-13,Assembly,"Assembly Ways And Means Committee: Favorable refer to committee Rules",27,2,0,6,35
1260764,882453,2019-06-17,Assembly,"Assembly Rules Committee: Favorable",26,0,0,5,31
1260764,884492,2019-06-18,Assembly,"Assembly Floor Vote - Final Passage",132,16,0,2,150
1260764,886694,2019-06-19,Senate,"Senate Floor Vote - Final Passage",62,0,0,0,62
1260775,874686,2019-05-29,Assembly,"Assembly Environmental Conservation Committee: Favorable refer to committee Codes",23,6,0,1,30
1260775,877400,2019-06-04,Assembly,"Assembly Codes Committee: Favorable refer to committee Ways and Means",15,7,0,0,22
1260797,882596,2019-06-17,Assembly,"Assembly Local Governments Committee: Favorable refer to committee Ways and Means",18,0,0,1,19
1260797,884762,2019-06-19,Assembly,"Assembly Ways And Means Committee: Favorable refer to committee Rules",28,5,0,2,35
1260797,886081,2019-06-20,Assembly,"Assembly Rules Committee: Favorable",27,0,0,4,31
1260826,877604,2019-06-04,Assembly,"Assembly Economic Development Committee: Favorable refer to committee Codes",23,1,0,2,26
1260826,880386,2019-06-11,Assembly,"Assembly Codes Committee: Favorable refer to committee Rules",22,0,0,0,22
1260826,881697,2019-06-14,Assembly,"Assembly Rules Committee: Favorable",25,0,0,6,31
1260834,971439,2020-07-16,Assembly,"Assembly Local Governments Committee: Favorable refer to committee Ways and Means",19,0,0,1,20
1260834,971828,2020-07-17,Assembly,"Assembly Ways And Means Committee: Favorable refer to committee Rules",32,0,0,2,34
1260834,972189,2020-07-20,Assembly,"Assembly Rules Committee: Favorable",27,0,0,3,30
1260834,973169,2020-07-22,Assembly,"Assembly Floor Vote - Final Passage",141,1,0,3,145
1260834,973500,2020-07-22,Senate,"Senate Floor Vote - Final Passage",60,0,0,0,60
1260835,879223,2019-06-06,Assembly,"Assembly Environmental Conservation Committee: Held for Consideration",21,7,0,2,30
1260848,874791,2019-05-21,Senate,"Senate Mental Health and Developmental Disabilities Committee Vote",7,0,0,0,7
1260848,875483,2019-05-30,Senate,"Senate Floor Vote - Final Passage",58,0,0,4,62
1260863,882083,2019-05-29,Senate,"Senate Investigations and Government Operations Committee Vote",7,0,0,0,7
1260863,882084,2019-06-14,Senate,"Senate Floor Vote - Final Passage",62,0,0,0,62
1260863,884018,2019-06-18,Assembly,"Assembly Floor Vote - Final Passage",147,1,0,2,150
1260875,868407,2019-05-21,Assembly,"Assembly Health Committee: Favorable",26,0,0,0,26
1260875,877236,2019-06-03,Assembly,"Assembly Floor Vote - Final Passage",141,0,0,9,150
1260875,877956,2019-06-05,Senate,"Senate Floor Vote - Final Passage",62,0,0,0,62
1260880,881915,2019-06-14,Assembly,"Assembly Governmental Operations Committee: Favorable refer to committee Ways and Means",12,0,0,2,14
1260880,882735,2019-06-17,Assembly,"Assembly Ways And Means Committee: Favorable refer to committee Rules",33,0,0,2,35
1260880,883569,2019-06-18,Assembly,"Assembly Rules Committee: Favorable",25,0,0,6,31
1260889,868328,2019-05-21,Assembly,"Assembly Codes Committee: Favorable",21,0,0,1,22
1260889,877207,2019-06-03,Assembly,"Assembly Floor Vote - Final Passage",140,0,0,10,150
1260895,904765,2020-01-21,Senate,"Senate Crime Victims, Crime and Correction Committee Vote",6,1,0,0,7
1260899,878997,2019-06-06,Assembly,"Assembly Environmental Conservation Committee: Favorable refer to committee Rules",21,7,0,2,30
1260899,972878,2020-07-22,Assembly,"Assembly Rules Committee: Favorable",22,7,0,1,30
1260899,972879,2020-07-22,Assembly,"Assembly Codes Committee: Favorable refer to committee Rules",20,1,0,1,22
1260900,880881,2019-05-29,Senate,"Senate Civil Service and Pensions Committee Vote",7,0,0,0,7
1260900,881777,2019-06-12,Senate,"Senate Floor Vote - Final Passage",62,0,0,0,62
1260900,883080,2019-06-17,Senate,"Senate Floor Vote - Final Passage",62,0,0,0,62
1260900,948677,2020-03-10,Senate,"Senate Civil Service and Pensions Committee Vote",6,1,0,0,7
1260901,960554,2020-05-26,Assembly,"Assembly Corporations, Authorities And Commissions Committee: Favorable refer to committee Rules",26,0,0,0,26
1260901,960945,2020-05-27,Assembly,"Assembly Rules Committee: Favorable",29,0,0,2,31
1260908,880129,2019-05-30,Senate,"Senate Education Committee Vote",14,0,0,1,15
1260908,880600,2019-06-11,Senate,"Senate Floor Vote - Final Passage",61,0,0,1,62
1260908,885352,2019-06-19,Assembly,"Assembly Floor Vote - Final Passage",148,0,0,2,150
1260909,868430,2019-05-21,Assembly,"Assembly Codes Committee: Favorable",15,6,0,1,22
1260918,971467,2020-07-16,Assembly,"Assembly Transportation Committee: Held for Consideration",16,6,0,2,24
1260924,870426,2019-05-21,Assembly,"Assembly Education Committee: Favorable",31,0,0,0,31
1260924,877067,2019-06-03,Assembly,"Assembly Floor Vote - Final Passage",141,0,0,9,150
1260924,881735,2019-06-12,Senate,"Senate Floor Vote - Final Passage",62,0,0,0,62
1260931,874210,2019-05-29,Assembly,"Assembly Banks Committee: Favorable",30,0,0,1,31
1260934,877914,2019-05-29,Senate,"Senate Agriculture Committee Vote",9,0,0,0,9
1260934,878275,2019-06-05,Senate,"Senate Floor Vote - Final Passage",62,0,0,0,62
1260934,883180,2019-06-17,Assembly,"Assembly Floor Vote - Final Passage",147,1,0,2,150
1260937,878205,2019-06-05,Assembly,"Assembly Insurance Committee: Favorable refer to committee Rules",24,0,0,0,24
1260937,882469,2019-06-17,Assembly,"Assembly Rules Committee: Favorable",26,0,0,5,31
1260938,877901,2019-05-30,Senate,"Senate Education Committee Vote",14,0,0,1,15
1260938,878478,2019-06-05,Senate,"Senate Floor Vote - Final Passage",62,0,0,0,62
1260938,886626,2019-06-21,Assembly,"Assembly Floor Vote - Final Passage",144,0,0,6,150
1260940,868371,2019-05-21,Assembly,"Assembly Correction Committee: Favorable refer to committee Ways and Means",10,0,0,3,13
1260940,874801,2019-05-30,Assembly,"Assembly Ways And Means Committee: Favorable",31,0,0,4,35
1260940,879401,2019-06-06,Assembly,"Assembly Floor Vote - Final Passage",139,0,0,11,150
1260940,880149,2019-06-11,Senate,"Senate Floor Vote - Final Passage",61,0,0,1,62
1260946,943107,2020-03-03,Senate,"Senate Labor Committee Vote",12,1,0,0,13
1260948,874419,2019-05-29,Senate,"Senate Agriculture Committee Vote",9,0,0,0,9
1260948,877705,2019-06-04,Senate,"Senate Floor Vote - Final Passage",62,0,0,0,62
1260948,878057,2019-06-04,Senate,"Senate Rules Committee Vote",19,0,0,0,19
1260948,941738,2020-03-02,Senate,"Senate Agriculture Committee Vote",9,0,0,0,9
1260951,881794,2019-06-14,Assembly,"Assembly Cities Committee: Favorable refer to committee Rules",15,0,0,0,15
1260951,886290,2019-06-20,Assembly,"Assembly Rules Committee: Favorable",27,0,0,4,31
1260951,886291,2019-06-21,Assembly,"Assembly Floor Vote - Final Passage",131,4,0,15,150
1260951,964484,2020-06-09,Senate,"Senate Floor Vote - Final Passage",62,0,0,0,62
1260954,971999,2020-07-17,Assembly,"Assembly Ways And Means Committee: Held for Consideration",22,10,0,2,34
1260982,868364,2019-05-21,Assembly,"Assembly Correction Committee: Favorable",8,2,0,3,13
1260984,868403,2019-05-21,Assembly,"Assembly Higher Education Committee: Favorable",26,0,0,0,26
1260990,874769,2019-05-21,Senate,"Senate Health Committee Vote",15,0,0,0,15
1260990,875172,2019-05-30,Senate,"Senate Floor Vote - Final Passage",58,0,0,4,62
1260990,879280,2019-06-06,Assembly,"Assembly Floor Vote - Final Passage",139,0,0,11,150
1261002,868451,2019-05-21,Assembly,"Assembly Higher Education Committee: Favorable refer to committee Codes",26,0,0,0,26
1261002,875088,2019-05-30,Assembly,"Assembly Codes Committee: Favorable",19,0,0,3,22
1261012,868027,2019-05-21,Assembly,"Assembly Tourism, Arts And Sports Development Committee: Favorable refer to committee Ways and Means",20,0,0,0,20
1261012,877835,2019-06-04,Assembly,"Assembly Ways And Means Committee: Favorable refer to committee Rules",33,0,0,2,35
1261012,880731,2019-06-12,Assembly,"Assembly Rules Committee: Favorable",27,0,0,4,31
1261018,877920,2019-05-30,Senate,"Senate Aging Committee Vote",7,0,0,0,7
1261018,878496,2019-06-05,Senate,"Senate Floor Vote - Final Passage",62,0,0,0,62
1261018,883279,2019-06-17,Assembly,"Assembly Floor Vote - Final Passage",148,0,0,2,150
1261029,882265,2019-05-30,Senate,"Senate Higher Education Committee Vote",10,0,0,1,11
1261029,882266,2019-06-14,Senate,"Senate Floor Vote - Final Passage",60,2,0,0,62
1261029,883281,2019-06-17,Assembly,"Assembly Floor Vote - Final Passage",113,32,0,5,150
1261039,883738,2019-05-22,Senate,"Senate Energy And Telecommunications Committee Vote",6,3,0,0,9
1261039,885003,2019-06-19,Assembly,"Assembly Floor Vote - Final Passage",149,0,0,1,150
1261039,885609,2019-06-18,Senate,"Senate Floor Vote - Final Passage",58,4,0,0,62
1261046,973637,2020-03-03,Senate,"Senate Labor Committee Vote",11,2,0,0,13
1261046,973638,2020-07-23,Senate,"Senate Floor Vote - Final Passage",49,11,0,0,60
1261183,881028,2019-05-30,Senate,"Senate Labor Committee Vote",12,1,0,0,13
1261183,881675,2019-06-12,Senate,"Senate Floor Vote - Final Passage",59,3,0,0,62
1261183,883479,2019-06-17,Assembly,"Assembly Floor Vote - Final Passage",104,42,0,4,150
1261201,881816,2019-06-13,Senate,"Senate Floor Vote - Final Passage",62,0,0,0,62
1261201,881817,2019-06-13,Senate,"Senate Rules Committee Vote",19,0,0,0,19
1261201,919739,2020-02-10,Senate,"Senate Education Committee Vote",15,0,0,0,15
1261201,922685,2020-02-13,Senate,"Senate Floor Vote - Final Passage",57,0,0,5,62
1261205,883390,2019-05-29,Senate,"Senate Investigations and Government Operations Committee Vote",7,0,0,0,7
1261205,885589,2019-06-18,Senate,"Senate Floor Vote - Final Passage",59,3,0,0,62
1261205,902758,2020-01-14,Senate,"Senate Investigations And Government Operations Committee Vote",7,0,0,0,7
1261208,877275,2019-06-04,Senate,"Senate Floor Vote - Final Passage",60,2,0,0,62
1261208,878035,2019-06-04,Senate,"Senate Rules Committee Vote",17,2,0,0,19
1261208,883230,2019-06-17,Assembly,"Assembly Floor Vote - Final Passage",140,8,0,2,150
1261215,878015,2019-06-05,Senate,"Senate Floor Vote - Final Passage",62,0,0,0,62
1261215,878016,2019-06-05,Senate,"Senate Rules Committee Vote",19,0,0,0,19
1261215,883208,2019-06-17,Assembly,"Assembly Floor Vote - Final Passage",148,0,0,2,150
1261224,881892,2019-06-13,Senate,"Senate Floor Vote - Final Passage",62,0,0,0,62
1261224,881894,2019-06-13,Senate,"Senate Rules Committee Vote",19,0,0,0,19
1261224,883673,2019-06-18,Senate,"Senate Floor Vote - Final Passage",62,0,0,0,62
1261230,885115,2019-06-19,Senate,"Senate Rules Committee Vote",15,4,0,0,19
1261230,886429,2019-06-19,Senate,"Senate Floor Vote - Final Passage",43,19,0,0,62
1261230,902737,2020-01-14,Senate,"Senate Social Services Committee Vote",7,0,0,0,7
1261266,881875,2019-06-13,Senate,"Senate Floor Vote - Final Passage",62,0,0,0,62
1261266,881876,2019-06-13,Senate,"Senate Rules Committee Vote",19,0,0,0,19
1261272,874748,2019-05-30,Senate,"Senate Domestic Animal Welfare Committee Vote",7,0,0,0,7
1261272,875422,2019-05-30,Senate,"Senate Domestic Animal Welfare Committee Vote",7,0,0,0,7
1261272,877242,2019-06-04,Senate,"Senate Floor Vote - Final Passage",62,0,0,0,62
1261272,881943,2019-06-12,Senate,"Senate Floor Vote - Final Passage",62,0,0,0,62
1261272,903100,2020-01-15,Senate,"Senate Domestic Animal Welfare Committee Vote",7,0,0,0,7
1261296,874229,2019-05-29,Assembly,"Assembly Environmental Conservation Committee: Favorable",29,0,0,1,30
1261296,879253,2019-06-06,Assembly,"Assembly Floor Vote - Final Passage",137,2,0,11,150
1261296,880283,2019-06-11,Senate,"Senate Floor Vote - Final Passage",59,2,0,1,62
1261313,874225,2019-05-29,Assembly,"Assembly Environmental Conservation Committee: Favorable",29,0,0,1,30
1261313,879244,2019-06-06,Assembly,"Assembly Floor Vote - Final Passage",137,2,0,11,150
1261313,880310,2019-06-11,Senate,"Senate Floor Vote - Final Passage",60,1,0,1,62
1261316,882177,2019-06-14,Senate,"Senate Floor Vote - Final Passage",59,3,0,0,62
1261316,882178,2019-06-14,Senate,"Senate Rules Committee Vote",19,0,0,0,19
1261316,884035,2019-06-18,Assembly,"Assembly Floor Vote - Final Passage",145,1,0,4,150
1261325,885039,2019-05-30,Senate,"Senate Higher Education Committee Vote",9,1,0,1,11
1261325,886775,2019-06-20,Senate,"Senate Floor Vote - Final Passage",62,0,0,0,62
1261353,874230,2019-05-29,Assembly,"Assembly Environmental Conservation Committee: Favorable",29,0,0,1,30
1261353,879241,2019-06-06,Assembly,"Assembly Floor Vote - Final Passage",137,2,0,11,150
1261353,880304,2019-06-11,Senate,"Senate Floor Vote - Final Passage",60,1,0,1,62
1261367,885420,2019-06-18,Senate,"Senate Floor Vote - Final Passage",56,6,0,0,62
1261367,886638,2019-06-18,Senate,"Senate Rules Committee Vote",19,0,0,0,19
1261378,886511,2019-06-20,Senate,"Senate Floor Vote - Final Passage",62,0,0,0,62
1261378,887267,2019-06-20,Senate,"Senate Rules Committee Vote",19,0,0,0,19
1261385,875688,2019-05-30,Senate,"Senate Cultural Affairs, Tourism, Parks and Recreation Committee Vote",7,0,0,0,7
1261385,877964,2019-06-05,Senate,"Senate Rules Committee Vote",15,4,0,0,19
1261385,881761,2019-06-13,Senate,"Senate Floor Vote - Final Passage",62,0,0,0,62
1261385,903178,2020-01-14,Senate,"Senate Cultural Affairs, Tourism, Parks and Recreation Committee Vote",7,0,0,0,7
1261385,935505,2020-02-25,Senate,"Senate Finance Committee Vote",22,0,0,1,23
1261385,940168,2020-03-02,Senate,"Senate Floor Vote - Final Passage",61,0,0,1,62
1261408,879238,2019-06-06,Assembly,"Assembly Agriculture Committee: Favorable refer to committee Codes",20,0,0,1,21
1261408,886171,2019-06-20,Assembly,"Assembly Rules Committee: Favorable",27,0,0,4,31
1261408,886172,2019-06-20,Assembly,"Assembly Ways And Means Committee: Favorable refer to committee Rules",33,0,0,2,35
1261424,875677,2019-05-29,Senate,"Senate Local Government Committee Vote",7,0,0,0,7
1261445,878861,2019-06-06,Senate,"Senate Floor Vote - Final Passage",43,18,0,1,62
1261445,878862,2019-06-06,Senate,"Senate Rules Committee Vote",16,3,0,0,19
1261445,886569,2019-06-21,Assembly,"Assembly Floor Vote - Final Passage",140,4,0,6,150
1261482,885906,2019-06-18,Senate,"Senate Floor Vote - Final Passage",54,8,0,0,62
1261482,886410,2019-06-18,Senate,"Senate Rules Committee Vote",16,3,0,0,19
1261482,886411,2019-06-21,Assembly,"Assembly Floor Vote - Final Passage",143,1,0,6,150
1261492,884314,2019-05-29,Senate,"Senate Local Government Committee Vote",7,0,0,0,7
1261492,886378,2019-06-19,Senate,"Senate Floor Vote - Final Passage",62,0,0,0,62
1261492,886379,2019-06-21,Assembly,"Assembly Floor Vote - Final Passage",122,12,0,16,150
1261519,882151,2019-06-14,Senate,"Senate Floor Vote - Final Passage",44,18,0,0,62
1261519,882152,2019-06-14,Senate,"Senate Rules Committee Vote",16,3,0,0,19
1261519,886160,2019-06-21,Assembly,"Assembly Floor Vote - Final Passage",111,29,0,10,150
1261530,868326,2019-05-21,Senate,"Senate Mental Health and Developmental Disabilities Committee Vote",7,0,0,0,7
1261533,878038,2019-06-05,Senate,"Senate Floor Vote - Final Passage",62,0,0,0,62
1261533,878039,2019-06-05,Senate,"Senate Rules Committee Vote",19,0,0,0,19
1261533,884356,2019-06-18,Assembly,"Assembly Floor Vote - Final Passage",147,0,0,3,150
1261549,877946,2019-06-05,Senate,"Senate Rules Committee Vote",19,0,0,0,19
1261549,878517,2019-06-05,Senate,"Senate Floor Vote - Final Passage",62,0,0,0,62
1261549,883285,2019-06-17,Assembly,"Assembly Floor Vote - Final Passage",148,0,0,2,150
1261670,881898,2019-06-13,Senate,"Senate Floor Vote - Final Passage",62,0,0,0,62
1261670,881899,2019-06-13,Senate,"Senate Rules Committee Vote",19,0,0,0,19
1261670,886295,2019-06-21,Assembly,"Assembly Floor Vote - Final Passage",135,0,0,15,150
1261672,943285,2020-03-03,Senate,"Senate Committee Vote",7,0,0,0,7
1261675,972117,2020-07-17,Assembly,"Assembly Codes Committee: Held for Consideration",15,6,0,1,22
1261676,886210,2019-06-21,Assembly,"Assembly Floor Vote - Final Passage",140,0,0,10,150
1261676,886691,2019-06-19,Senate,"Senate Floor Vote - Final Passage",61,1,0,0,62
1261676,887138,2019-06-19,Senate,"Senate Rules Committee Vote",18,1,0,0,19
1261680,884732,2019-05-29,Senate,"Senate Local Government Committee Vote",7,0,0,0,7
1261680,886541,2019-06-19,Senate,"Senate Floor Vote - Final Passage",62,0,0,0,62
1261680,931977,2020-02-24,Senate,"Senate Local Government Committee Vote",7,0,0,0,7
1261680,941783,2020-03-03,Senate,"Senate Floor Vote - Final Passage",62,0,0,0,62
1261683,874690,2019-05-29,Senate,"Senate Civil Service and Pensions Committee Vote",7,0,0,0,7
1261683,880017,2019-06-11,Senate,"Senate Rules Committee Vote",19,0,0,0,19
1261683,882836,2019-06-17,Senate,"Senate Floor Vote - Final Passage",62,0,0,0,62
1261683,886270,2019-06-20,Assembly,"Assembly Floor Vote - Final Passage",145,1,0,4,150
1261688,882886,2019-06-04,Senate,"Senate Rules Committee Vote",15,4,0,0,19
1261688,882887,2019-06-17,Senate,"Senate Floor Vote - Final Passage",40,22,0,0,62
1261689,886349,2019-06-21,Assembly,"Assembly Floor Vote - Final Passage",144,0,0,6,150
1261689,886787,2019-06-20,Senate,"Senate Floor Vote - Final Passage",62,0,0,0,62
1261689,887310,2019-06-19,Senate,"Senate Rules Committee Vote",19,0,0,0,19
1261710,885501,2019-06-18,Senate,"Senate Floor Vote - Final Passage",62,0,0,0,62
1261710,886190,2019-06-21,Assembly,"Assembly Floor Vote - Final Passage",91,43,0,16,150
1261710,886669,2019-06-18,Senate,"Senate Rules Committee Vote",17,2,0,0,19
1261717,886114,2019-06-18,Senate,"Senate Floor Vote - Final Passage",62,0,0,0,62
1261717,886582,2019-06-18,Senate,"Senate Rules Committee Vote",19,0,0,0,19
1261717,942668,2020-03-04,Senate,"Senate Aging Committee Vote",7,0,0,0,7
1261722,937115,2020-02-26,Senate,"Senate Civil Service and Pensions Committee Vote",7,0,0,0,7
1261732,885087,2019-06-19,Senate,"Senate Rules Committee Vote",19,0,0,0,19
1261732,886352,2019-06-19,Senate,"Senate Floor Vote - Final Passage",62,0,0,0,62
1261732,886353,2019-06-21,Assembly,"Assembly Floor Vote - Final Passage",144,0,0,6,150
1261734,885091,2019-06-19,Senate,"Senate Rules Committee Vote",19,0,0,0,19
1261734,886188,2019-06-21,Assembly,"Assembly Floor Vote - Final Passage",135,5,0,10,150
1261734,886672,2019-06-19,Senate,"Senate Floor Vote - Final Passage",62,0,0,0,62
1261736,880933,2019-05-29,Senate,"Senate Investigations and Government Operations Committee Vote",7,0,0,0,7
1261736,881922,2019-06-12,Senate,"Senate Floor Vote - Final Passage",60,2,0,0,62
1261736,883157,2019-06-17,Assembly,"Assembly Floor Vote - Final Passage",144,4,0,2,150
1261744,877379,2019-06-04,Assembly,"Assembly Correction Committee: Favorable refer to committee Rules",13,0,0,0,13
1261744,880721,2019-06-12,Assembly,"Assembly Rules Committee: Favorable",27,0,0,4,31
1261744,883143,2019-06-17,Assembly,"Assembly Floor Vote - Final Passage",146,2,0,2,150
1261744,886793,2019-06-20,Senate,"Senate Floor Vote - Final Passage",62,0,0,0,62
1261746,882892,2019-06-04,Senate,"Senate Rules Committee Vote",15,4,0,0,19
1261746,882893,2019-06-17,Senate,"Senate Floor Vote - Final Passage",40,22,0,0,62
1261750,874334,2019-05-29,Senate,"Senate Agriculture Committee Vote",9,0,0,0,9
1261750,878060,2019-06-04,Senate,"Senate Rules Committee Vote",19,0,0,0,19
1261750,880596,2019-06-11,Senate,"Senate Floor Vote - Final Passage",61,0,0,1,62
1261750,905079,2020-01-23,Senate,"Senate Agriculture Committee Vote",9,0,0,0,9
1261757,874740,2019-05-30,Senate,"Senate New York City Education Committee Vote",7,0,0,0,7
1261757,880032,2019-06-11,Senate,"Senate Rules Committee Vote",19,0,0,0,19
1261757,880508,2019-06-11,Senate,"Senate Floor Vote - Final Passage",61,0,0,1,62
1261765,885448,2019-06-18,Senate,"Senate Floor Vote - Final Passage",62,0,0,0,62
1261765,886651,2019-06-18,Senate,"Senate Rules Committee Vote",19,0,0,0,19
1261765,904453,2020-01-22,Senate,"Senate Finance Committee Vote",23,0,0,0,23
1261776,882068,2019-05-29,Senate,"Senate Investigations And Government Operations Committee Vote",7,0,0,0,7
1261776,882069,2019-06-14,Senate,"Senate Floor Vote - Final Passage",62,0,0,0,62
1261776,886310,2019-06-20,Assembly,"Assembly Floor Vote - Final Passage",147,1,0,2,150
1261781,874223,2019-05-29,Assembly,"Assembly Environmental Conservation Committee: Favorable",29,0,0,1,30
1261781,879249,2019-06-06,Assembly,"Assembly Floor Vote - Final Passage",138,1,0,11,150
1261781,880315,2019-06-11,Senate,"Senate Floor Vote - Final Passage",60,1,0,1,62
1261783,964186,2020-06-09,Senate,"Senate Floor Vote - Final Passage",62,0,0,0,62
1261783,966182,2020-05-28,Senate,"Senate Rules Committee Vote",19,0,0,0,19
1261783,966183,2020-06-08,Senate,"Senate Transportation Committee Vote",15,0,0,0,15
1261786,913830,2020-02-03,Senate,"Senate Domestic Animal Welfare Committee Vote",6,0,0,1,7
1261788,883235,2019-05-30,Senate,"Senate Health Committee Vote",15,0,0,0,15
1261788,883236,2019-06-17,Senate,"Senate Floor Vote - Final Passage",61,1,0,0,62
1261788,884004,2019-06-18,Assembly,"Assembly Floor Vote - Final Passage",142,6,0,2,150
1261790,948304,2020-03-10,Senate,"Senate Judiciary Committee Vote",14,0,0,1,15
1261790,972611,2020-07-21,Senate,"Senate Finance Committee Vote",23,0,0,0,23
1261790,973627,2020-07-22,Senate,"Senate Floor Vote - Final Passage",60,0,0,0,60
1261790,973628,2020-07-23,Assembly,"Assembly Floor Vote - Final Passage",140,1,0,4,145
1261790,973810,2020-07-21,Senate,"Senate Finance Committee Vote",23,0,0,0,23
1261791,971198,2020-07-14,Assembly,"Assembly Correction Committee: Held for Consideration",10,2,0,1,13
1261799,878423,2019-06-05,Assembly,"Assembly Transportation Committee: Favorable refer to committee Ways and Means",26,0,0,0,26
1261799,880366,2019-06-11,Assembly,"Assembly Ways And Means Committee: Favorable refer to committee Rules",33,0,0,2,35
1261799,881696,2019-06-14,Assembly,"Assembly Rules Committee: Favorable",25,0,0,6,31
1261803,884571,2019-06-13,Senate,"Senate Rules Committee Vote",15,4,0,0,19
1261803,886306,2019-06-19,Senate,"Senate Floor Vote - Final Passage",43,19,0,0,62
1261803,886307,2019-06-21,Assembly,"Assembly Floor Vote - Final Passage",111,30,0,9,150
1261808,883523,2019-06-17,Assembly,"Assembly Education Committee: Favorable refer to committee Rules",27,0,0,4,31
1261808,883524,2019-06-18,Assembly,"Assembly Rules Committee: Favorable",25,0,0,6,31
1261812,879370,2019-06-06,Assembly,"Assembly Ways And Means Committee: Favorable refer to committee Rules",21,10,0,4,35
1261812,880755,2019-06-12,Assembly,"Assembly Rules Committee: Favorable",27,0,0,4,31
1261818,881879,2019-06-13,Senate,"Senate Floor Vote - Final Passage",62,0,0,0,62
1261818,881880,2019-06-13,Senate,"Senate Rules Committee Vote",19,0,0,0,19
1261818,883130,2019-06-17,Assembly,"Assembly Floor Vote - Final Passage",148,0,0,2,150
1261824,878595,2019-06-05,Assembly,"Assembly Ways And Means Committee: Favorable refer to committee Rules",23,8,0,4,35
1261824,880716,2019-06-12,Assembly,"Assembly Rules Committee: Favorable",27,0,0,4,31
1261825,877609,2019-06-04,Assembly,"Assembly Economic Development Committee: Favorable refer to committee Ways and Means",24,0,0,2,26
1261828,877841,2019-06-05,Assembly,"Assembly Local Governments Committee: Favorable refer to committee Ways and Means",18,0,0,1,19
1261828,879340,2019-06-06,Assembly,"Assembly Ways And Means Committee: Favorable refer to committee Rules",31,0,0,4,35
1261828,880707,2019-06-12,Assembly,"Assembly Rules Committee: Favorable",27,0,0,4,31
1261830,880038,2019-06-11,Senate,"Senate Rules Committee Vote",19,0,0,0,19
1261830,880513,2019-06-11,Senate,"Senate Floor Vote - Final Passage",59,2,0,1,62
1261830,883040,2019-06-17,Senate,"Senate Floor Vote - Final Passage",60,2,0,0,62
1261830,886235,2019-06-21,Assembly,"Assembly Floor Vote - Final Passage",131,9,0,10,150
1261833,882586,2019-06-13,Senate,"Senate Rules Committee Vote",19,0,0,0,19
1261833,883104,2019-06-17,Senate,"Senate Floor Vote - Final Passage",62,0,0,0,62
1261833,886312,2019-06-20,Assembly,"Assembly Floor Vote - Final Passage",139,7,0,4,150
1261835,880715,2019-06-12,Assembly,"Assembly Local Governments Committee: Favorable refer to committee Ways and Means",17,0,0,2,19
1261835,881583,2019-06-13,Assembly,"Assembly Ways And Means Committee: Favorable refer to committee Rules",26,3,0,6,35
1261835,882481,2019-06-17,Assembly,"Assembly Rules Committee: Favorable",26,0,0,5,31
1261835,884496,2019-06-18,Assembly,"Assembly Floor Vote - Final Passage",143,5,0,2,150
1261843,885125,2019-06-19,Assembly,"Assembly Floor Vote - Final Passage",145,3,0,2,150
1261843,885921,2019-06-18,Senate,"Senate Floor Vote - Final Passage",62,0,0,0,62
1261843,886431,2019-06-18,Senate,"Senate Rules Committee Vote",19,0,0,0,19
1261857,880020,2019-06-11,Senate,"Senate Rules Committee Vote",17,2,0,0,19
1261857,880484,2019-06-11,Senate,"Senate Floor Vote - Final Passage",55,6,0,1,62
1261862,940887,2020-03-03,Senate,"Senate Committee Vote",7,0,0,0,7
1261865,880899,2019-06-04,Senate,"Senate Rules Committee Vote",19,0,0,0,19
1261865,882006,2019-06-12,Senate,"Senate Floor Vote - Final Passage",55,7,0,0,62
1261865,882771,2019-06-17,Senate,"Senate Floor Vote - Final Passage",55,7,0,0,62
1261865,886393,2019-06-20,Assembly,"Assembly Floor Vote - Final Passage",141,5,0,4,150
1261875,875638,2019-05-30,Senate,"Senate Higher Education Committee Vote",10,0,0,1,11
1261875,877268,2019-06-04,Senate,"Senate Floor Vote - Final Passage",62,0,0,0,62
1261875,877802,2019-06-04,Senate,"Senate Rules Committee Vote",19,0,0,0,19
1261875,886315,2019-06-21,Assembly,"Assembly Floor Vote - Final Passage",144,0,0,6,150
1261877,875685,2019-05-30,Senate,"Senate Higher Education Committee Vote",9,1,0,1,11
1261877,881842,2019-06-13,Senate,"Senate Floor Vote - Final Passage",45,17,0,0,62
1261877,881843,2019-06-13,Senate,"Senate Rules Committee Vote",17,2,0,0,19
1261877,902617,2020-01-14,Senate,"Senate Higher Education Committee Vote",10,0,0,1,11
1261879,875194,2019-05-30,Assembly,"Assembly Agriculture Committee: Favorable refer to committee Codes",19,0,0,2,21
1261879,877171,2019-06-04,Assembly,"Assembly Codes Committee: Favorable refer to committee Rules",22,0,0,0,22
1261879,880706,2019-06-12,Assembly,"Assembly Rules Committee: Favorable",27,0,0,4,31
1261889,963432,2019-06-05,Senate,"Senate Rules Committee Vote",19,0,0,0,19
1261889,964182,2020-06-09,Senate,"Senate Floor Vote - Final Passage",62,0,0,0,62
1261889,967758,2020-05-28,Senate,"Senate Rules Committee Vote",19,0,0,0,19
1261889,967759,2020-06-08,Senate,"Senate Investigations and Government Operations Committee Vote",7,0,0,0,7
1261891,877280,2019-06-04,Senate,"Senate Floor Vote - Final Passage",55,7,0,0,62
1261891,877804,2019-06-04,Senate,"Senate Rules Committee Vote",19,0,0,0,19
1261896,885034,2019-06-19,Assembly,"Assembly Floor Vote - Final Passage",146,2,0,2,150
1261896,885742,2019-06-18,Senate,"Senate Floor Vote - Final Passage",62,0,0,0,62
1261896,886293,2019-06-18,Senate,"Senate Rules Committee Vote",19,0,0,0,19
1261897,886605,2019-06-20,Senate,"Senate Floor Vote - Final Passage",62,0,0,0,62
1261897,887337,2019-06-20,Senate,"Senate Rules Committee Vote",19,0,0,0,19
1261904,869323,2019-05-20,Senate,"Senate Rules Committee Vote",17,1,0,1,19
1261904,869324,2019-05-22,Senate,"Senate Floor Vote - Final Passage",56,5,0,1,62
1261904,879337,2019-06-06,Assembly,"Assembly Floor Vote - Final Passage",139,0,0,11,150
1261905,884608,2019-06-18,Senate,"Senate Rules Committee Vote",17,2,0,0,19
1261905,885103,2019-06-18,Senate,"Senate Floor Vote - Final Passage",62,0,0,0,62
1261905,886399,2019-06-21,Assembly,"Assembly Floor Vote - Final Passage",144,0,0,6,150
1261906,879228,2019-06-06,Assembly,"Assembly Environmental Conservation Committee: Favorable refer to committee Rules",28,0,0,2,30
1261906,880738,2019-06-12,Assembly,"Assembly Rules Committee: Favorable",27,0,0,4,31
1261911,877973,2019-06-05,Assembly,"Assembly Education Committee: Favorable refer to committee Ways and Means",29,0,0,2,31
1261911,879332,2019-06-06,Assembly,"Assembly Ways And Means Committee: Favorable refer to committee Rules",31,0,0,4,35
1261911,880701,2019-06-12,Assembly,"Assembly Rules Committee: Favorable",27,0,0,4,31
1261920,874250,2019-05-29,Assembly,"Assembly Environmental Conservation Committee: Favorable",29,0,0,1,30
1261934,885419,2019-06-18,Senate,"Senate Floor Vote - Final Passage",62,0,0,0,62
1261934,886646,2019-06-18,Senate,"Senate Rules Committee Vote",19,0,0,0,19
1261934,886647,2019-06-20,Assembly,"Assembly Floor Vote - Final Passage",135,13,0,2,150
1261936,883000,2019-06-17,Senate,"Senate Floor Vote - Final Passage",62,0,0,0,62
1261936,883001,2019-06-17,Senate,"Senate Rules Committee Vote",19,0,0,0,19
1261936,921364,2020-02-11,Senate,"Senate Internet and Technology Committee Vote",7,0,0,0,7
1261936,934900,2020-02-25,Senate,"Senate Floor Vote - Final Passage",60,0,0,2,62
1261942,875626,2019-05-29,Senate,"Senate Local Government Committee Vote",6,1,0,0,7
1261942,886030,2019-06-18,Senate,"Senate Floor Vote - Final Passage",47,15,0,0,62
1261942,886530,2019-06-18,Senate,"Senate Rules Committee Vote",17,2,0,0,19
1261946,881877,2019-06-13,Senate,"Senate Floor Vote - Final Passage",41,21,0,0,62
1261946,881878,2019-06-13,Senate,"Senate Rules Committee Vote",15,4,0,0,19
1261948,877292,2019-06-04,Senate,"Senate Floor Vote - Final Passage",62,0,0,0,62
1261948,878061,2019-06-04,Senate,"Senate Rules Committee Vote",19,0,0,0,19
1261948,879394,2019-06-06,Assembly,"Assembly Floor Vote - Final Passage",139,0,0,11,150
1261950,886167,2019-06-21,Assembly,"Assembly Floor Vote - Final Passage",113,28,0,9,150
1261950,886653,2019-06-19,Senate,"Senate Floor Vote - Final Passage",43,19,0,0,62
1261950,887146,2019-06-19,Senate,"Senate Rules Committee Vote",15,4,0,0,19
1261977,885897,2019-06-18,Senate,"Senate Floor Vote - Final Passage",62,0,0,0,62
1261977,886391,2019-06-18,Senate,"Senate Rules Committee Vote",19,0,0,0,19
1261977,886392,2019-06-21,Assembly,"Assembly Floor Vote - Final Passage",143,1,0,6,150
1261979,875667,2019-05-29,Senate,"Senate Local Government Committee Vote",6,1,0,0,7
1261979,886107,2019-06-18,Senate,"Senate Floor Vote - Final Passage",46,16,0,0,62
1261979,886572,2019-06-18,Senate,"Senate Rules Committee Vote",17,2,0,0,19
1261993,884936,2019-06-19,Assembly,"Assembly Rules Committee: Favorable",28,0,0,3,31
1261993,884937,2019-06-19,Assembly,"Assembly Ways And Means Committee: Favorable refer to committee Rules",33,0,0,2,35
1261994,886007,2019-06-18,Senate,"Senate Floor Vote - Final Passage",62,0,0,0,62
1261994,886496,2019-06-18,Senate,"Senate Rules Committee Vote",18,1,0,0,19
1262006,885881,2019-06-18,Senate,"Senate Floor Vote - Final Passage",62,0,0,0,62
1262006,886363,2019-06-18,Senate,"Senate Rules Committee Vote",19,0,0,0,19
1262006,904656,2020-01-21,Senate,"Senate Children and Families Committee Vote",7,0,0,0,7
1262016,879986,2019-05-30,Senate,"Senate Education Committee Vote",14,0,0,1,15
1262016,880440,2019-06-11,Senate,"Senate Floor Vote - Final Passage",61,0,0,1,62
1262016,908747,2020-01-28,Senate,"Senate Education Committee Vote",15,0,0,0,15
1262016,972391,2020-07-21,Senate,"Senate Floor Vote - Final Passage",60,0,0,0,60
1262018,874935,2019-05-30,Senate,"Senate Transportation Committee Vote",14,1,0,0,15
1262018,935689,2020-02-25,Senate,"Senate Transportation Committee Vote",15,0,0,0,15
1262018,940982,2020-03-03,Senate,"Senate Floor Vote - Final Passage",62,0,0,0,62
1262020,886537,2019-06-19,Senate,"Senate Floor Vote - Final Passage",46,16,0,0,62
1262020,887170,2019-06-19,Senate,"Senate Rules Committee Vote",14,5,0,0,19
1262020,935640,2020-02-25,Senate,"Senate Transportation Committee Vote",14,1,0,0,15
1262023,874054,2019-05-29,Senate,"Senate Energy And Telecommunications Committee Vote",9,0,0,0,9
1262023,877566,2019-06-04,Senate,"Senate Floor Vote - Final Passage",62,0,0,0,62
1262023,877751,2019-06-04,Senate,"Senate Rules Committee Vote",19,0,0,0,19
1262023,883111,2019-06-17,Assembly,"Assembly Floor Vote - Final Passage",120,26,0,4,150
1262023,884279,2019-06-18,Senate,"Senate Rules Committee Vote",17,2,0,0,19
1262024,883823,2019-05-30,Senate,"Senate Higher Education Committee Vote",10,0,0,1,11
1262024,885313,2019-06-18,Senate,"Senate Floor Vote - Final Passage",62,0,0,0,62
1262039,885516,2019-06-18,Senate,"Senate Floor Vote - Final Passage",61,1,0,0,62
1262039,886205,2019-06-21,Assembly,"Assembly Floor Vote - Final Passage",138,2,0,10,150
1262039,886680,2019-06-18,Senate,"Senate Rules Committee Vote",18,1,0,0,19
1262042,883035,2019-06-17,Senate,"Senate Floor Vote - Final Passage",61,1,0,0,62
1262042,883036,2019-06-17,Senate,"Senate Rules Committee Vote",19,0,0,0,19
1262042,906684,2020-01-28,Senate,"Senate Judiciary Committee Vote",15,0,0,0,15
1262048,885768,2019-06-18,Senate,"Senate Floor Vote - Final Passage",62,0,0,0,62
1262048,886311,2019-06-18,Senate,"Senate Rules Committee Vote",19,0,0,0,19
1262050,875381,2019-05-30,Senate,"Senate New York City Education Committee Vote",7,0,0,0,7
1262069,914010,2020-02-04,Senate,"Senate Mental Health and Developmental Disabilities Committee Vote",7,0,0,0,7
1262071,881871,2019-06-13,Senate,"Senate Floor Vote - Final Passage",62,0,0,0,62
1262071,881872,2019-06-13,Senate,"Senate Rules Committee Vote",19,0,0,0,19
1262071,904754,2020-01-22,Senate,"Senate Finance Committee Vote",23,0,0,0,23
1262071,936585,2020-02-26,Senate,"Senate Floor Vote - Final Passage",60,0,0,2,62
1262082,882851,2019-05-30,Senate,"Senate Transportation Committee Vote",15,0,0,0,15
1262082,882852,2019-06-17,Senate,"Senate Floor Vote - Final Passage",61,1,0,0,62
1262082,915090,2020-02-04,Senate,"Senate Transportation Committee Vote",15,0,0,0,15
1262085,878737,2019-05-30,Senate,"Senate Cultural Affairs, Tourism, Parks and Recreation Committee Vote",7,0,0,0,7
1262085,879178,2019-06-06,Senate,"Senate Floor Vote - Final Passage",61,0,0,1,62
1262085,883298,2019-06-17,Assembly,"Assembly Floor Vote - Final Passage",148,0,0,2,150
1262091,869556,2019-05-22,Assembly,"Assembly Election Law Committee: Favorable refer to committee Ways and Means",10,4,0,2,16
1262091,877161,2019-06-04,Assembly,"Assembly Ways And Means Committee: Favorable refer to committee Rules",25,8,0,2,35
1262091,880739,2019-06-12,Assembly,"Assembly Rules Committee: Favorable",27,0,0,4,31
1262101,886620,2019-06-19,Senate,"Senate Floor Vote - Final Passage",62,0,0,0,62
1262101,887129,2019-06-19,Senate,"Senate Rules Committee Vote",19,0,0,0,19
1262132,874386,2019-05-29,Senate,"Senate Children and Families Committee Vote",6,1,0,0,7
1262133,942121,2020-03-03,Senate,"Senate Labor Committee Vote",10,3,0,0,13
1262260,874376,2019-05-29,Senate,"Senate Racing, Gaming and Wagering Committee Vote",5,2,0,0,7
1262260,885150,2019-06-19,Senate,"Senate Rules Committee Vote",15,4,0,0,19
1262260,886463,2019-06-19,Senate,"Senate Floor Vote - Final Passage",53,9,0,0,62
1262300,875181,2019-05-30,Assembly,"Assembly Judiciary Committee: Favorable",20,0,0,1,21
1262300,879262,2019-06-06,Assembly,"Assembly Floor Vote - Final Passage",139,0,0,11,150
1262300,886771,2019-06-20,Senate,"Senate Floor Vote - Final Passage",62,0,0,0,62
1262318,878191,2019-06-05,Assembly,"Assembly Health Committee: Favorable refer to committee Rules",25,0,0,1,26
1262318,880768,2019-06-12,Assembly,"Assembly Rules Committee: Favorable",27,0,0,4,31
1262321,877597,2019-06-04,Assembly,"Assembly Mental Health Committee: Favorable refer to committee Ways and Means",12,0,0,1,13
1262343,884519,2019-06-19,Assembly,"Assembly Ways And Means Committee: Favorable refer to committee Rules",32,1,0,2,35
1262343,885234,2019-06-20,Assembly,"Assembly Rules Committee: Favorable",27,0,0,4,31
1262361,883989,2019-06-18,Assembly,"Assembly Local Governments Committee: Favorable refer to committee Ways and Means",14,3,0,2,19
1262361,884837,2019-06-19,Assembly,"Assembly Ways And Means Committee: Favorable refer to committee Rules",30,3,0,2,35
1262361,885217,2019-06-20,Assembly,"Assembly Rules Committee: Favorable",27,0,0,4,31
1262383,882767,2019-06-17,Assembly,"Assembly Local Governments Committee: Favorable refer to committee Ways and Means",18,0,0,1,19
1262389,868538,2019-05-21,Assembly,"Assembly Governmental Employees Committee: Favorable refer to committee Ways and Means",13,1,0,0,14
1262396,883490,2019-06-18,Assembly,"Assembly Rules Committee: Favorable",25,0,0,6,31
1262396,883491,2019-06-18,Assembly,"Assembly Ways And Means Committee: Favorable refer to committee Rules",25,8,0,2,35
1262500,880106,2019-05-29,Senate,"Senate Racing, Gaming and Wagering Committee Vote",7,0,0,0,7
1262500,880592,2019-06-11,Senate,"Senate Floor Vote - Final Passage",61,0,0,1,62
1262500,940481,2020-03-02,Senate,"Senate Racing, Gaming and Wagering Committee Vote",7,0,0,0,7
1262500,949723,2020-03-11,Senate,"Senate Floor Vote - Final Passage",58,0,0,4,62
1262510,878226,2019-06-05,Assembly,"Assembly Health Committee: Favorable refer to committee Codes",24,1,0,1,26
1262510,881416,2019-06-13,Assembly,"Assembly Codes Committee: Favorable refer to committee Rules",19,1,0,2,22
1262521,867932,2019-05-21,Assembly,"Assembly Governmental Employees Committee: Favorable refer to committee Ways and Means",14,0,0,0,14
1262521,882696,2019-06-17,Assembly,"Assembly Rules Committee: Favorable",25,0,0,6,31
1262521,882697,2019-06-17,Assembly,"Assembly Ways And Means Committee: Favorable refer to committee Rules",27,6,0,2,35
1262524,886512,2019-06-20,Senate,"Senate Floor Vote - Final Passage",62,0,0,0,62
1262524,887334,2019-06-20,Senate,"Senate Rules Committee Vote",19,0,0,0,19
1262524,972330,2020-07-20,Senate,"Senate Local Government Committee Vote",7,0,0,0,7
1262524,973986,2020-07-22,Senate,"Senate Floor Vote - Final Passage",60,0,0,0,60
1262524,973987,2020-07-22,Senate,"Senate Rules Committee Vote",19,0,0,0,19
1262539,877283,2019-06-04,Assembly,"Assembly Codes Committee: Favorable refer to committee Rules",18,4,0,0,22
1262539,882522,2019-06-17,Assembly,"Assembly Rules Committee: Favorable",19,7,0,5,31
1262547,881012,2019-05-30,Senate,"Senate Environmental Conservation Committee Vote",10,0,0,1,11
1262547,882007,2019-06-12,Senate,"Senate Floor Vote - Final Passage",62,0,0,0,62
1262547,885303,2019-06-19,Assembly,"Assembly Floor Vote - Final Passage",148,0,0,2,150
1262618,971430,2020-07-16,Assembly,"Assembly Governmental Operations Committee: Favorable refer to committee Ways and Means",14,0,0,0,14
1262618,971849,2020-07-17,Assembly,"Assembly Ways And Means Committee: Favorable refer to committee Rules",32,0,0,2,34
1262618,972217,2020-07-20,Assembly,"Assembly Rules Committee: Favorable",27,0,0,3,30
1262618,972278,2020-07-20,Assembly,"Assembly Floor Vote - Final Passage",141,0,0,4,145
1262622,875046,2019-05-30,Assembly,"Assembly Codes Committee: Favorable",15,4,0,3,22
1262623,878330,2019-06-05,Assembly,"Assembly Education Committee: Favorable refer to committee Ways and Means",29,0,0,2,31
1262623,882043,2019-06-14,Assembly,"Assembly Ways And Means Committee: Favorable refer to committee Rules",30,0,0,5,35
1262623,883582,2019-06-18,Assembly,"Assembly Rules Committee: Favorable",25,0,0,6,31
1262636,877875,2019-05-30,Senate,"Senate Cities Committee Vote",7,0,0,0,7
1262636,878426,2019-06-05,Senate,"Senate Floor Vote - Final Passage",62,0,0,0,62
1262636,883314,2019-06-17,Assembly,"Assembly Floor Vote - Final Passage",148,0,0,2,150
1262654,868995,2019-05-21,Senate,"Senate Rules Committee Vote",12,7,0,0,19
1262654,869525,2019-05-22,Senate,"Senate Floor Vote - Final Passage",40,21,0,1,62
1262654,870251,2019-05-22,Assembly,"Assembly Floor Vote - Final Passage",91,51,0,8,150
1262656,904426,2020-01-22,Assembly,"Assembly Corporations, Authorities And Commissions Committee: Favorable refer to committee Codes",17,7,0,2,26
1262656,906858,2020-01-28,Assembly,"Assembly Codes Committee: Favorable",15,6,0,1,22
1262656,972707,2020-07-21,Assembly,"Assembly Floor Vote - Final Passage",140,2,0,3,145
1262663,870531,2019-05-21,Assembly,"Assembly Education Committee: Favorable refer to committee Ways and Means",31,0,0,0,31
1262663,874775,2019-05-30,Assembly,"Assembly Ways And Means Committee: Favorable",23,8,0,4,35
1262668,972860,2020-07-22,Assembly,"Assembly Ways And Means Committee: Favorable refer to committee Rules",32,0,0,2,34
1262668,973110,2020-07-22,Assembly,"Assembly Rules Committee: Favorable",29,0,0,1,30
1262672,868057,2019-05-21,Assembly,"Assembly Rules Committee: Favorable",20,8,0,3,31
1262672,868058,2019-05-21,Assembly,"Assembly Ways And Means Committee: Favorable refer to committee Rules",21,11,0,3,35
1262680,882884,2019-06-17,Assembly,"Assembly Codes Committee: Favorable refer to committee Rules",19,1,0,2,22
1262680,883621,2019-06-18,Assembly,"Assembly Rules Committee: Favorable",25,0,0,6,31
1262686,878013,2019-06-05,Assembly,"Assembly Codes Committee: Favorable refer to committee Rules",15,7,0,0,22
1262686,880733,2019-06-12,Assembly,"Assembly Rules Committee: Favorable",19,8,0,4,31
1262686,885012,2019-06-19,Assembly,"Assembly Floor Vote - Final Passage",99,49,0,2,150
1262686,886734,2019-06-20,Senate,"Senate Floor Vote - Final Passage",36,23,0,3,62
1262734,881778,2019-06-14,Assembly,"Assembly Cities Committee: Favorable refer to committee Ways and Means",15,0,0,0,15
1262734,882649,2019-06-17,Assembly,"Assembly Rules Committee: Favorable",25,0,0,6,31
1262734,882650,2019-06-17,Assembly,"Assembly Ways And Means Committee: Favorable refer to committee Rules",33,0,0,2,35
1262857,874149,2019-05-29,Assembly,"Assembly Racing And Wagering Committee: Favorable refer to committee Ways and Means",8,3,0,0,11
1262884,874202,2019-05-29,Assembly,"Assembly Racing And Wagering Committee: Favorable refer to committee Ways and Means",11,0,0,0,11
1262884,879386,2019-06-06,Assembly,"Assembly Ways And Means Committee: Favorable refer to committee Rules",31,0,0,4,35
1262884,880752,2019-06-12,Assembly,"Assembly Rules Committee: Favorable",27,0,0,4,31
1262884,883211,2019-06-17,Assembly,"Assembly Floor Vote - Final Passage",129,18,0,3,150
1262884,883751,2019-06-18,Senate,"Senate Floor Vote - Final Passage",62,0,0,0,62
1262929,878101,2019-06-05,Assembly,"Assembly Energy Committee: Favorable refer to committee Rules",17,0,0,0,17
1262929,880748,2019-06-12,Assembly,"Assembly Rules Committee: Favorable",27,0,0,4,31
1262929,882908,2019-06-17,Senate,"Senate Floor Vote - Final Passage",46,16,0,0,62
1262929,883299,2019-06-17,Assembly,"Assembly Floor Vote - Final Passage",148,0,0,2,150
1262950,882655,2019-06-17,Assembly,"Assembly Rules Committee: Favorable",25,0,0,6,31
1262950,882656,2019-06-17,Assembly,"Assembly Ways And Means Committee: Favorable refer to committee Rules",33,0,0,2,35
1262954,877463,2019-05-29,Senate,"Senate Crime Victims, Crime and Correction Committee Vote",7,0,0,0,7
1262954,877464,2019-06-04,Senate,"Senate Floor Vote - Final Passage",62,0,0,0,62
1262954,886648,2019-06-21,Assembly,"Assembly Floor Vote - Final Passage",142,2,0,6,150
1262958,874929,2019-05-30,Senate,"Senate Veterans, Homeland Security and Military Affairs Committee Vote",9,0,0,0,9
1262958,881722,2019-06-13,Senate,"Senate Floor Vote - Final Passage",44,18,0,0,62
1262958,881723,2019-06-13,Senate,"Senate Rules Committee Vote",15,4,0,0,19
1262958,903054,2020-01-14,Senate,"Senate Veterans, Homeland Security and Military Affairs Committee Vote",7,1,0,1,9
1262958,935427,2020-02-25,Senate,"Senate Finance Committee Vote",16,6,0,1,23
1262981,883114,2019-06-17,Assembly,"Assembly Judiciary Committee: Favorable refer to committee Rules",18,0,0,3,21
1262981,883517,2019-06-18,Assembly,"Assembly Rules Committee: Favorable",25,0,0,6,31
1263004,881844,2019-06-13,Senate,"Senate Floor Vote - Final Passage",62,0,0,0,62
1263004,881845,2019-06-13,Senate,"Senate Rules Committee Vote",19,0,0,0,19
1263004,905959,2020-01-27,Senate,"Senate Codes Committee Vote",12,0,0,0,12
1263004,937911,2020-02-27,Senate,"Senate Floor Vote - Final Passage",59,0,0,3,62
1263013,878027,2019-05-30,Senate,"Senate Housing, Construction and Community Development Committee Vote",10,0,0,1,11
1263013,878524,2019-06-05,Senate,"Senate Floor Vote - Final Passage",62,0,0,0,62
1263013,904721,2020-01-21,Senate,"Senate Housing, Construction and Community Development Committee Vote",11,0,0,0,11
1263013,972764,2020-07-21,Senate,"Senate Floor Vote - Final Passage",60,0,0,0,60
1263021,879122,2019-06-06,Senate,"Senate Floor Vote - Final Passage",61,0,0,1,62
1263021,879123,2019-06-06,Senate,"Senate Rules Committee Vote",18,1,0,0,19
1263021,883248,2019-06-17,Assembly,"Assembly Floor Vote - Final Passage",142,6,0,2,150
1263048,878176,2019-05-29,Senate,"Senate Crime Victims, Crime and Correction Committee Vote",7,0,0,0,7
1263048,878177,2019-06-05,Senate,"Senate Floor Vote - Final Passage",57,5,0,0,62
1263048,904528,2020-01-21,Senate,"Senate Crime Victims, Crime and Correction Committee Vote",7,0,0,0,7
1263048,909263,2020-01-29,Senate,"Senate Floor Vote - Final Passage",53,5,0,4,62
1263115,878014,2019-06-05,Senate,"Senate Rules Committee Vote",12,7,0,0,19
1263115,878271,2019-06-05,Senate,"Senate Floor Vote - Final Passage",41,21,0,0,62
1263115,886155,2019-06-20,Assembly,"Assembly Floor Vote - Final Passage",101,46,0,3,150
1263128,875631,2019-05-29,Senate,"Senate Crime Victims, Crime and Correction Committee Vote",7,0,0,0,7
1263128,877289,2019-06-04,Senate,"Senate Floor Vote - Final Passage",62,0,0,0,62
1263128,879552,2019-06-04,Senate,"Senate Rules Committee Vote",19,0,0,0,19
1263139,878236,2019-05-30,Senate,"Senate Judiciary Committee Vote",14,0,0,1,15
1263139,878237,2019-06-05,Senate,"Senate Floor Vote - Final Passage",62,0,0,0,62
1263139,906827,2020-01-28,Senate,"Senate Judiciary Committee Vote",15,0,0,0,15
1263139,951192,2020-03-11,Senate,"Senate Floor Vote - Final Passage",58,0,0,4,62
1263150,882089,2019-06-14,Assembly,"Assembly Governmental Employees Committee: Favorable refer to committee Ways and Means",13,0,0,1,14
1263150,882651,2019-06-17,Assembly,"Assembly Rules Committee: Favorable",25,0,0,6,31
1263150,882652,2019-06-17,Assembly,"Assembly Ways And Means Committee: Favorable refer to committee Rules",32,1,0,2,35
1263150,885048,2019-06-19,Assembly,"Assembly Floor Vote - Final Passage",145,3,0,2,150
1263177,875030,2019-05-30,Assembly,"Assembly Social Services Committee: Favorable",16,0,0,2,18
1263177,879243,2019-06-06,Assembly,"Assembly Floor Vote - Final Passage",139,0,0,11,150
1263177,881750,2019-06-13,Senate,"Senate Floor Vote - Final Passage",62,0,0,0,62
1263181,878644,2019-06-05,Assembly,"Assembly Transportation Committee: Favorable refer to committee Rules",26,0,0,0,26
1263181,880736,2019-06-12,Assembly,"Assembly Rules Committee: Favorable",27,0,0,4,31
1263183,879088,2019-06-06,Senate,"Senate Floor Vote - Final Passage",60,1,0,1,62
1263183,879089,2019-06-06,Senate,"Senate Rules Committee Vote",19,0,0,0,19
1263183,941741,2020-03-02,Senate,"Senate Corporations, Authorities and Commissions Committee Vote",6,0,0,1,7
1263192,878867,2019-06-06,Senate,"Senate Floor Vote - Final Passage",61,0,0,1,62
1263192,878868,2019-06-06,Senate,"Senate Rules Committee Vote",19,0,0,0,19
1263198,877666,2019-05-29,Senate,"Senate Elections Committee Vote",7,0,0,0,7
1263198,877667,2019-06-04,Senate,"Senate Floor Vote - Final Passage",60,2,0,0,62
1263198,884294,2019-06-18,Assembly,"Assembly Floor Vote - Final Passage",114,34,0,2,150
1263221,879086,2019-06-06,Senate,"Senate Floor Vote - Final Passage",60,1,0,1,62
1263221,879087,2019-06-06,Senate,"Senate Rules Committee Vote",18,1,0,0,19
1263221,883241,2019-06-17,Assembly,"Assembly Floor Vote - Final Passage",142,6,0,2,150
1263224,881823,2019-06-13,Senate,"Senate Floor Vote - Final Passage",62,0,0,0,62
1263224,881824,2019-06-13,Senate,"Senate Rules Committee Vote",19,0,0,0,19
1263256,881856,2019-06-13,Senate,"Senate Floor Vote - Final Passage",45,17,0,0,62
1263256,881857,2019-06-13,Senate,"Senate Rules Committee Vote",15,4,0,0,19
1263256,935289,2020-02-25,Senate,"Senate Finance Committee Vote",17,5,0,1,23
1263256,948446,2020-03-10,Senate,"Senate Floor Vote - Final Passage",41,18,0,3,62
1263265,885006,2019-05-29,Senate,"Senate Investigations and Government Operations Committee Vote",6,1,0,0,7
1263265,886666,2019-06-19,Senate,"Senate Floor Vote - Final Passage",61,1,0,0,62
1263265,920829,2020-02-11,Senate,"Senate Investigations and Government Operations Committee Vote",7,0,0,0,7
1263265,934445,2020-02-25,Senate,"Senate Floor Vote - Final Passage",51,9,0,2,62
1263269,879113,2019-06-06,Senate,"Senate Floor Vote - Final Passage",61,0,0,1,62
1263269,879114,2019-06-06,Senate,"Senate Rules Committee Vote",19,0,0,0,19
1263278,881881,2019-06-13,Senate,"Senate Floor Vote - Final Passage",62,0,0,0,62
1263278,881882,2019-06-13,Senate,"Senate Rules Committee Vote",19,0,0,0,19
1263278,884043,2019-06-18,Assembly,"Assembly Floor Vote - Final Passage",147,1,0,2,150
1263341,882904,2019-06-04,Senate,"Senate Rules Committee Vote",15,4,0,0,19
1263341,882905,2019-06-17,Senate,"Senate Floor Vote - Final Passage",40,22,0,0,62
1263448,881902,2019-06-13,Senate,"Senate Floor Vote - Final Passage",62,0,0,0,62
1263448,881903,2019-06-13,Senate,"Senate Rules Committee Vote",19,0,0,0,19
1263448,906874,2020-01-28,Senate,"Senate Investigations and Government Operations Committee Vote",7,0,0,0,7
1263470,883876,2019-06-05,Senate,"Senate Rules Committee Vote",18,1,0,0,19
1263470,883877,2019-06-17,Senate,"Senate Floor Vote - Final Passage",56,6,0,0,62
1263470,885379,2019-06-19,Assembly,"Assembly Floor Vote - Final Passage",148,0,0,2,150
1263477,878691,2019-05-30,Senate,"Senate Judiciary Committee Vote",12,2,0,1,15
1263477,879152,2019-06-06,Senate,"Senate Floor Vote - Final Passage",41,20,0,1,62
1263477,907979,2020-01-28,Senate,"Senate Judiciary Committee Vote",10,5,0,0,15
1263507,886169,2019-06-21,Assembly,"Assembly Floor Vote - Final Passage",131,4,0,15,150
1263507,886662,2019-06-20,Senate,"Senate Floor Vote - Final Passage",62,0,0,0,62
1263507,887277,2019-06-20,Senate,"Senate Rules Committee Vote",19,0,0,0,19
1263512,879016,2019-05-30,Senate,"Senate Transportation Committee Vote",15,0,0,0,15
1263512,879017,2019-06-06,Senate,"Senate Floor Vote - Final Passage",61,0,0,1,62
1263512,902565,2020-01-13,Senate,"Senate Transportation Committee Vote",15,0,0,0,15
1263512,902566,2020-01-13,Senate,"Senate Rules Committee Vote",19,0,0,0,19
1263512,902796,2020-01-14,Senate,"Senate Floor Vote - Final Passage",60,0,0,2,62
1263515,878812,2019-05-30,Senate,"Senate Transportation Committee Vote",15,0,0,0,15
1263515,878813,2019-06-06,Senate,"Senate Floor Vote - Final Passage",61,0,0,1,62
1263515,902693,2020-01-13,Senate,"Senate Rules Committee Vote",19,0,0,0,19
1263515,902694,2020-01-13,Senate,"Senate Transportation Committee Vote",15,0,0,0,15
1263515,902695,2020-01-14,Senate,"Senate Floor Vote - Final Passage",60,0,0,2,62
1263520,878735,2019-05-30,Senate,"Senate Transportation Committee Vote",15,0,0,0,15
1263520,879130,2019-06-06,Senate,"Senate Floor Vote - Final Passage",61,0,0,1,62
1263520,902533,2020-01-13,Senate,"Senate Rules Committee Vote",19,0,0,0,19
1263520,902761,2020-01-13,Senate,"Senate Rules Committee Vote",19,0,0,0,19
1263520,902762,2020-01-14,Senate,"Senate Floor Vote - Final Passage",60,0,0,2,62
1263524,883349,2019-05-30,Senate,"Senate Transportation Committee Vote",14,1,0,0,15
1263524,885540,2019-06-18,Senate,"Senate Floor Vote - Final Passage",62,0,0,0,62
1263526,875028,2019-05-30,Assembly,"Assembly Governmental Operations Committee: Favorable",12,0,0,2,14
1263536,878773,2019-05-30,Senate,"Senate Transportation Committee Vote",15,0,0,0,15
1263536,878774,2019-06-06,Senate,"Senate Floor Vote - Final Passage",61,0,0,1,62
1263536,902535,2020-01-13,Senate,"Senate Rules Committee Vote",19,0,0,0,19
1263536,902644,2020-01-13,Senate,"Senate Rules Committee Vote",19,0,0,0,19
1263536,902877,2020-01-14,Senate,"Senate Floor Vote - Final Passage",60,0,0,2,62
1263555,878738,2019-05-30,Senate,"Senate Transportation Committee Vote",15,0,0,0,15
1263555,879132,2019-06-06,Senate,"Senate Floor Vote - Final Passage",61,0,0,1,62
1263555,902687,2020-01-13,Senate,"Senate Rules Committee Vote",19,0,0,0,19
1263555,902688,2020-01-13,Senate,"Senate Transportation Committee Vote",15,0,0,0,15
1263555,902689,2020-01-14,Senate,"Senate Floor Vote - Final Passage",60,0,0,2,62
1263563,875448,2019-05-30,Senate,"Senate Transportation Committee Vote",15,0,0,0,15
1263563,877311,2019-06-03,Senate,"Senate Rules Committee Vote",19,0,0,0,19
1263563,878840,2019-06-06,Senate,"Senate Floor Vote - Final Passage",61,0,0,1,62
1263563,902569,2020-01-13,Senate,"Senate Transportation Committee Vote",15,0,0,0,15
1263563,902570,2020-01-13,Senate,"Senate Rules Committee Vote",19,0,0,0,19
1263563,902860,2020-01-14,Senate,"Senate Floor Vote - Final Passage",60,0,0,2,62
1263571,878682,2019-05-30,Senate,"Senate Transportation Committee Vote",14,1,0,0,15
1263571,879134,2019-06-06,Senate,"Senate Floor Vote - Final Passage",61,0,0,1,62
1263571,902563,2020-01-13,Senate,"Senate Transportation Committee Vote",15,0,0,0,15
1263571,902564,2020-01-13,Senate,"Senate Rules Committee Vote",19,0,0,0,19
1263571,902663,2020-01-14,Senate,"Senate Floor Vote - Final Passage",60,0,0,2,62
1263584,878964,2019-05-30,Senate,"Senate Transportation Committee Vote",15,0,0,0,15
1263584,878965,2019-06-06,Senate,"Senate Floor Vote - Final Passage",61,0,0,1,62
1263584,902532,2020-01-13,Senate,"Senate Rules Committee Vote",19,0,0,0,19
1263584,902743,2020-01-13,Senate,"Senate Rules Committee Vote",19,0,0,0,19
1263584,902744,2020-01-14,Senate,"Senate Floor Vote - Final Passage",60,0,0,2,62
1263725,878063,2019-05-30,Senate,"Senate Housing, Construction and Community Development Committee Vote",10,0,0,1,11
1263725,878064,2019-06-05,Senate,"Senate Floor Vote - Final Passage",62,0,0,0,62
1263725,904830,2020-01-21,Senate,"Senate Housing, Construction and Community Development Committee Vote",11,0,0,0,11
1263725,910311,2020-01-29,Senate,"Senate Floor Vote - Final Passage",58,0,0,4,62
1263730,881752,2019-05-29,Senate,"Senate Insurance Committee Vote",11,0,0,0,11
1263730,881753,2019-06-13,Senate,"Senate Floor Vote - Final Passage",62,0,0,0,62
1263730,885336,2019-06-19,Assembly,"Assembly Floor Vote - Final Passage",148,0,0,2,150
1263742,882286,2019-05-29,Senate,"Senate Energy and Telecommunications Committee Vote",9,0,0,0,9
1263742,882287,2019-06-14,Senate,"Senate Floor Vote - Final Passage",62,0,0,0,62
1263742,914623,2020-02-03,Senate,"Senate Energy and Telecommunications Committee Vote",9,0,0,0,9
1263750,878406,2019-05-29,Senate,"Senate Codes Committee Vote",13,0,0,0,13
1263750,878407,2019-06-05,Senate,"Senate Floor Vote - Final Passage",62,0,0,0,62
1263750,883093,2019-06-17,Assembly,"Assembly Floor Vote - Final Passage",145,3,0,2,150
1263756,878610,2019-05-29,Senate,"Senate Commerce, Economic Development and Small Business Committee Vote",9,0,0,0,9
1263756,879071,2019-06-06,Senate,"Senate Floor Vote - Final Passage",61,0,0,1,62
1263756,883422,2019-06-17,Assembly,"Assembly Floor Vote - Final Passage",148,0,0,2,150
1263766,885920,2019-06-18,Senate,"Senate Floor Vote - Final Passage",62,0,0,0,62
1263766,886799,2019-06-18,Senate,"Senate Rules Committee Vote",19,0,0,0,19
1263766,886800,2019-06-21,Assembly,"Assembly Floor Vote - Final Passage",134,1,0,15,150
1263772,885529,2019-06-18,Senate,"Senate Floor Vote - Final Passage",49,13,0,0,62
1263772,886657,2019-06-18,Senate,"Senate Rules Committee Vote",14,5,0,0,19
1263775,882284,2019-06-14,Assembly,"Assembly Governmental Operations Committee: Favorable refer to committee Codes",12,0,0,2,14
1263775,882714,2019-06-17,Assembly,"Assembly Codes Committee: Favorable refer to committee Ways and Means",20,0,0,2,22
1263779,882282,2019-06-14,Assembly,"Assembly Governmental Operations Committee: Favorable refer to committee Ways and Means",12,0,0,2,14
1263779,884818,2019-06-19,Assembly,"Assembly Ways And Means Committee: Favorable refer to committee Rules",33,0,0,2,35
1263779,885224,2019-06-20,Assembly,"Assembly Rules Committee: Favorable",27,0,0,4,31
1263781,882283,2019-06-14,Assembly,"Assembly Governmental Operations Committee: Favorable refer to committee Ways and Means",12,0,0,2,14
1263783,875080,2019-05-30,Assembly,"Assembly Governmental Operations Committee: Favorable",12,0,0,2,14
1263783,879250,2019-06-06,Assembly,"Assembly Floor Vote - Final Passage",137,1,0,12,150
1263783,880318,2019-06-11,Senate,"Senate Floor Vote - Final Passage",61,0,0,1,62
1263846,874130,2019-05-29,Assembly,"Assembly Banks Committee: Favorable",30,0,0,1,31
1263846,879226,2019-06-06,Assembly,"Assembly Floor Vote - Final Passage",138,0,0,12,150
1263892,881004,2019-05-30,Senate,"Senate Labor Committee Vote",12,1,0,0,13
1263892,882119,2019-06-12,Senate,"Senate Floor Vote - Final Passage",61,1,0,0,62
1263892,915220,2020-02-04,Senate,"Senate Labor Committee Vote",12,1,0,0,13
1263892,972495,2020-07-21,Senate,"Senate Floor Vote - Final Passage",59,1,0,0,60
1263976,885100,2019-06-19,Assembly,"Assembly Floor Vote - Final Passage",129,19,0,2,150
1263976,885901,2019-06-18,Senate,"Senate Floor Vote - Final Passage",62,0,0,0,62
1263976,886396,2019-06-18,Senate,"Senate Rules Committee Vote",19,0,0,0,19
1264124,883671,2019-06-18,Assembly,"Assembly Ways And Means Committee: Favorable refer to committee Rules",33,0,0,2,35
1264124,885254,2019-06-20,Assembly,"Assembly Rules Committee: Favorable",27,0,0,4,31
1264127,884646,2019-06-19,Assembly,"Assembly Codes Committee: Favorable refer to committee Rules",19,3,0,0,22
1264127,885268,2019-06-20,Assembly,"Assembly Rules Committee: Favorable",27,0,0,4,31
1264142,878977,2019-06-06,Assembly,"Assembly Corporations, Authorities And Commissions Committee: Favorable refer to committee Rules",25,0,0,1,26
1264142,883502,2019-06-18,Assembly,"Assembly Rules Committee: Favorable",25,0,0,6,31
1264147,882881,2019-06-17,Assembly,"Assembly Local Governments Committee: Favorable refer to committee Ways and Means",18,0,0,1,19
1264155,971026,2020-07-14,Assembly,"Assembly Energy Committee: Favorable refer to committee Ways and Means",15,0,0,0,15
1264155,972861,2020-07-22,Assembly,"Assembly Ways And Means Committee: Favorable refer to committee Rules",30,2,0,2,34
1264155,973096,2020-07-22,Assembly,"Assembly Rules Committee: Favorable",27,2,0,1,30
1264159,878197,2019-06-05,Assembly,"Assembly Health Committee: Favorable refer to committee Codes",25,0,0,1,26
1264159,882742,2019-06-17,Assembly,"Assembly Codes Committee: Favorable refer to committee Rules",20,0,0,2,22
1264159,885238,2019-06-20,Assembly,"Assembly Rules Committee: Favorable",27,0,0,4,31
1264172,883071,2019-06-17,Senate,"Senate Floor Vote - Final Passage",46,16,0,0,62
1264172,883072,2019-06-17,Senate,"Senate Rules Committee Vote",12,7,0,0,19
1264172,886252,2019-06-21,Assembly,"Assembly Floor Vote - Final Passage",130,10,0,10,150
1264179,914637,2020-02-04,Assembly,"Assembly Health Committee: Favorable refer to committee Codes",23,0,0,3,26
1264179,933766,2020-02-25,Assembly,"Assembly Codes Committee: Favorable",21,0,0,1,22
1264179,941032,2020-03-02,Assembly,"Assembly Floor Vote - Final Passage",138,0,0,9,147
1264179,973543,2020-07-22,Senate,"Senate Floor Vote - Final Passage",60,0,0,0,60
1264181,876707,2019-06-03,Assembly,"Assembly Social Services Committee: Favorable refer to committee Ways and Means",15,1,0,2,18
1264205,877279,2019-06-04,Senate,"Senate Floor Vote - Final Passage",62,0,0,0,62
1264205,878044,2019-06-04,Senate,"Senate Rules Committee Vote",19,0,0,0,19
1264208,904572,2020-01-22,Assembly,"Assembly Health Committee: Favorable",25,0,0,1,26
1264209,904584,2020-01-22,Assembly,"Assembly Health Committee: Favorable refer to committee Ways and Means",25,0,0,1,26
1264214,874718,2019-05-30,Assembly,"Assembly Social Services Committee: Favorable refer to committee Ways and Means",11,5,0,2,18
1264214,883896,2019-06-18,Assembly,"Assembly Ways And Means Committee: Favorable refer to committee Rules",24,9,0,2,35
1264214,884836,2019-06-19,Assembly,"Assembly Rules Committee: Favorable",27,0,0,4,31
1264214,886257,2019-06-20,Assembly,"Assembly Floor Vote - Final Passage",118,29,0,3,150
1264217,874739,2019-05-30,Senate,"Senate New York City Education Committee Vote",7,0,0,0,7
1264217,874889,2019-05-30,Senate,"Senate New York City Education Committee Vote",7,0,0,0,7
1264217,875387,2019-05-30,Senate,"Senate Floor Vote - Final Passage",57,1,0,4,62
1264217,883313,2019-06-17,Assembly,"Assembly Floor Vote - Final Passage",131,14,0,5,150
1264229,878004,2019-06-05,Senate,"Senate Rules Committee Vote",16,3,0,0,19
1264229,878516,2019-06-05,Senate,"Senate Floor Vote - Final Passage",45,17,0,0,62
1264229,919636,2020-02-11,Senate,"Senate Investigations and Government Operations Committee Vote",6,1,0,0,7
1264229,973006,2020-07-21,Senate,"Senate Floor Vote - Final Passage",45,15,0,0,60
1264232,886443,2019-06-19,Senate,"Senate Floor Vote - Final Passage",62,0,0,0,62
1264232,886444,2019-06-21,Assembly,"Assembly Floor Vote - Final Passage",143,1,0,6,150
1264232,887278,2019-06-19,Senate,"Senate Rules Committee Vote",19,0,0,0,19
1264234,878281,2019-06-05,Assembly,"Assembly Education Committee: Favorable refer to committee Ways and Means",29,0,0,2,31
1264234,883132,2019-06-17,Assembly,"Assembly Ways And Means Committee: Favorable refer to committee Rules",33,0,0,2,35
1264234,886401,2019-06-20,Assembly,"Assembly Rules Committee: Favorable",27,0,0,4,31
1264250,879989,2019-05-29,Senate,"Senate Children and Families Committee Vote",7,0,0,0,7
1264250,880449,2019-06-11,Senate,"Senate Floor Vote - Final Passage",54,7,0,1,62
1264250,884122,2019-06-18,Assembly,"Assembly Floor Vote - Final Passage",129,17,0,4,150
1264262,973085,2020-03-11,Senate,"Senate Domestic Animal Welfare Committee Vote",7,0,0,0,7
1264262,973086,2020-07-21,Senate,"Senate Floor Vote - Final Passage",57,3,0,0,60
1264263,971060,2020-07-14,Assembly,"Assembly Correction Committee: Favorable refer to committee Rules",12,0,0,1,13
1264263,972797,2020-07-21,Assembly,"Assembly Floor Vote - Final Passage",140,2,0,3,145
1264263,972798,2020-07-21,Assembly,"Assembly Rules Committee: Favorable",26,0,0,4,30
1264275,882285,2019-06-14,Assembly,"Assembly Governmental Operations Committee: Favorable refer to committee Rules",12,0,0,2,14
1264275,882486,2019-06-17,Assembly,"Assembly Rules Committee: Favorable",26,0,0,5,31
1264283,877578,2019-06-04,Assembly,"Assembly Governmental Operations Committee: Favorable refer to committee Ways and Means",12,0,0,2,14
1264283,878313,2019-06-05,Assembly,"Assembly Ways And Means Committee: Favorable refer to committee Rules",31,0,0,4,35
1264283,880714,2019-06-12,Assembly,"Assembly Rules Committee: Favorable",27,0,0,4,31
1264283,883165,2019-06-17,Assembly,"Assembly Floor Vote - Final Passage",148,0,0,2,150
1264283,965164,2020-06-09,Senate,"Senate Floor Vote - Final Passage",62,0,0,0,62
1264286,876709,2019-06-03,Assembly,"Assembly Social Services Committee: Favorable refer to committee Ways and Means",16,0,0,2,18
1264286,880360,2019-06-11,Assembly,"Assembly Ways And Means Committee: Favorable refer to committee Rules",33,0,0,2,35
1264286,881683,2019-06-14,Assembly,"Assembly Rules Committee: Favorable",25,0,0,6,31
1264289,883252,2019-06-17,Assembly,"Assembly Ways And Means Committee: Favorable refer to committee Rules",33,0,0,2,35
1264289,883253,2019-06-17,Assembly,"Assembly Real Property Taxation Committee: Favorable refer to committee Ways and Means",10,0,0,0,10
1264289,883570,2019-06-18,Assembly,"Assembly Rules Committee: Favorable",25,0,0,6,31
1264292,878227,2019-06-05,Assembly,"Assembly Governmental Employees Committee: Favorable refer to committee Ways and Means",14,0,0,0,14
1264292,883118,2019-06-17,Assembly,"Assembly Ways And Means Committee: Favorable refer to committee Rules",33,0,0,2,35
1264292,886446,2019-06-20,Assembly,"Assembly Rules Committee: Favorable",27,0,0,4,31
1264293,886430,2019-06-21,Assembly,"Assembly Floor Vote - Final Passage",119,25,0,6,150
1264293,886790,2019-06-20,Senate,"Senate Floor Vote - Final Passage",44,18,0,0,62
1264293,887147,2019-06-19,Senate,"Senate Rules Committee Vote",12,7,0,0,19
1264294,970873,2020-07-13,Assembly,"Assembly Cities Committee: Favorable refer to committee Rules",14,0,0,0,14
1264294,972188,2020-07-20,Assembly,"Assembly Rules Committee: Favorable",27,0,0,3,30
1264294,972972,2020-07-21,Assembly,"Assembly Floor Vote - Final Passage",139,3,0,3,145
1264294,973588,2020-07-23,Senate,"Senate Floor Vote - Final Passage",57,3,0,0,60
1264307,970774,2020-07-13,Assembly,"Assembly Health Committee: Held for Consideration",18,6,0,2,26
1264352,878395,2019-05-29,Senate,"Senate Children and Families Committee Vote",7,0,0,0,7
1264352,878396,2019-06-05,Senate,"Senate Floor Vote - Final Passage",49,13,0,0,62
1264352,904700,2020-01-21,Senate,"Senate Children and Families Committee Vote",6,1,0,0,7
1264352,972484,2020-07-21,Senate,"Senate Floor Vote - Final Passage",47,13,0,0,60
1264382,875053,2019-05-30,Assembly,"Assembly Insurance Committee: Favorable refer to committee Ways and Means",22,2,0,0,24
1264382,882028,2019-06-14,Assembly,"Assembly Ways And Means Committee: Favorable refer to committee Rules",26,4,0,5,35
1264382,882438,2019-06-17,Assembly,"Assembly Rules Committee: Favorable",26,0,0,5,31
1264694,884782,2019-06-19,Assembly,"Assembly Ways And Means Committee: Favorable refer to committee Rules",30,3,0,2,35
1264694,885216,2019-06-20,Assembly,"Assembly Rules Committee: Favorable",27,0,0,4,31
1264718,919930,2020-02-11,Assembly,"Assembly Mental Health Committee: Favorable",11,0,0,2,13
1264720,878200,2019-06-05,Assembly,"Assembly Health Committee: Favorable refer to committee Rules",25,0,0,1,26
1264720,880717,2019-06-12,Assembly,"Assembly Rules Committee: Favorable",27,0,0,4,31
1264733,878224,2019-06-05,Assembly,"Assembly Health Committee: Favorable refer to committee Rules",25,0,0,1,26
1264733,907004,2020-01-28,Assembly,"Assembly Health Committee: Favorable",24,0,0,2,26
1264748,882922,2019-06-17,Assembly,"Assembly Local Governments Committee: Favorable refer to committee Rules",18,0,0,1,19
1264756,883124,2019-06-17,Assembly,"Assembly Codes Committee: Favorable refer to committee Rules",19,1,0,2,22
1264765,882281,2019-06-14,Assembly,"Assembly Governmental Operations Committee: Favorable refer to committee Ways and Means",12,0,0,2,14
1264765,882615,2019-06-17,Assembly,"Assembly Rules Committee: Favorable",25,0,0,6,31
1264765,882616,2019-06-17,Assembly,"Assembly Ways And Means Committee: Favorable refer to committee Rules",33,0,0,2,35
1264771,880857,2019-06-12,Assembly,"Assembly Real Property Taxation Committee: Favorable refer to committee Ways and Means",9,0,0,1,10
1264771,882060,2019-06-14,Assembly,"Assembly Ways And Means Committee: Favorable refer to committee Rules",30,0,0,5,35
1264771,882504,2019-06-17,Assembly,"Assembly Rules Committee: Favorable",26,0,0,5,31
1264777,877826,2019-06-04,Assembly,"Assembly Tourism, Arts And Sports Development Committee: Favorable refer to committee Ways and Means",19,0,0,1,20
1264777,878394,2019-06-05,Assembly,"Assembly Ways And Means Committee: Favorable refer to committee Rules",31,0,0,4,35
1264777,880725,2019-06-12,Assembly,"Assembly Rules Committee: Favorable",27,0,0,4,31
1264782,881836,2019-06-13,Senate,"Senate Floor Vote - Final Passage",62,0,0,0,62
1264782,881837,2019-06-13,Senate,"Senate Rules Committee Vote",19,0,0,0,19
1264782,915021,2020-02-04,Senate,"Senate Transportation Committee Vote",15,0,0,0,15
1264782,941778,2020-03-03,Senate,"Senate Floor Vote - Final Passage",62,0,0,0,62
1264794,883996,2019-06-18,Assembly,"Assembly Local Governments Committee: Favorable refer to committee Ways and Means",17,0,0,2,19
1264794,885309,2019-06-20,Assembly,"Assembly Ways And Means Committee: Favorable refer to committee Rules",29,5,0,1,35
1264794,886099,2019-06-20,Assembly,"Assembly Rules Committee: Favorable",27,0,0,4,31
1264795,885094,2019-06-19,Assembly,"Assembly Floor Vote - Final Passage",145,3,0,2,150
1264795,885895,2019-06-18,Senate,"Senate Floor Vote - Final Passage",61,1,0,0,62
1264795,886390,2019-06-18,Senate,"Senate Rules Committee Vote",19,0,0,0,19
1264797,883636,2019-06-18,Assembly,"Assembly Rules Committee: Favorable",25,0,0,6,31
1264797,883637,2019-06-18,Assembly,"Assembly Ways And Means Committee: Favorable refer to committee Rules",33,0,0,2,35
1264800,885432,2019-06-18,Senate,"Senate Floor Vote - Final Passage",62,0,0,0,62
1264800,886649,2019-06-18,Senate,"Senate Rules Committee Vote",19,0,0,0,19
1264800,972700,2020-07-20,Senate,"Senate Health Committee Vote",14,0,0,1,15
1264800,974024,2020-07-22,Senate,"Senate Floor Vote - Final Passage",60,0,0,0,60
1264800,974025,2020-07-22,Senate,"Senate Rules Committee Vote",19,0,0,0,19
1265004,878942,2019-06-06,Assembly,"Assembly Environmental Conservation Committee: Favorable refer to committee Rules",28,0,0,2,30
1265004,880734,2019-06-12,Assembly,"Assembly Rules Committee: Favorable",27,0,0,4,31
1265005,971460,2020-07-15,Assembly,"Assembly Labor Committee: Held for Consideration",18,7,0,3,28
1265008,881041,2019-06-06,Senate,"Senate Rules Committee Vote",15,4,0,0,19
1265008,881848,2019-06-12,Senate,"Senate Floor Vote - Final Passage",46,16,0,0,62
1265008,885045,2019-06-19,Assembly,"Assembly Floor Vote - Final Passage",137,11,0,2,150
1265015,971354,2020-07-15,Assembly,"Assembly Veterans' Affairs Committee: Held for Consideration",11,6,0,2,19
1265026,881751,2019-06-14,Assembly,"Assembly Governmental Employees Committee: Favorable refer to committee Rules",13,0,0,1,14
1265026,882545,2019-06-17,Assembly,"Assembly Rules Committee: Favorable",26,0,0,5,31
1265028,878017,2019-06-05,Assembly,"Assembly Governmental Employees Committee: Favorable refer to committee Ways and Means",14,0,0,0,14
1265028,879327,2019-06-06,Assembly,"Assembly Ways And Means Committee: Favorable refer to committee Rules",31,0,0,4,35
1265028,880713,2019-06-12,Assembly,"Assembly Rules Committee: Favorable",27,0,0,4,31
1265033,963772,2020-06-09,Assembly,"Assembly Rules Committee: Favorable",27,0,0,4,31
1265033,963773,2020-06-09,Assembly,"Assembly Ways And Means Committee: Favorable refer to committee Rules",32,0,0,3,35
1265033,964640,2020-06-09,Assembly,"Assembly Floor Vote - Final Passage",144,0,0,3,147
1265033,973607,2020-07-22,Senate,"Senate Floor Vote - Final Passage",59,1,0,0,60
1265039,876791,2019-06-03,Assembly,"Assembly Higher Education Committee: Favorable refer to committee Ways and Means",25,0,0,1,26
1265039,878297,2019-06-05,Assembly,"Assembly Ways And Means Committee: Favorable refer to committee Rules",31,0,0,4,35
1265039,880772,2019-06-12,Assembly,"Assembly Rules Committee: Favorable",27,0,0,4,31
1265039,883206,2019-06-17,Assembly,"Assembly Floor Vote - Final Passage",145,3,0,2,150
1265039,883743,2019-06-18,Senate,"Senate Floor Vote - Final Passage",56,6,0,0,62
1265048,882100,2019-06-14,Assembly,"Assembly Governmental Employees Committee: Favorable refer to committee Ways and Means",13,0,0,1,14
1265048,882750,2019-06-17,Assembly,"Assembly Rules Committee: Favorable",25,0,0,6,31
1265048,882751,2019-06-17,Assembly,"Assembly Ways And Means Committee: Favorable refer to committee Rules",32,1,0,2,35
1265055,877282,2019-06-04,Assembly,"Assembly Governmental Operations Committee: Favorable refer to committee Codes",12,0,0,2,14
1265055,878222,2019-06-05,Assembly,"Assembly Codes Committee: Favorable refer to committee Rules",16,6,0,0,22
1265055,880762,2019-06-12,Assembly,"Assembly Rules Committee: Favorable",26,1,0,4,31
1265058,878024,2019-06-05,Senate,"Senate Rules Committee Vote",19,0,0,0,19
1265058,878525,2019-06-05,Senate,"Senate Floor Vote - Final Passage",62,0,0,0,62
1265058,883138,2019-06-17,Senate,"Senate Floor Vote - Final Passage",62,0,0,0,62
1265058,886598,2019-06-21,Assembly,"Assembly Floor Vote - Final Passage",134,0,0,16,150
1265060,882138,2019-06-14,Assembly,"Assembly Governmental Operations Committee: Favorable refer to committee Ways and Means",12,0,0,2,14
1265060,882601,2019-06-17,Assembly,"Assembly Rules Committee: Favorable",25,0,0,6,31
1265060,882602,2019-06-17,Assembly,"Assembly Ways And Means Committee: Favorable refer to committee Rules",28,5,0,2,35
1265060,886555,2019-06-20,Assembly,"Assembly Floor Vote - Final Passage",112,35,0,3,150
1265074,883243,2019-06-17,Assembly,"Assembly Ways And Means Committee: Favorable refer to committee Rules",33,0,0,2,35
1265074,883244,2019-06-17,Assembly,"Assembly Real Property Taxation Committee: Favorable refer to committee Ways and Means",10,0,0,0,10
1265074,883507,2019-06-18,Assembly,"Assembly Rules Committee: Favorable",25,0,0,6,31
1265085,878967,2019-06-06,Assembly,"Assembly Environmental Conservation Committee: Favorable refer to committee Rules",28,0,0,2,30
1265085,880747,2019-06-12,Assembly,"Assembly Rules Committee: Favorable",27,0,0,4,31
1265085,883173,2019-06-17,Assembly,"Assembly Floor Vote - Final Passage",148,0,0,2,150
1265085,935734,2020-02-26,Senate,"Senate Floor Vote - Final Passage",59,1,0,2,62
1265093,877881,2019-06-05,Assembly,"Assembly Insurance Committee: Favorable refer to committee Rules",24,0,0,0,24
1265093,880196,2019-06-11,Assembly,"Assembly Codes Committee: Favorable refer to committee Rules",22,0,0,0,22
1265093,881685,2019-06-14,Assembly,"Assembly Rules Committee: Favorable",25,0,0,6,31
1265099,883256,2019-06-17,Assembly,"Assembly Ways And Means Committee: Favorable refer to committee Rules",33,0,0,2,35
1265099,883257,2019-06-17,Assembly,"Assembly Real Property Taxation Committee: Favorable refer to committee Ways and Means",10,0,0,0,10
1265099,885213,2019-06-20,Assembly,"Assembly Rules Committee: Favorable",27,0,0,4,31
1265099,886510,2019-06-21,Assembly,"Assembly Floor Vote - Final Passage",140,0,0,10,150
1265099,973552,2020-07-22,Senate,"Senate Floor Vote - Final Passage",59,1,0,0,60
1265100,878982,2019-06-06,Assembly,"Assembly Environmental Conservation Committee: Favorable refer to committee Codes",26,2,0,2,30
1265100,880201,2019-06-11,Assembly,"Assembly Codes Committee: Favorable refer to committee Rules",17,5,0,0,22
1265100,882466,2019-06-17,Assembly,"Assembly Rules Committee: Favorable",20,6,0,5,31
1265101,877531,2019-06-04,Assembly,"Assembly Mental Health Committee: Favorable refer to committee Ways and Means",12,0,0,1,13
1265112,879009,2019-06-06,Assembly,"Assembly Corporations, Authorities And Commissions Committee: Favorable refer to committee Rules",25,0,0,1,26
1265112,881682,2019-06-14,Assembly,"Assembly Rules Committee: Favorable",25,0,0,6,31
1265112,884321,2019-06-18,Assembly,"Assembly Floor Vote - Final Passage",146,0,0,4,150
1265115,883134,2019-06-17,Assembly,"Assembly Education Committee: Favorable refer to committee Ways and Means",27,0,0,4,31
1265115,883571,2019-06-18,Assembly,"Assembly Rules Committee: Favorable",25,0,0,6,31
1265115,883572,2019-06-18,Assembly,"Assembly Ways And Means Committee: Favorable refer to committee Rules",33,0,0,2,35
1265125,971462,2020-07-16,Assembly,"Assembly Transportation Committee: Held for Consideration",16,6,0,2,24
1265128,877438,2019-06-04,Assembly,"Assembly Codes Committee: Favorable refer to committee Rules",22,0,0,0,22
1265128,880761,2019-06-12,Assembly,"Assembly Rules Committee: Favorable",27,0,0,4,31
1265134,882702,2019-06-17,Assembly,"Assembly Higher Education Committee: Favorable refer to committee Ways and Means",26,0,0,0,26
1265134,883555,2019-06-18,Assembly,"Assembly Rules Committee: Favorable",25,0,0,6,31
1265134,883556,2019-06-18,Assembly,"Assembly Ways And Means Committee: Favorable refer to committee Rules",33,0,0,2,35
1265144,877580,2019-06-04,Assembly,"Assembly Governmental Operations Committee: Favorable refer to committee Ways and Means",12,0,0,2,14
1265144,878326,2019-06-05,Assembly,"Assembly Ways And Means Committee: Favorable refer to committee Rules",30,1,0,4,35
1265144,880693,2019-06-12,Assembly,"Assembly Rules Committee: Favorable",27,0,0,4,31
1265147,881667,2019-06-14,Assembly,"Assembly Governmental Employees Committee: Favorable refer to committee Ways and Means",13,0,0,1,14
1265147,883496,2019-06-18,Assembly,"Assembly Rules Committee: Favorable",25,0,0,6,31
1265147,883497,2019-06-18,Assembly,"Assembly Ways And Means Committee: Favorable refer to committee Rules",30,3,0,2,35
1265154,882179,2019-06-14,Assembly,"Assembly Governmental Operations Committee: Favorable refer to committee Rules",12,0,0,2,14
1265154,883991,2019-06-18,Assembly,"Assembly Rules Committee: Favorable",25,0,0,6,31
1265179,877543,2019-06-04,Assembly,"Assembly Mental Health Committee: Favorable refer to committee Codes",12,0,0,1,13
1265199,877381,2019-06-04,Assembly,"Assembly Correction Committee: Favorable refer to committee Rules",10,3,0,0,13
1265199,880735,2019-06-12,Assembly,"Assembly Rules Committee: Favorable",27,0,0,4,31
1265274,877430,2019-06-04,Assembly,"Assembly Correction Committee: Favorable refer to committee Rules",13,0,0,0,13
1265274,884827,2019-06-19,Assembly,"Assembly Rules Committee: Favorable",27,0,0,4,31
1265283,877518,2019-06-04,Assembly,"Assembly Children And Families Committee: Favorable refer to committee Codes",14,2,0,0,16
1265283,880227,2019-06-11,Assembly,"Assembly Codes Committee: Favorable refer to committee Rules",22,0,0,0,22
1265283,881700,2019-06-14,Assembly,"Assembly Rules Committee: Favorable",25,0,0,6,31
1265283,883998,2019-06-18,Assembly,"Assembly Floor Vote - Final Passage",137,9,0,4,150
1265283,886772,2019-06-19,Senate,"Senate Floor Vote - Final Passage",59,3,0,0,62
1265284,877542,2019-06-04,Assembly,"Assembly Children And Families Committee: Favorable refer to committee Codes",16,0,0,0,16
1265284,880271,2019-06-11,Assembly,"Assembly Codes Committee: Favorable refer to committee Rules",22,0,0,0,22
1265284,884911,2019-06-19,Assembly,"Assembly Rules Committee: Favorable",27,0,0,4,31
1265294,877513,2019-06-04,Assembly,"Assembly Children And Families Committee: Favorable refer to committee Codes",13,3,0,0,16
1265294,880222,2019-06-11,Assembly,"Assembly Codes Committee: Favorable refer to committee Rules",22,0,0,0,22
1265294,882399,2019-06-17,Assembly,"Assembly Rules Committee: Favorable",26,0,0,5,31
1265294,884514,2019-06-18,Assembly,"Assembly Floor Vote - Final Passage",139,9,0,2,150
1265294,886714,2019-06-19,Senate,"Senate Floor Vote - Final Passage",44,18,0,0,62
1265296,878410,2019-06-05,Assembly,"Assembly Transportation Committee: Favorable refer to committee Rules",26,0,0,0,26
1265296,881714,2019-06-14,Assembly,"Assembly Rules Committee: Favorable",25,0,0,6,31
1265296,884355,2019-06-18,Assembly,"Assembly Floor Vote - Final Passage",146,0,0,4,150
1265296,886633,2019-06-20,Senate,"Senate Floor Vote - Final Passage",55,7,0,0,62
1265317,882048,2019-06-14,Assembly,"Assembly Ways And Means Committee: Favorable refer to committee Rules",30,0,0,5,35
1265317,882488,2019-06-17,Assembly,"Assembly Rules Committee: Favorable",26,0,0,5,31
1265317,884504,2019-06-18,Assembly,"Assembly Floor Vote - Final Passage",148,0,0,2,150
1265317,886698,2019-06-19,Senate,"Senate Floor Vote - Final Passage",42,20,0,0,62
1265322,877153,2019-06-04,Assembly,"Assembly Correction Committee: Favorable refer to committee Ways and Means",10,3,0,0,13
1265325,877535,2019-06-04,Assembly,"Assembly Children And Families Committee: Favorable refer to committee Codes",16,0,0,0,16
1265325,881413,2019-06-13,Assembly,"Assembly Codes Committee: Favorable refer to committee Rules",20,0,0,2,22
1265325,882547,2019-06-17,Assembly,"Assembly Rules Committee: Favorable",26,0,0,5,31
1265325,883954,2019-06-18,Assembly,"Assembly Floor Vote - Final Passage",148,0,0,2,150
1265328,950541,2020-03-10,Assembly,"Assembly Transportation Committee: Held for Consideration",18,7,0,0,25
1265339,877515,2019-06-04,Assembly,"Assembly Children And Families Committee: Favorable refer to committee Codes",13,3,0,0,16
1265339,880197,2019-06-11,Assembly,"Assembly Codes Committee: Favorable refer to committee Ways and Means",20,2,0,0,22
1265339,882067,2019-06-14,Assembly,"Assembly Ways And Means Committee: Favorable refer to committee Rules",30,0,0,5,35
1265339,882509,2019-06-17,Assembly,"Assembly Rules Committee: Favorable",26,0,0,5,31
1265345,877519,2019-06-04,Assembly,"Assembly Mental Health Committee: Favorable refer to committee Ways and Means",12,0,0,1,13
1265353,934905,2020-02-25,Assembly,"Assembly Environmental Conservation Committee: Favorable refer to committee Codes",20,7,0,2,29
1265353,940737,2020-03-03,Assembly,"Assembly Codes Committee: Favorable",15,6,0,1,22
1265364,885374,2019-06-19,Assembly,"Assembly Floor Vote - Final Passage",138,10,0,2,150
1265364,886127,2019-06-18,Senate,"Senate Floor Vote - Final Passage",62,0,0,0,62
1265364,886599,2019-06-18,Senate,"Senate Rules Committee Vote",18,1,0,0,19
1265365,877406,2019-06-04,Assembly,"Assembly Correction Committee: Favorable refer to committee Codes",10,3,0,0,13
1265365,881433,2019-06-13,Assembly,"Assembly Codes Committee: Favorable refer to committee Rules",15,5,0,2,22
1265367,882849,2019-06-17,Assembly,"Assembly Ways And Means Committee: Favorable refer to committee Rules",33,0,0,2,35
1265367,882850,2019-06-17,Assembly,"Assembly Real Property Taxation Committee: Favorable refer to committee Ways and Means",10,0,0,0,10
1265367,883995,2019-06-18,Assembly,"Assembly Rules Committee: Favorable",25,0,0,6,31
1265391,878214,2019-06-05,Assembly,"Assembly Health Committee: Favorable refer to committee Ways and Means",25,0,0,1,26
1265391,880792,2019-06-12,Assembly,"Assembly Ways And Means Committee: Favorable refer to committee Rules",30,0,0,5,35
1265391,881687,2019-06-14,Assembly,"Assembly Rules Committee: Favorable",25,0,0,6,31
1265397,877402,2019-06-04,Assembly,"Assembly Judiciary Committee: Favorable refer to committee Rules",21,0,0,0,21
1265397,880746,2019-06-12,Assembly,"Assembly Rules Committee: Favorable",27,0,0,4,31
1265413,878211,2019-06-05,Assembly,"Assembly Health Committee: Favorable refer to committee Ways and Means",25,0,0,1,26
1265420,877514,2019-06-04,Assembly,"Assembly Children And Families Committee: Favorable refer to committee Codes",15,1,0,0,16
1265420,880238,2019-06-11,Assembly,"Assembly Codes Committee: Favorable refer to committee Rules",22,0,0,0,22
1265420,881681,2019-06-14,Assembly,"Assembly Rules Committee: Favorable",25,0,0,6,31
1265427,932227,2020-02-03,Senate,"Senate Agriculture Committee Vote",9,0,0,0,9
1265427,932228,2020-02-24,Senate,"Senate Floor Vote - Final Passage",59,0,0,3,62
1265427,940591,2020-03-02,Assembly,"Assembly Floor Vote - Final Passage",136,2,0,9,147
1265433,877422,2019-06-04,Assembly,"Assembly Correction Committee: Favorable refer to committee Rules",10,3,0,0,13
1265434,878687,2019-06-06,Assembly,"Assembly Environmental Conservation Committee: Favorable refer to committee Ways and Means",25,3,0,2,30
1265463,919845,2020-02-11,Assembly,"Assembly Health Committee: Favorable",21,1,0,4,26
1265463,972605,2020-07-21,Assembly,"Assembly Floor Vote - Final Passage",139,3,0,3,145
1265463,973676,2020-07-23,Senate,"Senate Floor Vote - Final Passage",59,1,0,0,60
1265464,877967,2019-06-05,Senate,"Senate Rules Committee Vote",19,0,0,0,19
1265464,878512,2019-06-05,Senate,"Senate Floor Vote - Final Passage",62,0,0,0,62
1265464,883120,2019-06-17,Assembly,"Assembly Floor Vote - Final Passage",144,4,0,2,150
1265465,878519,2019-06-05,Assembly,"Assembly Transportation Committee: Favorable refer to committee Ways and Means",26,0,0,0,26
1265465,879363,2019-06-06,Assembly,"Assembly Ways And Means Committee: Favorable refer to committee Rules",31,0,0,4,35
1265465,880711,2019-06-12,Assembly,"Assembly Rules Committee: Favorable",27,0,0,4,31
1265465,883144,2019-06-17,Assembly,"Assembly Floor Vote - Final Passage",147,1,0,2,150
1265465,883879,2019-06-18,Senate,"Senate Floor Vote - Final Passage",62,0,0,0,62
1265469,878956,2019-06-06,Assembly,"Assembly Environmental Conservation Committee: Favorable refer to committee Ways and Means",28,0,0,2,30
1265469,882617,2019-06-17,Assembly,"Assembly Rules Committee: Favorable",25,0,0,6,31
1265469,882618,2019-06-17,Assembly,"Assembly Ways And Means Committee: Favorable refer to committee Rules",33,0,0,2,35
1265471,877416,2019-06-04,Assembly,"Assembly Codes Committee: Favorable refer to committee Rules",19,3,0,0,22
1265471,880756,2019-06-12,Assembly,"Assembly Rules Committee: Favorable",27,0,0,4,31
1265478,934102,2020-02-25,Assembly,"Assembly Agriculture Committee: Favorable",19,0,0,2,21
1265484,877538,2019-06-04,Assembly,"Assembly Economic Development Committee: Favorable refer to committee Ways and Means",24,0,0,2,26
1265484,880384,2019-06-11,Assembly,"Assembly Ways And Means Committee: Favorable refer to committee Rules",33,0,0,2,35
1265484,882473,2019-06-17,Assembly,"Assembly Rules Committee: Favorable",26,0,0,5,31
1265486,877553,2019-06-04,Assembly,"Assembly Mental Health Committee: Favorable refer to committee Rules",12,0,0,1,13
1265486,880740,2019-06-12,Assembly,"Assembly Rules Committee: Favorable",27,0,0,4,31
1265486,883167,2019-06-17,Assembly,"Assembly Floor Vote - Final Passage",148,0,0,2,150
1265486,885186,2019-06-18,Senate,"Senate Floor Vote - Final Passage",62,0,0,0,62
1265489,882920,2019-06-17,Assembly,"Assembly Local Governments Committee: Favorable refer to committee Rules",18,0,0,1,19
1265489,883492,2019-06-18,Assembly,"Assembly Rules Committee: Favorable",25,0,0,6,31
1265496,884323,2019-06-18,Assembly,"Assembly Ways And Means Committee: Favorable refer to committee Rules",25,8,0,2,35
1265496,884938,2019-06-19,Assembly,"Assembly Rules Committee: Favorable",27,0,0,4,31
1265498,885147,2019-06-19,Senate,"Senate Rules Committee Vote",19,0,0,0,19
1265498,886451,2019-06-19,Senate,"Senate Floor Vote - Final Passage",62,0,0,0,62
1265498,886452,2019-06-20,Assembly,"Assembly Floor Vote - Final Passage",148,0,0,2,150
1265505,882619,2019-06-17,Assembly,"Assembly Rules Committee: Favorable",25,0,0,6,31
1265505,882620,2019-06-17,Assembly,"Assembly Ways And Means Committee: Favorable refer to committee Rules",29,4,0,2,35
1265505,882621,2019-06-17,Assembly,"Assembly Local Governments Committee: Favorable refer to committee Ways and Means",18,0,0,1,19
1265506,882092,2019-06-14,Assembly,"Assembly Governmental Employees Committee: Favorable refer to committee Ways and Means",13,0,0,1,14
1265506,883544,2019-06-18,Assembly,"Assembly Rules Committee: Favorable",25,0,0,6,31
1265506,883545,2019-06-18,Assembly,"Assembly Ways And Means Committee: Favorable refer to committee Rules",32,1,0,2,35
1265509,877995,2019-06-05,Assembly,"Assembly Governmental Employees Committee: Favorable refer to committee Ways and Means",14,0,0,0,14
1265509,879321,2019-06-06,Assembly,"Assembly Ways And Means Committee: Favorable refer to committee Rules",30,1,0,4,35
1265509,880700,2019-06-12,Assembly,"Assembly Rules Committee: Favorable",27,0,0,4,31
1265509,882733,2019-06-17,Senate,"Senate Floor Vote - Final Passage",62,0,0,0,62
1265509,883188,2019-06-17,Assembly,"Assembly Floor Vote - Final Passage",148,0,0,2,150
1265515,877205,2019-06-04,Assembly,"Assembly Codes Committee: Favorable refer to committee Rules",15,7,0,0,22
1265515,880720,2019-06-12,Assembly,"Assembly Rules Committee: Favorable",27,0,0,4,31
1265521,881789,2019-06-14,Assembly,"Assembly Transportation Committee: Favorable refer to committee Ways and Means",24,0,0,1,25
1265521,882875,2019-06-17,Assembly,"Assembly Ways And Means Committee: Favorable refer to committee Rules",33,0,0,2,35
1265521,884961,2019-06-19,Assembly,"Assembly Rules Committee: Favorable",27,0,0,4,31
1265530,881575,2019-06-13,Assembly,"Assembly Ways And Means Committee: Favorable refer to committee Rules",29,0,0,6,35
1265530,882535,2019-06-17,Assembly,"Assembly Rules Committee: Favorable",26,0,0,5,31
1265546,877220,2019-06-04,Assembly,"Assembly Governmental Operations Committee: Favorable refer to committee Rules",12,0,0,2,14
1265546,880699,2019-06-12,Assembly,"Assembly Rules Committee: Favorable",27,0,0,4,31
1265546,883166,2019-06-17,Assembly,"Assembly Floor Vote - Final Passage",148,0,0,2,150
1265546,973620,2020-07-22,Senate,"Senate Floor Vote - Final Passage",60,0,0,0,60
1265555,877215,2019-06-04,Assembly,"Assembly Economic Development Committee: Favorable refer to committee Rules",24,0,0,2,26
1265555,880727,2019-06-12,Assembly,"Assembly Rules Committee: Favorable",27,0,0,4,31
1265555,882734,2019-06-17,Senate,"Senate Floor Vote - Final Passage",62,0,0,0,62
1265555,883187,2019-06-17,Assembly,"Assembly Floor Vote - Final Passage",148,0,0,2,150
1265566,877206,2019-06-04,Assembly,"Assembly Children And Families Committee: Favorable refer to committee Codes",13,3,0,0,16
1265566,883125,2019-06-17,Assembly,"Assembly Codes Committee: Favorable refer to committee Rules",14,6,0,2,22
1265566,883542,2019-06-18,Assembly,"Assembly Rules Committee: Favorable",25,0,0,6,31
1265573,877561,2019-06-04,Assembly,"Assembly Governmental Operations Committee: Favorable refer to committee Rules",12,0,0,2,14
1265573,880732,2019-06-12,Assembly,"Assembly Rules Committee: Favorable",27,0,0,4,31
1265573,882952,2019-06-17,Senate,"Senate Floor Vote - Final Passage",62,0,0,0,62
1265573,883391,2019-06-17,Assembly,"Assembly Floor Vote - Final Passage",148,0,0,2,150
1265585,878792,2019-06-06,Assembly,"Assembly Corporations, Authorities And Commissions Committee: Favorable refer to committee Ways and Means",25,0,0,1,26
1265585,879375,2019-06-06,Assembly,"Assembly Ways And Means Committee: Favorable refer to committee Rules",31,0,0,4,35
1265585,880726,2019-06-12,Assembly,"Assembly Rules Committee: Favorable",27,0,0,4,31
1265588,877191,2019-06-04,Assembly,"Assembly Housing Committee: Favorable refer to committee Ways and Means",26,0,0,2,28
1265588,885221,2019-06-20,Assembly,"Assembly Rules Committee: Favorable",27,0,0,4,31
1265588,885222,2019-06-20,Assembly,"Assembly Ways And Means Committee: Favorable refer to committee Rules",34,0,0,1,35
1265606,884417,2019-06-18,Senate,"Senate Rules Committee Vote",19,0,0,0,19
1265606,886359,2019-06-19,Senate,"Senate Floor Vote - Final Passage",62,0,0,0,62
1265606,886360,2019-06-21,Assembly,"Assembly Floor Vote - Final Passage",139,1,0,10,150
1265610,883012,2019-06-17,Senate,"Senate Floor Vote - Final Passage",42,20,0,0,62
1265610,883013,2019-06-17,Senate,"Senate Rules Committee Vote",13,6,0,0,19
1265610,904588,2020-01-22,Senate,"Senate Committee Vote",6,1,0,0,7
1265610,941915,2020-03-03,Senate,"Senate Finance Committee Vote",17,6,0,0,23
1265618,877223,2019-06-04,Assembly,"Assembly Economic Development Committee: Favorable refer to committee Codes",23,1,0,2,26
1265618,880357,2019-06-11,Assembly,"Assembly Codes Committee: Favorable refer to committee Ways and Means",22,0,0,0,22
1265618,880358,2019-06-11,Assembly,"Assembly Ways And Means Committee: Favorable refer to committee Rules",33,0,0,2,35
1265618,881712,2019-06-14,Assembly,"Assembly Rules Committee: Favorable",25,0,0,6,31
1265618,884335,2019-06-18,Assembly,"Assembly Floor Vote - Final Passage",145,1,0,4,150
1265634,877980,2019-06-05,Assembly,"Assembly Health Committee: Favorable refer to committee Ways and Means",25,0,0,1,26
1265634,879291,2019-06-06,Assembly,"Assembly Ways And Means Committee: Favorable refer to committee Rules",31,0,0,4,35
1265634,880703,2019-06-12,Assembly,"Assembly Rules Committee: Favorable",27,0,0,4,31
1265650,877478,2019-06-04,Assembly,"Assembly Judiciary Committee: Favorable refer to committee Codes",20,1,0,0,21
1265650,880184,2019-06-11,Assembly,"Assembly Codes Committee: Favorable refer to committee Rules",22,0,0,0,22
1265650,971912,2020-07-17,Assembly,"Assembly Codes Committee: Favorable refer to committee Rules",21,0,0,1,22
1265650,973016,2020-07-22,Assembly,"Assembly Rules Committee: Favorable",25,0,0,5,30
1265666,877214,2019-06-04,Assembly,"Assembly Judiciary Committee: Favorable refer to committee Rules",20,1,0,0,21
1265666,881716,2019-06-14,Assembly,"Assembly Rules Committee: Favorable",25,0,0,6,31
1265686,877222,2019-06-04,Assembly,"Assembly Judiciary Committee: Favorable refer to committee Rules",21,0,0,0,21
1265686,880705,2019-06-12,Assembly,"Assembly Rules Committee: Favorable",27,0,0,4,31
1265798,878919,2019-06-06,Assembly,"Assembly Environmental Conservation Committee: Favorable refer to committee Rules",28,0,0,2,30
1265798,880743,2019-06-12,Assembly,"Assembly Rules Committee: Favorable",27,0,0,4,31
1265809,972753,2020-07-20,Senate,"Senate Labor Committee Vote",11,2,0,0,13
1265809,973184,2020-07-22,Assembly,"Assembly Floor Vote - Final Passage",101,41,0,3,145
1265809,973533,2020-07-22,Senate,"Senate Floor Vote - Final Passage",52,8,0,0,60
1265809,973779,2020-07-21,Senate,"Senate Rules Committee Vote",15,4,0,0,19
1265810,878954,2019-06-06,Assembly,"Assembly Environmental Conservation Committee: Favorable refer to committee Rules",28,0,0,2,30
1265810,880758,2019-06-12,Assembly,"Assembly Rules Committee: Favorable",27,0,0,4,31
1265820,877529,2019-06-04,Assembly,"Assembly Labor Committee: Favorable refer to committee Rules",28,0,0,1,29
1265820,880750,2019-06-12,Assembly,"Assembly Rules Committee: Favorable",27,0,0,4,31
1265820,883131,2019-06-17,Assembly,"Assembly Floor Vote - Final Passage",147,1,0,2,150
1265820,886583,2019-06-19,Senate,"Senate Floor Vote - Final Passage",58,4,0,0,62
1265826,886616,2019-06-20,Senate,"Senate Floor Vote - Final Passage",52,10,0,0,62
1265826,886617,2019-06-21,Assembly,"Assembly Floor Vote - Final Passage",106,36,0,8,150
1265826,887132,2019-06-19,Senate,"Senate Rules Committee Vote",18,1,0,0,19
1265832,878934,2019-06-06,Assembly,"Assembly Environmental Conservation Committee: Favorable refer to committee Rules",28,0,0,2,30
1265832,880759,2019-06-12,Assembly,"Assembly Rules Committee: Favorable",27,0,0,4,31
1265854,882032,2019-06-11,Senate,"Senate Rules Committee Vote",17,2,0,0,19
1265854,882033,2019-06-14,Senate,"Senate Floor Vote - Final Passage",53,9,0,0,62
1265854,884245,2019-06-18,Assembly,"Assembly Floor Vote - Final Passage",115,33,0,2,150
1265855,881144,2019-06-13,Assembly,"Assembly Health Committee: Favorable refer to committee Ways and Means",26,0,0,0,26
1265855,882071,2019-06-14,Assembly,"Assembly Ways And Means Committee: Favorable refer to committee Rules",30,0,0,5,35
1265855,882513,2019-06-17,Assembly,"Assembly Rules Committee: Favorable",26,0,0,5,31
1265896,878928,2019-06-06,Assembly,"Assembly Environmental Conservation Committee: Favorable refer to committee Rules",28,0,0,2,30
1265896,880775,2019-06-12,Assembly,"Assembly Rules Committee: Favorable",27,0,0,4,31
1265904,877624,2019-06-04,Assembly,"Assembly Governmental Operations Committee: Favorable refer to committee Rules",12,0,0,2,14
1265904,880712,2019-06-12,Assembly,"Assembly Rules Committee: Favorable",27,0,0,4,31
1265904,883198,2019-06-17,Assembly,"Assembly Floor Vote - Final Passage",148,0,0,2,150
1265904,886540,2019-06-18,Senate,"Senate Floor Vote - Final Passage",62,0,0,0,62
1265913,878962,2019-06-06,Assembly,"Assembly Environmental Conservation Committee: Favorable refer to committee Rules",28,0,0,2,30
1265913,881680,2019-06-14,Assembly,"Assembly Rules Committee: Favorable",25,0,0,6,31
1265913,884363,2019-06-18,Assembly,"Assembly Floor Vote - Final Passage",146,0,0,4,150
1265913,886643,2019-06-19,Senate,"Senate Floor Vote - Final Passage",62,0,0,0,62
1265916,881227,2019-06-13,Assembly,"Assembly Health Committee: Favorable refer to committee Ways and Means",26,0,0,0,26
1265916,881584,2019-06-13,Assembly,"Assembly Ways And Means Committee: Favorable refer to committee Rules",29,0,0,6,35
1265916,882432,2019-06-17,Assembly,"Assembly Rules Committee: Favorable",26,0,0,5,31
1265916,883977,2019-06-18,Assembly,"Assembly Floor Vote - Final Passage",148,0,0,2,150
1265916,885596,2019-06-18,Senate,"Senate Floor Vote - Final Passage",62,0,0,0,62
1265958,882917,2019-06-17,Assembly,"Assembly Labor Committee: Favorable refer to committee Codes",25,3,0,1,29
1265958,883787,2019-06-18,Assembly,"Assembly Codes Committee: Favorable refer to committee Rules",20,2,0,0,22
1265958,884928,2019-06-19,Assembly,"Assembly Rules Committee: Favorable",27,0,0,4,31
1265973,881142,2019-06-13,Assembly,"Assembly Health Committee: Favorable refer to committee Rules",26,0,0,0,26
1265973,882435,2019-06-17,Assembly,"Assembly Rules Committee: Favorable",26,0,0,5,31
1265978,878963,2019-06-06,Assembly,"Assembly Environmental Conservation Committee: Favorable refer to committee Rules",28,0,0,2,30
1265978,880765,2019-06-12,Assembly,"Assembly Rules Committee: Favorable",27,0,0,4,31
1265985,877539,2019-06-04,Assembly,"Assembly Children And Families Committee: Favorable refer to committee Codes",16,0,0,0,16
1265985,882911,2019-06-17,Assembly,"Assembly Codes Committee: Favorable refer to committee Ways and Means",20,0,0,2,22
1265985,883922,2019-06-18,Assembly,"Assembly Ways And Means Committee: Favorable refer to committee Rules",33,0,0,2,35
1265985,884958,2019-06-19,Assembly,"Assembly Rules Committee: Favorable",27,0,0,4,31
1265991,880258,2019-06-11,Assembly,"Assembly Codes Committee: Favorable refer to committee Ways and Means",22,0,0,0,22
1265991,882039,2019-06-14,Assembly,"Assembly Ways And Means Committee: Favorable refer to committee Rules",30,0,0,5,35
1265991,882521,2019-06-17,Assembly,"Assembly Rules Committee: Favorable",26,0,0,5,31
1265991,883985,2019-06-18,Assembly,"Assembly Floor Vote - Final Passage",148,0,0,2,150
1265994,883004,2019-06-17,Senate,"Senate Floor Vote - Final Passage",60,2,0,0,62
1265994,883005,2019-06-17,Senate,"Senate Rules Committee Vote",16,3,0,0,19
1265994,886230,2019-06-21,Assembly,"Assembly Floor Vote - Final Passage",132,3,0,15,150
1265996,950519,2020-03-10,Assembly,"Assembly Transportation Committee: Held for Consideration",18,7,0,0,25
1266000,877256,2019-06-04,Assembly,"Assembly Governmental Operations Committee: Favorable refer to committee Codes",12,0,0,2,14
1266000,878078,2019-06-05,Assembly,"Assembly Codes Committee: Favorable refer to committee Ways and Means",22,0,0,0,22
1266000,882057,2019-06-14,Assembly,"Assembly Ways And Means Committee: Favorable refer to committee Rules",30,0,0,5,35
1266000,883618,2019-06-18,Assembly,"Assembly Rules Committee: Favorable",25,0,0,6,31
1266000,886294,2019-06-20,Assembly,"Assembly Floor Vote - Final Passage",148,0,0,2,150
1266006,881409,2019-06-13,Assembly,"Assembly Codes Committee: Favorable refer to committee Rules",20,0,0,2,22
1266006,882523,2019-06-17,Assembly,"Assembly Rules Committee: Favorable",26,0,0,5,31
1266006,883950,2019-06-18,Assembly,"Assembly Floor Vote - Final Passage",138,10,0,2,150
1266006,972502,2020-07-21,Senate,"Senate Floor Vote - Final Passage",57,3,0,0,60
1266012,970840,2020-07-13,Assembly,"Assembly Health Committee: Held for Consideration",18,6,0,2,26
1266023,878413,2019-06-05,Assembly,"Assembly Transportation Committee: Favorable refer to committee Ways and Means",26,0,0,0,26
1266023,884943,2019-06-19,Assembly,"Assembly Rules Committee: Favorable",28,0,0,3,31
1266023,884944,2019-06-19,Assembly,"Assembly Ways And Means Committee: Favorable refer to committee Rules",33,0,0,2,35
1266027,877233,2019-06-04,Assembly,"Assembly Children And Families Committee: Favorable refer to committee Rules",16,0,0,0,16
1266027,881699,2019-06-14,Assembly,"Assembly Rules Committee: Favorable",25,0,0,6,31
1266029,883116,2019-06-17,Assembly,"Assembly Labor Committee: Favorable refer to committee Codes",28,0,0,1,29
1266029,883913,2019-06-18,Assembly,"Assembly Ways And Means Committee: Favorable refer to committee Rules",33,0,0,2,35
1266029,883914,2019-06-18,Assembly,"Assembly Codes Committee: Favorable refer to committee Ways and Means",22,0,0,0,22
1266029,884672,2019-06-19,Assembly,"Assembly Rules Committee: Favorable",27,0,0,4,31
1266038,950520,2020-03-10,Assembly,"Assembly Governmental Operations Committee: Held for Consideration",10,4,0,0,14
1266042,877254,2019-06-04,Assembly,"Assembly Correction Committee: Favorable refer to committee Ways and Means",10,3,0,0,13
1266054,885513,2019-06-18,Senate,"Senate Floor Vote - Final Passage",62,0,0,0,62
1266054,886677,2019-06-18,Senate,"Senate Rules Committee Vote",19,0,0,0,19
1266057,881774,2019-06-14,Assembly,"Assembly Ways And Means Committee: Favorable refer to committee Rules",21,9,0,5,35
1266057,882530,2019-06-17,Assembly,"Assembly Rules Committee: Favorable",26,0,0,5,31
1266057,883466,2019-06-17,Assembly,"Assembly Floor Vote - Final Passage",100,45,0,5,150
1266057,883963,2019-06-18,Senate,"Senate Floor Vote - Final Passage",43,19,0,0,62
1266063,877509,2019-06-04,Assembly,"Assembly Mental Health Committee: Favorable refer to committee Codes",12,0,0,1,13
1266063,880211,2019-06-11,Assembly,"Assembly Codes Committee: Favorable refer to committee Rules",22,0,0,0,22
1266063,882405,2019-06-17,Assembly,"Assembly Rules Committee: Favorable",26,0,0,5,31
1266071,877975,2019-06-05,Assembly,"Assembly Small Business Committee: Favorable refer to committee Ways and Means",16,0,0,1,17
1266071,879313,2019-06-06,Assembly,"Assembly Ways And Means Committee: Favorable refer to committee Rules",30,1,0,4,35
1266071,880729,2019-06-12,Assembly,"Assembly Rules Committee: Favorable",27,0,0,4,31
1266074,877131,2019-06-04,Assembly,"Assembly Labor Committee: Favorable refer to committee Ways and Means",28,0,0,1,29
1266074,878304,2019-06-05,Assembly,"Assembly Ways And Means Committee: Favorable refer to committee Rules",31,0,0,4,35
1266077,877497,2019-06-04,Assembly,"Assembly Children And Families Committee: Favorable refer to committee Codes",13,3,0,0,16
1266079,877536,2019-06-04,Assembly,"Assembly Children And Families Committee: Favorable refer to committee Codes",16,0,0,0,16
1266079,880253,2019-06-11,Assembly,"Assembly Codes Committee: Favorable refer to committee Rules",21,1,0,0,22
1266079,881690,2019-06-14,Assembly,"Assembly Rules Committee: Favorable",25,0,0,6,31
1266079,884331,2019-06-18,Assembly,"Assembly Floor Vote - Final Passage",106,40,0,4,150
1266148,877435,2019-06-04,Assembly,"Assembly Children And Families Committee: Favorable refer to committee Codes",16,0,0,0,16
1266148,881418,2019-06-13,Assembly,"Assembly Codes Committee: Favorable refer to committee Rules",20,0,0,2,22
1266148,882483,2019-06-17,Assembly,"Assembly Rules Committee: Favorable",26,0,0,5,31
1266152,885161,2019-06-19,Senate,"Senate Rules Committee Vote",19,0,0,0,19
1266152,886465,2019-06-21,Assembly,"Assembly Floor Vote - Final Passage",124,20,0,6,150
1266152,886795,2019-06-20,Senate,"Senate Floor Vote - Final Passage",62,0,0,0,62
1266155,877581,2019-06-04,Assembly,"Assembly Veterans' Affairs Committee: Favorable refer to committee Rules",18,0,0,1,19
1266155,880760,2019-06-12,Assembly,"Assembly Rules Committee: Favorable",27,0,0,4,31
1266155,883177,2019-06-17,Assembly,"Assembly Floor Vote - Final Passage",148,0,0,2,150
1266155,936328,2020-02-26,Senate,"Senate Floor Vote - Final Passage",60,0,0,2,62
1266159,877167,2019-06-04,Assembly,"Assembly Veterans' Affairs Committee: Favorable refer to committee Ways and Means",18,0,0,1,19
1266159,880828,2019-06-12,Assembly,"Assembly Ways And Means Committee: Favorable refer to committee Rules",30,0,0,5,35
1266159,881679,2019-06-14,Assembly,"Assembly Rules Committee: Favorable",25,0,0,6,31
1266162,877583,2019-06-04,Assembly,"Assembly Veterans' Affairs Committee: Favorable refer to committee Rules",18,0,0,1,19
1266162,881709,2019-06-14,Assembly,"Assembly Rules Committee: Favorable",25,0,0,6,31
1266162,884358,2019-06-18,Assembly,"Assembly Floor Vote - Final Passage",146,0,0,4,150
1266162,886642,2019-06-19,Senate,"Senate Floor Vote - Final Passage",43,19,0,0,62
1266163,877584,2019-06-04,Assembly,"Assembly Veterans' Affairs Committee: Favorable refer to committee Rules",18,0,0,1,19
1266163,881715,2019-06-14,Assembly,"Assembly Rules Committee: Favorable",25,0,0,6,31
1266163,884114,2019-06-18,Assembly,"Assembly Floor Vote - Final Passage",146,0,0,4,150
1266163,886337,2019-06-19,Senate,"Senate Floor Vote - Final Passage",51,11,0,0,62
1266169,877596,2019-06-04,Assembly,"Assembly Labor Committee: Favorable refer to committee Codes",26,2,0,1,29
1266169,881587,2019-06-13,Assembly,"Assembly Codes Committee: Favorable refer to committee Ways and Means",15,5,0,2,22
1266169,882647,2019-06-17,Assembly,"Assembly Rules Committee: Favorable",20,5,0,6,31
1266169,882648,2019-06-17,Assembly,"Assembly Ways And Means Committee: Favorable refer to committee Rules",23,10,0,2,35
1266170,877326,2019-06-04,Assembly,"Assembly Real Property Taxation Committee: Favorable refer to committee Codes",10,0,0,0,10
1266170,880188,2019-06-11,Assembly,"Assembly Codes Committee: Favorable refer to committee Ways and Means",22,0,0,0,22
1266170,881306,2019-06-13,Assembly,"Assembly Ways And Means Committee: Favorable refer to committee Rules",29,0,0,6,35
1266170,882458,2019-06-17,Assembly,"Assembly Rules Committee: Favorable",26,0,0,5,31
1266170,884485,2019-06-18,Assembly,"Assembly Floor Vote - Final Passage",148,0,0,2,150
1266170,973658,2020-07-22,Senate,"Senate Floor Vote - Final Passage",44,16,0,0,60
1266172,885090,2019-06-19,Senate,"Senate Rules Committee Vote",19,0,0,0,19
1266172,886388,2019-06-19,Senate,"Senate Floor Vote - Final Passage",62,0,0,0,62
1266172,886389,2019-06-21,Assembly,"Assembly Floor Vote - Final Passage",144,0,0,6,150
1266176,914486,2020-01-15,Senate,"Senate Mental Health and Developmental Disabilities Committee Vote",6,1,0,0,7
1266176,914487,2020-02-04,Senate,"Senate Floor Vote - Final Passage",49,12,0,1,62
1266182,879000,2019-06-06,Assembly,"Assembly Agriculture Committee: Favorable refer to committee Rules",20,0,0,1,21
1266182,882484,2019-06-17,Assembly,"Assembly Rules Committee: Favorable",26,0,0,5,31
1266186,885909,2019-06-18,Senate,"Senate Floor Vote - Final Passage",62,0,0,0,62
1266186,886423,2019-06-18,Senate,"Senate Rules Committee Vote",19,0,0,0,19
1266186,886424,2019-06-20,Assembly,"Assembly Floor Vote - Final Passage",137,11,0,2,150
1266188,878957,2019-06-06,Assembly,"Assembly Environmental Conservation Committee: Favorable refer to committee Ways and Means",28,0,0,2,30
1266188,972842,2020-07-22,Assembly,"Assembly Ways And Means Committee: Favorable refer to committee Rules",32,0,0,2,34
1266188,973101,2020-07-22,Assembly,"Assembly Rules Committee: Favorable",29,0,0,1,30
1266188,973542,2020-07-23,Assembly,"Assembly Floor Vote - Final Passage",141,0,0,4,145
1266195,881145,2019-06-13,Assembly,"Assembly Health Committee: Favorable refer to committee Rules",26,0,0,0,26
1266195,882447,2019-06-17,Assembly,"Assembly Rules Committee: Favorable",26,0,0,5,31
1266196,886372,2019-06-19,Senate,"Senate Floor Vote - Final Passage",62,0,0,0,62
1266196,886373,2019-06-21,Assembly,"Assembly Floor Vote - Final Passage",133,6,0,11,150
1266196,887276,2019-06-19,Senate,"Senate Rules Committee Vote",19,0,0,0,19
1266202,883014,2019-06-17,Senate,"Senate Floor Vote - Final Passage",52,10,0,0,62
1266202,883015,2019-06-17,Senate,"Senate Rules Committee Vote",17,2,0,0,19
1266204,885333,2019-06-19,Assembly,"Assembly Floor Vote - Final Passage",131,17,0,2,150
1266204,886108,2019-06-18,Senate,"Senate Floor Vote - Final Passage",62,0,0,0,62
1266204,886573,2019-06-18,Senate,"Senate Rules Committee Vote",19,0,0,0,19
1266208,881895,2019-06-13,Senate,"Senate Floor Vote - Final Passage",59,3,0,0,62
1266208,881896,2019-06-13,Senate,"Senate Rules Committee Vote",19,0,0,0,19
1266208,884041,2019-06-18,Assembly,"Assembly Floor Vote - Final Passage",148,0,0,2,150
1266214,885204,2019-06-19,Assembly,"Assembly Floor Vote - Final Passage",132,16,0,2,150
1266214,886500,2019-06-18,Senate,"Senate Rules Committee Vote",19,0,0,0,19
1266214,886501,2019-06-19,Senate,"Senate Floor Vote - Final Passage",61,1,0,0,62
1266215,879001,2019-06-06,Assembly,"Assembly Corporations, Authorities And Commissions Committee: Favorable refer to committee Ways and Means",25,0,0,1,26
1266215,882052,2019-06-14,Assembly,"Assembly Ways And Means Committee: Favorable refer to committee Rules",30,0,0,5,35
1266215,882527,2019-06-17,Assembly,"Assembly Rules Committee: Favorable",26,0,0,5,31
1266215,883944,2019-06-18,Assembly,"Assembly Floor Vote - Final Passage",146,2,0,2,150
1266215,886716,2019-06-20,Senate,"Senate Floor Vote - Final Passage",61,1,0,0,62
1266216,880710,2019-06-12,Assembly,"Assembly Local Governments Committee: Favorable refer to committee Ways and Means",17,0,0,2,19
1266216,881589,2019-06-13,Assembly,"Assembly Ways And Means Committee: Favorable refer to committee Rules",29,0,0,6,35
1266216,882437,2019-06-17,Assembly,"Assembly Rules Committee: Favorable",26,0,0,5,31
1266216,884494,2019-06-18,Assembly,"Assembly Floor Vote - Final Passage",148,0,0,2,150
1266216,886706,2019-06-19,Senate,"Senate Floor Vote - Final Passage",62,0,0,0,62
1266217,971445,2020-07-15,Assembly,"Assembly Veterans' Affairs Committee: Favorable refer to committee Ways and Means",17,0,0,2,19
1266217,972857,2020-07-22,Assembly,"Assembly Ways And Means Committee: Favorable refer to committee Rules",32,0,0,2,34
1266217,973108,2020-07-22,Assembly,"Assembly Rules Committee: Favorable",29,0,0,1,30
1266217,973573,2020-07-23,Assembly,"Assembly Floor Vote - Final Passage",141,0,0,4,145
1266222,972951,2020-07-21,Senate,"Senate Elections Committee Vote",6,1,0,0,7
1266222,973906,2020-07-21,Senate,"Senate Elections Committee Vote",6,1,0,0,7
1266222,973907,2020-07-22,Senate,"Senate Floor Vote - Final Passage",59,1,0,0,60
1266228,880787,2019-06-12,Assembly,"Assembly Ways And Means Committee: Favorable refer to committee Rules",30,0,0,5,35
1266228,880788,2019-06-12,Assembly,"Assembly Real Property Taxation Committee: Favorable refer to committee Ways and Means",9,0,0,1,10
1266228,881710,2019-06-14,Assembly,"Assembly Rules Committee: Favorable",25,0,0,6,31
1266228,884349,2019-06-18,Assembly,"Assembly Floor Vote - Final Passage",146,0,0,4,150
1266228,886614,2019-06-19,Senate,"Senate Floor Vote - Final Passage",59,3,0,0,62
1266230,878933,2019-06-06,Assembly,"Assembly Environmental Conservation Committee: Favorable refer to committee Rules",21,7,0,2,30
1266230,883579,2019-06-18,Assembly,"Assembly Rules Committee: Favorable",25,0,0,6,31
1266233,883260,2019-06-17,Assembly,"Assembly Ways And Means Committee: Favorable refer to committee Rules",28,5,0,2,35
1266233,883261,2019-06-17,Assembly,"Assembly Local Governments Committee: Favorable refer to committee Ways and Means",18,0,0,1,19
1266233,883564,2019-06-18,Assembly,"Assembly Rules Committee: Favorable",25,0,0,6,31
1266235,882689,2019-06-17,Assembly,"Assembly Rules Committee: Favorable",25,0,0,6,31
1266235,882690,2019-06-17,Assembly,"Assembly Ways And Means Committee: Favorable refer to committee Rules",28,5,0,2,35
1266235,882691,2019-06-17,Assembly,"Assembly Local Governments Committee: Favorable refer to committee Ways and Means",18,0,0,1,19
1266236,881284,2019-06-13,Assembly,"Assembly Health Committee: Favorable refer to committee Ways and Means",26,0,0,0,26
1266236,881588,2019-06-13,Assembly,"Assembly Ways And Means Committee: Favorable refer to committee Rules",28,1,0,6,35
1266236,882450,2019-06-17,Assembly,"Assembly Rules Committee: Favorable",26,0,0,5,31
1266250,878993,2019-06-06,Assembly,"Assembly Corporations, Authorities And Commissions Committee: Favorable refer to committee Rules",25,0,0,1,26
1266250,970908,2020-07-13,Assembly,"Assembly Corporations, Authorities And Commissions Committee: Favorable refer to committee Rules",24,2,0,0,26
1266250,972564,2020-07-21,Assembly,"Assembly Floor Vote - Final Passage",142,0,0,3,145
1266250,972565,2020-07-21,Assembly,"Assembly Rules Committee: Favorable",26,0,0,4,30
1266250,973421,2020-07-22,Senate,"Senate Floor Vote - Final Passage",60,0,0,0,60
1266257,882906,2019-06-17,Assembly,"Assembly Labor Committee: Favorable refer to committee Rules",28,0,0,1,29
1266257,886112,2019-06-20,Assembly,"Assembly Rules Committee: Favorable",27,0,0,4,31
1266272,878199,2019-06-05,Assembly,"Assembly Insurance Committee: Favorable refer to committee Ways and Means",21,3,0,0,24
1266275,882822,2019-06-17,Senate,"Senate Floor Vote - Final Passage",58,4,0,0,62
1266275,882823,2019-06-17,Senate,"Senate Rules Committee Vote",17,2,0,0,19
1266276,878995,2019-06-06,Assembly,"Assembly Corporations, Authorities And Commissions Committee: Favorable refer to committee Codes",19,6,0,1,26
1266276,883141,2019-06-17,Assembly,"Assembly Codes Committee: Favorable refer to committee Ways and Means",20,0,0,2,22
1266276,883641,2019-06-18,Assembly,"Assembly Rules Committee: Favorable",25,0,0,6,31
1266276,883642,2019-06-18,Assembly,"Assembly Ways And Means Committee: Favorable refer to committee Rules",30,3,0,2,35
1266276,884968,2019-06-19,Assembly,"Assembly Floor Vote - Final Passage",133,15,0,2,150
1266276,886794,2019-06-20,Senate,"Senate Floor Vote - Final Passage",62,0,0,0,62
1266346,878651,2019-06-06,Assembly,"Assembly Corporations, Authorities And Commissions Committee: Favorable refer to committee Ways and Means",22,3,0,1,26
1266346,880353,2019-06-11,Assembly,"Assembly Ways And Means Committee: Favorable refer to committee Rules",32,1,0,2,35
1266346,881686,2019-06-14,Assembly,"Assembly Rules Committee: Favorable",25,0,0,6,31
1266402,878924,2019-06-06,Assembly,"Assembly Environmental Conservation Committee: Favorable refer to committee Ways and Means",28,0,0,2,30
1266437,878974,2019-06-06,Assembly,"Assembly Environmental Conservation Committee: Favorable refer to committee Ways and Means",28,0,0,2,30
1266463,973166,2020-07-22,Senate,"Senate Floor Vote - Final Passage",44,16,0,0,60
1266463,973224,2020-07-22,Senate,"Senate Rules Committee Vote",13,6,0,0,19
1266470,880025,2019-06-11,Senate,"Senate Rules Committee Vote",19,0,0,0,19
1266470,880483,2019-06-11,Senate,"Senate Floor Vote - Final Passage",61,0,0,1,62
1266470,884233,2019-06-18,Assembly,"Assembly Floor Vote - Final Passage",102,46,0,2,150
1266471,882673,2019-06-17,Assembly,"Assembly Rules Committee: Favorable",24,1,0,6,31
1266471,882674,2019-06-17,Assembly,"Assembly Ways And Means Committee: Favorable refer to committee Rules",28,5,0,2,35
1266473,883016,2019-06-17,Senate,"Senate Floor Vote - Final Passage",62,0,0,0,62
1266473,883017,2019-06-17,Senate,"Senate Rules Committee Vote",19,0,0,0,19
1266473,884498,2019-06-18,Assembly,"Assembly Floor Vote - Final Passage",145,3,0,2,150
1266485,885096,2019-06-19,Assembly,"Assembly Floor Vote - Final Passage",114,34,0,2,150
1266485,885889,2019-06-18,Senate,"Senate Floor Vote - Final Passage",62,0,0,0,62
1266485,886362,2019-06-18,Senate,"Senate Rules Committee Vote",19,0,0,0,19
1266488,878930,2019-06-06,Assembly,"Assembly Environmental Conservation Committee: Favorable refer to committee Rules",28,0,0,2,30
1266488,880753,2019-06-12,Assembly,"Assembly Rules Committee: Favorable",27,0,0,4,31
1266488,883161,2019-06-17,Assembly,"Assembly Floor Vote - Final Passage",148,0,0,2,150
1266488,886494,2019-06-20,Senate,"Senate Floor Vote - Final Passage",62,0,0,0,62
1266491,878958,2019-06-06,Assembly,"Assembly Environmental Conservation Committee: Favorable refer to committee Ways and Means",28,0,0,2,30
1266491,880359,2019-06-11,Assembly,"Assembly Ways And Means Committee: Favorable refer to committee Rules",33,0,0,2,35
1266491,881702,2019-06-14,Assembly,"Assembly Rules Committee: Favorable",25,0,0,6,31
1266491,884359,2019-06-18,Assembly,"Assembly Floor Vote - Final Passage",146,0,0,4,150
1266491,885423,2019-06-18,Senate,"Senate Floor Vote - Final Passage",62,0,0,0,62
1266496,880395,2019-06-06,Senate,"Senate Rules Committee Vote",19,0,0,0,19
1266496,880396,2019-06-11,Senate,"Senate Floor Vote - Final Passage",59,2,0,1,62
1266498,878953,2019-06-06,Assembly,"Assembly Environmental Conservation Committee: Favorable refer to committee Rules",28,0,0,2,30
1266507,882288,2019-06-14,Assembly,"Assembly Governmental Operations Committee: Favorable refer to committee Rules",12,0,0,2,14
1266507,883630,2019-06-18,Assembly,"Assembly Rules Committee: Favorable",25,0,0,6,31
1266508,880029,2019-06-11,Senate,"Senate Rules Committee Vote",18,1,0,0,19
1266508,880454,2019-06-11,Senate,"Senate Floor Vote - Final Passage",61,0,0,1,62
1266508,883171,2019-06-17,Assembly,"Assembly Floor Vote - Final Passage",120,25,0,5,150
1266512,880794,2019-06-12,Assembly,"Assembly Ways And Means Committee: Favorable refer to committee Rules",30,0,0,5,35
1266512,880795,2019-06-12,Assembly,"Assembly Real Property Taxation Committee: Favorable refer to committee Ways and Means",9,0,0,1,10
1266512,884950,2019-06-19,Assembly,"Assembly Rules Committee: Favorable",27,0,0,4,31
1266519,971822,2020-07-16,Assembly,"Assembly Governmental Employees Committee: Held for Consideration",10,4,0,0,14
1266520,880834,2019-06-12,Assembly,"Assembly Ways And Means Committee: Favorable refer to committee Rules",26,4,0,5,35
1266520,880835,2019-06-12,Assembly,"Assembly Real Property Taxation Committee: Favorable refer to committee Ways and Means",7,2,0,1,10
1266520,881691,2019-06-14,Assembly,"Assembly Rules Committee: Favorable",25,0,0,6,31
1266520,884366,2019-06-18,Assembly,"Assembly Floor Vote - Final Passage",131,15,0,4,150
1266520,886652,2019-06-19,Senate,"Senate Floor Vote - Final Passage",62,0,0,0,62
1266522,885250,2019-06-20,Assembly,"Assembly Rules Committee: Favorable",27,0,0,4,31
1266522,885251,2019-06-20,Assembly,"Assembly Ways And Means Committee: Favorable refer to committee Rules",34,0,0,1,35
1266524,878959,2019-06-06,Assembly,"Assembly Environmental Conservation Committee: Favorable refer to committee Rules",28,0,0,2,30
1266524,880769,2019-06-12,Assembly,"Assembly Rules Committee: Favorable",27,0,0,4,31
1266524,883229,2019-06-17,Assembly,"Assembly Floor Vote - Final Passage",148,0,0,2,150
1266524,884226,2019-06-18,Senate,"Senate Floor Vote - Final Passage",62,0,0,0,62
1266526,881865,2019-06-13,Senate,"Senate Floor Vote - Final Passage",62,0,0,0,62
1266526,881866,2019-06-13,Senate,"Senate Rules Committee Vote",19,0,0,0,19
1266526,884030,2019-06-18,Assembly,"Assembly Floor Vote - Final Passage",148,0,0,2,150
1266533,971666,2020-07-16,Assembly,"Assembly Governmental Operations Committee: Held for Consideration",10,4,0,0,14
1266537,880875,2019-06-12,Assembly,"Assembly Cities Committee: Favorable refer to committee Ways and Means",14,0,0,1,15
1266537,882840,2019-06-17,Assembly,"Assembly Ways And Means Committee: Favorable refer to committee Rules",33,0,0,2,35
1266537,886449,2019-06-20,Assembly,"Assembly Rules Committee: Favorable",27,0,0,4,31
1266541,971449,2020-07-16,Assembly,"Assembly Governmental Operations Committee: Held for Consideration",10,4,0,0,14
1266542,914305,2020-02-04,Assembly,"Assembly Health Committee: Favorable refer to committee Ways and Means",23,0,0,3,26
1266542,971728,2020-07-17,Assembly,"Assembly Ways And Means Committee: Favorable refer to committee Rules",32,0,0,2,34
1266542,972801,2020-07-21,Assembly,"Assembly Floor Vote - Final Passage",141,1,0,3,145
1266542,972802,2020-07-21,Assembly,"Assembly Rules Committee: Favorable",26,0,0,4,30
1266542,973562,2020-07-22,Senate,"Senate Floor Vote - Final Passage",60,0,0,0,60
1266543,880210,2019-06-11,Assembly,"Assembly Codes Committee: Favorable refer to committee Rules",22,0,0,0,22
1266543,884929,2019-06-19,Assembly,"Assembly Rules Committee: Favorable",27,0,0,4,31
1266543,886204,2019-06-21,Assembly,"Assembly Floor Vote - Final Passage",143,1,0,6,150
1266545,971699,2020-07-16,Assembly,"Assembly Governmental Operations Committee: Favorable refer to committee Codes",14,0,0,0,14
1266545,971767,2020-07-17,Assembly,"Assembly Codes Committee: Favorable refer to committee Rules",21,0,0,1,22
1266545,972208,2020-07-20,Assembly,"Assembly Rules Committee: Favorable",27,0,0,3,30
1266545,972270,2020-07-20,Assembly,"Assembly Floor Vote - Final Passage",141,0,0,4,145
1266545,972471,2020-07-21,Senate,"Senate Floor Vote - Final Passage",45,15,0,0,60
1266548,971668,2020-07-16,Assembly,"Assembly Governmental Operations Committee: Held for Consideration",10,4,0,0,14
1266550,881798,2019-06-14,Assembly,"Assembly Transportation Committee: Favorable refer to committee Ways and Means",24,0,0,1,25
1266550,883619,2019-06-18,Assembly,"Assembly Rules Committee: Favorable",25,0,0,6,31
1266550,883620,2019-06-18,Assembly,"Assembly Ways And Means Committee: Favorable refer to committee Rules",33,0,0,2,35
1266550,886296,2019-06-21,Assembly,"Assembly Floor Vote - Final Passage",143,1,0,6,150
1266550,964902,2020-06-09,Senate,"Senate Floor Vote - Final Passage",62,0,0,0,62
1266554,883115,2019-06-17,Assembly,"Assembly Education Committee: Favorable refer to committee Ways and Means",27,0,0,4,31
1266554,884947,2019-06-19,Assembly,"Assembly Rules Committee: Favorable",28,0,0,3,31
1266554,884948,2019-06-19,Assembly,"Assembly Ways And Means Committee: Favorable refer to committee Rules",33,0,0,2,35
1266565,881863,2019-06-13,Senate,"Senate Floor Vote - Final Passage",62,0,0,0,62
1266565,881864,2019-06-13,Senate,"Senate Rules Committee Vote",19,0,0,0,19
1266565,883107,2019-06-17,Assembly,"Assembly Floor Vote - Final Passage",148,0,0,2,150
1266567,971290,2020-07-15,Assembly,"Assembly Labor Committee: Favorable refer to committee Codes",20,5,0,3,28
1266567,971853,2020-07-17,Assembly,"Assembly Ways And Means Committee: Favorable refer to committee Rules",22,10,0,2,34
1266567,971854,2020-07-17,Assembly,"Assembly Codes Committee: Favorable refer to committee Ways and Means",15,6,0,1,22
1266567,972199,2020-07-20,Assembly,"Assembly Rules Committee: Favorable",20,7,0,3,30
1266572,881410,2019-06-13,Assembly,"Assembly Codes Committee: Favorable refer to committee Rules",20,0,0,2,22
1266572,885261,2019-06-20,Assembly,"Assembly Rules Committee: Favorable",27,0,0,4,31
1266576,971298,2020-07-15,Assembly,"Assembly Labor Committee: Favorable refer to committee Codes",19,6,0,3,28
1266576,971827,2020-07-17,Assembly,"Assembly Codes Committee: Favorable refer to committee Rules",15,6,0,1,22
1266576,972576,2020-07-21,Assembly,"Assembly Rules Committee: Favorable",19,7,0,4,30
1266576,973211,2020-07-22,Assembly,"Assembly Floor Vote - Final Passage",98,44,0,3,145
1266646,881846,2019-06-13,Senate,"Senate Floor Vote - Final Passage",62,0,0,0,62
1266646,881847,2019-06-13,Senate,"Senate Rules Committee Vote",19,0,0,0,19
1266646,883129,2019-06-17,Assembly,"Assembly Floor Vote - Final Passage",148,0,0,2,150
1266658,881867,2019-06-13,Senate,"Senate Floor Vote - Final Passage",61,1,0,0,62
1266658,881868,2019-06-13,Senate,"Senate Rules Committee Vote",17,2,0,0,19
1266658,884037,2019-06-18,Assembly,"Assembly Floor Vote - Final Passage",144,2,0,4,150
1266662,881803,2019-06-14,Assembly,"Assembly Transportation Committee: Favorable refer to committee Codes",24,0,0,1,25
1266662,882576,2019-06-17,Assembly,"Assembly Codes Committee: Favorable refer to committee Rules",20,0,0,2,22
1266662,883149,2019-06-17,Assembly,"Assembly Codes Committee: Favorable refer to committee Rules",20,0,0,2,22
1266662,885056,2019-06-19,Assembly,"Assembly Floor Vote - Final Passage",148,0,0,2,150
1266662,902871,2020-01-14,Senate,"Senate Floor Vote - Final Passage",60,0,0,2,62
1266683,880041,2019-06-11,Senate,"Senate Rules Committee Vote",16,3,0,0,19
1266683,880532,2019-06-11,Senate,"Senate Floor Vote - Final Passage",45,16,0,1,62
1266683,884032,2019-06-18,Assembly,"Assembly Floor Vote - Final Passage",108,40,0,2,150
1266712,885610,2019-06-19,Senate,"Senate Rules Committee Vote",19,0,0,0,19
1266712,886725,2019-06-19,Senate,"Senate Floor Vote - Final Passage",62,0,0,0,62
1266712,914065,2020-02-03,Senate,"Senate Energy and Telecommunications Committee Vote",8,1,0,0,9
1266712,948884,2020-03-10,Senate,"Senate Floor Vote - Final Passage",59,0,0,3,62
1266715,884499,2019-06-17,Senate,"Senate Rules Committee Vote",19,0,0,0,19
1266715,886357,2019-06-19,Senate,"Senate Floor Vote - Final Passage",62,0,0,0,62
1266715,886358,2019-06-21,Assembly,"Assembly Floor Vote - Final Passage",135,0,0,15,150
1266747,882962,2019-06-17,Senate,"Senate Floor Vote - Final Passage",61,1,0,0,62
1266747,882963,2019-06-17,Senate,"Senate Rules Committee Vote",18,1,0,0,19
1266747,902990,2020-01-15,Senate,"Senate Consumer Protection Committee Vote",7,0,0,0,7
1266747,949231,2020-03-11,Senate,"Senate Floor Vote - Final Passage",57,1,0,4,62
1266754,886724,2019-06-19,Senate,"Senate Floor Vote - Final Passage",62,0,0,0,62
1266754,887174,2019-06-19,Senate,"Senate Rules Committee Vote",19,0,0,0,19
1266754,914232,2020-02-03,Senate,"Senate Energy and Telecommunications Committee Vote",8,1,0,0,9
1266754,919780,2020-02-11,Senate,"Senate Floor Vote - Final Passage",62,0,0,0,62
1266761,881814,2019-06-14,Assembly,"Assembly Transportation Committee: Favorable refer to committee Codes",24,0,0,1,25
1266761,882675,2019-06-17,Assembly,"Assembly Rules Committee: Favorable",25,0,0,6,31
1266761,882676,2019-06-17,Assembly,"Assembly Codes Committee: Favorable refer to committee Rules",20,0,0,2,22
1266761,885066,2019-06-19,Assembly,"Assembly Floor Vote - Final Passage",148,0,0,2,150
1266780,884072,2019-06-18,Assembly,"Assembly Floor Vote - Final Passage",148,0,0,2,150
1266780,884595,2019-06-18,Senate,"Senate Rules Committee Vote",19,0,0,0,19
1266780,885076,2019-06-18,Senate,"Senate Floor Vote - Final Passage",62,0,0,0,62
1266800,885154,2019-06-19,Assembly,"Assembly Floor Vote - Final Passage",148,0,0,2,150
1266800,885972,2019-06-18,Senate,"Senate Floor Vote - Final Passage",62,0,0,0,62
1266800,886459,2019-06-18,Senate,"Senate Rules Committee Vote",19,0,0,0,19
1266815,882940,2019-06-17,Senate,"Senate Floor Vote - Final Passage",62,0,0,0,62
1266815,882941,2019-06-17,Senate,"Senate Rules Committee Vote",19,0,0,0,19
1266815,884910,2019-06-19,Assembly,"Assembly Floor Vote - Final Passage",146,2,0,2,150
1266877,881911,2019-06-13,Senate,"Senate Floor Vote - Final Passage",62,0,0,0,62
1266877,881912,2019-06-13,Senate,"Senate Rules Committee Vote",19,0,0,0,19
1267017,885769,2019-06-19,Senate,"Senate Rules Committee Vote",19,0,0,0,19
1267017,886297,2019-06-19,Senate,"Senate Floor Vote - Final Passage",61,1,0,0,62
1267017,941733,2020-03-02,Senate,"Senate Racing, Gaming and Wagering Committee Vote",7,0,0,0,7
1267017,972386,2020-07-21,Senate,"Senate Floor Vote - Final Passage",59,1,0,0,60
1267017,973448,2020-07-22,Senate,"Senate Floor Vote - Final Passage",43,17,0,0,60
1267018,880192,2019-06-11,Assembly,"Assembly Codes Committee: Favorable refer to committee Rules",22,0,0,0,22
1267018,881708,2019-06-14,Assembly,"Assembly Rules Committee: Favorable",25,0,0,6,31
1267018,884340,2019-06-18,Assembly,"Assembly Floor Vote - Final Passage",145,1,0,4,150
1267018,885414,2019-06-18,Senate,"Senate Floor Vote - Final Passage",61,1,0,0,62
1267019,880042,2019-06-11,Senate,"Senate Rules Committee Vote",17,2,0,0,19
1267019,880455,2019-06-11,Senate,"Senate Floor Vote - Final Passage",47,14,0,1,62
1267019,883199,2019-06-17,Assembly,"Assembly Floor Vote - Final Passage",148,0,0,2,150
1267042,880022,2019-06-11,Senate,"Senate Rules Committee Vote",19,0,0,0,19
1267042,880489,2019-06-11,Senate,"Senate Floor Vote - Final Passage",61,0,0,1,62
1267042,883264,2019-06-17,Assembly,"Assembly Floor Vote - Final Passage",140,8,0,2,150
1267071,882134,2019-06-14,Senate,"Senate Floor Vote - Final Passage",62,0,0,0,62
1267071,882135,2019-06-14,Senate,"Senate Rules Committee Vote",19,0,0,0,19
1267071,886175,2019-06-21,Assembly,"Assembly Floor Vote - Final Passage",135,0,0,15,150
1267074,882678,2019-06-17,Assembly,"Assembly Rules Committee: Favorable",24,1,0,6,31
1267074,882679,2019-06-17,Assembly,"Assembly Ways And Means Committee: Favorable refer to committee Rules",25,8,0,2,35
1267076,887881,2019-06-20,Senate,"Senate Floor Vote - Final Passage",62,0,0,0,62
1267076,887882,2019-06-20,Senate,"Senate Floor Vote - Final Passage",62,0,0,0,62
1267076,887883,2019-06-20,Senate,"Senate Rules Committee Vote",19,0,0,0,19
1267091,883020,2019-06-17,Senate,"Senate Floor Vote - Final Passage",62,0,0,0,62
1267091,883021,2019-06-17,Senate,"Senate Rules Committee Vote",19,0,0,0,19
1267091,884141,2019-06-18,Assembly,"Assembly Floor Vote - Final Passage",148,0,0,2,150
1267093,886472,2019-06-19,Senate,"Senate Floor Vote - Final Passage",62,0,0,0,62
1267093,886473,2019-06-20,Assembly,"Assembly Floor Vote - Final Passage",147,1,0,2,150
1267093,887306,2019-06-19,Senate,"Senate Rules Committee Vote",19,0,0,0,19
1267101,884110,2019-06-18,Assembly,"Assembly Floor Vote - Final Passage",110,38,0,2,150
1267101,884611,2019-06-18,Senate,"Senate Rules Committee Vote",17,2,0,0,19
1267101,885085,2019-06-18,Senate,"Senate Floor Vote - Final Passage",48,14,0,0,62
1267128,880988,2019-06-12,Assembly,"Assembly Election Law Committee: Favorable refer to committee Rules",16,0,0,0,16
1267128,882465,2019-06-17,Assembly,"Assembly Rules Committee: Favorable",26,0,0,5,31
1267134,972341,2020-07-20,Senate,"Senate Local Government Committee Vote",7,0,0,0,7
1267134,973898,2020-07-21,Senate,"Senate Rules Committee Vote",18,1,0,0,19
1267134,973899,2020-07-22,Senate,"Senate Floor Vote - Final Passage",59,1,0,0,60
1267142,971700,2020-07-16,Assembly,"Assembly Local Governments Committee: Favorable refer to committee Ways and Means",18,1,0,1,20
1267142,971751,2020-07-17,Assembly,"Assembly Ways And Means Committee: Favorable refer to committee Rules",26,6,0,2,34
1267142,972222,2020-07-20,Assembly,"Assembly Rules Committee: Favorable",27,0,0,3,30
1267142,972283,2020-07-20,Assembly,"Assembly Floor Vote - Final Passage",130,11,0,4,145
1267142,973527,2020-07-22,Senate,"Senate Floor Vote - Final Passage",59,1,0,0,60
1267145,964119,2020-06-09,Senate,"Senate Floor Vote - Final Passage",62,0,0,0,62
1267145,967741,2020-05-28,Senate,"Senate Rules Committee Vote",19,0,0,0,19
1267145,967742,2020-06-08,Senate,"Senate Local Government Committee Vote",7,0,0,0,7
1267150,886268,2019-06-21,Assembly,"Assembly Floor Vote - Final Passage",142,2,0,6,150
1267150,886728,2019-06-19,Senate,"Senate Floor Vote - Final Passage",62,0,0,0,62
1267150,887149,2019-06-19,Senate,"Senate Rules Committee Vote",19,0,0,0,19
1267163,882700,2019-06-17,Assembly,"Assembly Rules Committee: Favorable",25,0,0,6,31
1267163,882936,2019-06-17,Assembly,"Assembly Codes Committee: Favorable refer to committee Rules",19,1,0,2,22
1267168,881297,2019-06-13,Assembly,"Assembly Ways And Means Committee: Favorable refer to committee Rules",29,0,0,6,35
1267168,882482,2019-06-17,Assembly,"Assembly Rules Committee: Favorable",26,0,0,5,31
1267168,884981,2019-06-19,Assembly,"Assembly Floor Vote - Final Passage",148,0,0,2,150
1267168,886700,2019-06-19,Senate,"Senate Floor Vote - Final Passage",62,0,0,0,62
1267183,882965,2019-06-17,Senate,"Senate Floor Vote - Final Passage",62,0,0,0,62
1267183,882966,2019-06-17,Senate,"Senate Rules Committee Vote",19,0,0,0,19
1267183,884368,2019-06-18,Assembly,"Assembly Floor Vote - Final Passage",142,6,0,2,150
1267191,884594,2019-06-18,Senate,"Senate Rules Committee Vote",17,2,0,0,19
1267191,885079,2019-06-18,Senate,"Senate Floor Vote - Final Passage",45,17,0,0,62
1267191,886350,2019-06-21,Assembly,"Assembly Floor Vote - Final Passage",101,43,0,6,150
1267230,964059,2020-06-09,Senate,"Senate Floor Vote - Final Passage",62,0,0,0,62
1267230,967728,2020-05-28,Senate,"Senate Rules Committee Vote",19,0,0,0,19
1267230,967729,2020-06-08,Senate,"Senate Local Government Committee Vote",7,0,0,0,7
1267241,971313,2020-07-14,Assembly,"Assembly Higher Education Committee: Held for Consideration",18,7,0,0,25
1267248,881795,2019-06-14,Assembly,"Assembly Transportation Committee: Favorable refer to committee Ways and Means",24,0,0,1,25
1267248,883690,2019-06-18,Assembly,"Assembly Ways And Means Committee: Favorable refer to committee Rules",33,0,0,2,35
1267248,885267,2019-06-20,Assembly,"Assembly Rules Committee: Favorable",27,0,0,4,31
1267248,886536,2019-06-21,Assembly,"Assembly Floor Vote - Final Passage",139,1,0,10,150
1267251,881802,2019-06-14,Assembly,"Assembly Transportation Committee: Favorable refer to committee Ways and Means",24,0,0,1,25
1267251,882748,2019-06-17,Assembly,"Assembly Rules Committee: Favorable",25,0,0,6,31
1267251,882749,2019-06-17,Assembly,"Assembly Ways And Means Committee: Favorable refer to committee Rules",33,0,0,2,35
1267267,971239,2020-07-14,Assembly,"Assembly Education Committee: Held for Consideration",23,6,0,2,31
1267283,885182,2019-06-19,Senate,"Senate Rules Committee Vote",19,0,0,0,19
1267283,885183,2019-06-19,Assembly,"Assembly Floor Vote - Final Passage",147,1,0,2,150
1267283,886469,2019-06-19,Senate,"Senate Floor Vote - Final Passage",62,0,0,0,62
1267285,902588,2020-01-14,Assembly,"Assembly Rules Committee: Favorable",25,0,0,5,30
1267285,902589,2020-01-14,Assembly,"Assembly Ways And Means Committee: Favorable refer to committee Rules",33,0,0,2,35
1267285,902590,2020-01-14,Assembly,"Assembly Transportation Committee: Favorable refer to committee Ways and Means",24,0,0,1,25
1267285,902866,2020-01-14,Senate,"Senate Floor Vote - Final Passage",60,0,0,2,62
1267285,902928,2020-01-14,Assembly,"Assembly Floor Vote - Final Passage",140,0,0,8,148
1267300,883008,2019-06-17,Senate,"Senate Floor Vote - Final Passage",62,0,0,0,62
1267300,883009,2019-06-17,Senate,"Senate Rules Committee Vote",19,0,0,0,19
1267310,971485,2020-07-16,Assembly,"Assembly Transportation Committee: Held for Consideration",16,6,0,2,24
1267313,883117,2019-06-17,Assembly,"Assembly Education Committee: Favorable refer to committee Ways and Means",27,0,0,4,31
1267313,883586,2019-06-18,Assembly,"Assembly Rules Committee: Favorable",25,0,0,6,31
1267313,883587,2019-06-18,Assembly,"Assembly Ways And Means Committee: Favorable refer to committee Rules",33,0,0,2,35
1267322,964599,2020-03-03,Senate,"Senate Commerce, Economic Development and Small Business Committee Vote",9,0,0,0,9
1267322,964600,2020-06-09,Senate,"Senate Floor Vote - Final Passage",61,1,0,0,62
1267328,882762,2019-06-17,Assembly,"Assembly Local Governments Committee: Favorable refer to committee Rules",18,0,0,1,19
1267328,883505,2019-06-18,Assembly,"Assembly Rules Committee: Favorable",25,0,0,6,31
1267328,886285,2019-06-20,Assembly,"Assembly Floor Vote - Final Passage",144,1,0,5,150
1267328,964481,2020-06-09,Senate,"Senate Floor Vote - Final Passage",62,0,0,0,62
1267339,881143,2019-06-13,Assembly,"Assembly Health Committee: Favorable refer to committee Rules",19,7,0,0,26
1267339,883997,2019-06-18,Assembly,"Assembly Rules Committee: Favorable",25,0,0,6,31
1267339,972621,2020-07-21,Assembly,"Assembly Floor Vote - Final Passage",99,43,0,3,145
1267340,881140,2019-06-13,Assembly,"Assembly Health Committee: Favorable refer to committee Ways and Means",26,0,0,0,26
1267340,885227,2019-06-20,Assembly,"Assembly Rules Committee: Favorable",27,0,0,4,31
1267340,885228,2019-06-20,Assembly,"Assembly Ways And Means Committee: Favorable refer to committee Rules",34,0,0,1,35
1267341,880894,2019-06-12,Assembly,"Assembly Local Governments Committee: Favorable refer to committee Ways and Means",17,0,0,2,19
1267341,882040,2019-06-14,Assembly,"Assembly Ways And Means Committee: Favorable refer to committee Rules",30,0,0,5,35
1267341,882429,2019-06-17,Assembly,"Assembly Rules Committee: Favorable",26,0,0,5,31
1267351,882624,2019-06-17,Assembly,"Assembly Local Governments Committee: Favorable refer to committee Ways and Means",18,0,0,1,19
1267351,883529,2019-06-18,Assembly,"Assembly Rules Committee: Favorable",25,0,0,6,31
1267351,883530,2019-06-18,Assembly,"Assembly Ways And Means Committee: Favorable refer to committee Rules",33,0,0,2,35
1267351,886273,2019-06-21,Assembly,"Assembly Floor Vote - Final Passage",142,2,0,6,150
1267351,964308,2020-06-09,Senate,"Senate Floor Vote - Final Passage",62,0,0,0,62
1267354,885914,2019-06-18,Senate,"Senate Floor Vote - Final Passage",62,0,0,0,62
1267354,886417,2019-06-18,Senate,"Senate Rules Committee Vote",19,0,0,0,19
1267354,886418,2019-06-21,Assembly,"Assembly Floor Vote - Final Passage",134,1,0,15,150
1267373,880853,2019-06-12,Assembly,"Assembly Election Law Committee: Favorable refer to committee Rules",12,4,0,0,16
1267373,882512,2019-06-17,Assembly,"Assembly Rules Committee: Favorable",26,0,0,5,31
1267374,880012,2019-06-11,Senate,"Senate Rules Committee Vote",18,1,0,0,19
1267374,880480,2019-06-11,Senate,"Senate Floor Vote - Final Passage",60,1,0,1,62
1267374,883245,2019-06-17,Assembly,"Assembly Floor Vote - Final Passage",140,8,0,2,150
1267376,881933,2019-06-12,Senate,"Senate Floor Vote - Final Passage",62,0,0,0,62
1267376,881934,2019-06-12,Senate,"Senate Rules Committee Vote",19,0,0,0,19
1267376,902802,2020-01-14,Senate,"Senate Health Committee Vote",14,0,0,0,14
1267376,914284,2020-02-04,Senate,"Senate Floor Vote - Final Passage",59,2,0,1,62
1267381,883048,2019-06-17,Senate,"Senate Floor Vote - Final Passage",62,0,0,0,62
1267381,883049,2019-06-17,Senate,"Senate Rules Committee Vote",19,0,0,0,19
1267381,884509,2019-06-18,Assembly,"Assembly Floor Vote - Final Passage",146,0,0,4,150
1267390,885205,2019-06-19,Senate,"Senate Rules Committee Vote",19,0,0,0,19
1267390,886591,2019-06-19,Senate,"Senate Floor Vote - Final Passage",61,1,0,0,62
1267390,886592,2019-06-20,Assembly,"Assembly Floor Vote - Final Passage",96,50,0,4,150
1267393,880013,2019-06-11,Senate,"Senate Rules Committee Vote",18,1,0,0,19
1267393,880470,2019-06-11,Senate,"Senate Floor Vote - Final Passage",60,1,0,1,62
1267393,883246,2019-06-17,Assembly,"Assembly Floor Vote - Final Passage",141,7,0,2,150
1267395,973499,2020-07-22,Senate,"Senate Floor Vote - Final Passage",60,0,0,0,60
1267395,973822,2020-07-20,Senate,"Senate Transportation Committee Vote",15,0,0,0,15
1267395,973823,2020-07-21,Senate,"Senate Rules Committee Vote",19,0,0,0,19
1267396,880132,2019-06-11,Assembly,"Assembly Codes Committee: Favorable refer to committee Rules",16,6,0,0,22
1267396,963646,2020-06-08,Assembly,"Assembly Codes Committee: Favorable refer to committee Rules",19,2,0,1,22
1267396,963647,2020-06-08,Assembly,"Assembly Rules Committee: Favorable",25,1,0,5,31
1267416,880023,2019-06-11,Senate,"Senate Rules Committee Vote",18,1,0,0,19
1267416,880494,2019-06-11,Senate,"Senate Floor Vote - Final Passage",60,1,0,1,62
1267416,883247,2019-06-17,Assembly,"Assembly Floor Vote - Final Passage",146,2,0,2,150
1267417,886531,2019-06-20,Senate,"Senate Floor Vote - Final Passage",62,0,0,0,62
1267417,903427,2020-01-14,Senate,"Senate Labor Committee Vote",13,0,0,0,13
1267417,904969,2020-01-23,Senate,"Senate Floor Vote - Final Passage",59,0,0,3,62
1267417,972822,2020-07-21,Assembly,"Assembly Floor Vote - Final Passage",142,0,0,3,145
1267418,880037,2019-06-11,Senate,"Senate Rules Committee Vote",18,1,0,0,19
1267418,880525,2019-06-11,Senate,"Senate Floor Vote - Final Passage",60,1,0,1,62
1267418,883254,2019-06-17,Assembly,"Assembly Floor Vote - Final Passage",144,4,0,2,150
1267424,883053,2019-06-17,Senate,"Senate Floor Vote - Final Passage",62,0,0,0,62
1267424,883054,2019-06-17,Senate,"Senate Rules Committee Vote",19,0,0,0,19
1267425,885505,2019-06-18,Senate,"Senate Floor Vote - Final Passage",62,0,0,0,62
1267425,886671,2019-06-18,Senate,"Senate Rules Committee Vote",19,0,0,0,19
1267430,885511,2019-06-18,Senate,"Senate Floor Vote - Final Passage",62,0,0,0,62
1267430,886687,2019-06-18,Senate,"Senate Rules Committee Vote",19,0,0,0,19
1267467,885040,2019-06-19,Assembly,"Assembly Floor Vote - Final Passage",144,3,0,3,150
1267467,885767,2019-06-19,Senate,"Senate Rules Committee Vote",19,0,0,0,19
1267467,886302,2019-06-19,Senate,"Senate Floor Vote - Final Passage",62,0,0,0,62
1267475,885038,2019-06-19,Assembly,"Assembly Floor Vote - Final Passage",148,0,0,2,150
1267475,885762,2019-06-19,Senate,"Senate Rules Committee Vote",19,0,0,0,19
1267475,886299,2019-06-19,Senate,"Senate Floor Vote - Final Passage",62,0,0,0,62
1267483,880945,2019-06-12,Assembly,"Assembly Election Law Committee: Favorable refer to committee Rules",11,5,0,0,16
1267483,882538,2019-06-17,Assembly,"Assembly Rules Committee: Favorable",26,0,0,5,31
1267514,886729,2019-06-19,Senate,"Senate Floor Vote - Final Passage",62,0,0,0,62
1267514,887175,2019-06-19,Senate,"Senate Rules Committee Vote",19,0,0,0,19
1267514,972703,2020-07-20,Senate,"Senate Civil Service and Pensions Committee Vote",7,0,0,0,7
1267514,972704,2020-07-21,Senate,"Senate Finance Committee Vote",23,0,0,0,23
1267514,974030,2020-07-22,Senate,"Senate Floor Vote - Final Passage",60,0,0,0,60
1267514,974031,2020-07-22,Senate,"Senate Rules Committee Vote",19,0,0,0,19
1267519,885806,2019-06-19,Senate,"Senate Rules Committee Vote",14,5,0,0,19
1267519,886320,2019-06-19,Senate,"Senate Floor Vote - Final Passage",42,20,0,0,62
1267519,886321,2019-06-20,Assembly,"Assembly Floor Vote - Final Passage",103,43,0,4,150
1267526,884969,2019-06-19,Assembly,"Assembly Floor Vote - Final Passage",127,20,0,3,150
1267526,885571,2019-06-19,Senate,"Senate Rules Committee Vote",19,0,0,0,19
1267526,886650,2019-06-19,Senate,"Senate Floor Vote - Final Passage",53,9,0,0,62
1267541,880011,2019-06-11,Senate,"Senate Rules Committee Vote",19,0,0,0,19
1267541,880471,2019-06-11,Senate,"Senate Floor Vote - Final Passage",61,0,0,1,62
1267541,907355,2020-01-28,Senate,"Senate Health Committee Vote",15,0,0,0,15
1267541,972528,2020-07-21,Senate,"Senate Floor Vote - Final Passage",58,2,0,0,60
1267543,882685,2019-06-17,Assembly,"Assembly Rules Committee: Favorable",25,0,0,6,31
1267543,882686,2019-06-17,Assembly,"Assembly Ways And Means Committee: Favorable refer to committee Rules",32,1,0,2,35
1267543,882687,2019-06-17,Assembly,"Assembly Local Governments Committee: Favorable refer to committee Ways and Means",18,0,0,1,19
1267543,885089,2019-06-19,Assembly,"Assembly Floor Vote - Final Passage",131,17,0,2,150
1267543,886788,2019-06-20,Senate,"Senate Floor Vote - Final Passage",62,0,0,0,62
1267568,884591,2019-06-18,Senate,"Senate Rules Committee Vote",16,3,0,0,19
1267568,885853,2019-06-18,Senate,"Senate Floor Vote - Final Passage",44,18,0,0,62
1267568,886325,2019-06-21,Assembly,"Assembly Floor Vote - Final Passage",130,14,0,6,150
1267577,884825,2019-06-19,Assembly,"Assembly Ways And Means Committee: Favorable refer to committee Rules",33,0,0,2,35
1267577,885241,2019-06-20,Assembly,"Assembly Rules Committee: Favorable",27,0,0,4,31
1267579,885510,2019-06-18,Senate,"Senate Floor Vote - Final Passage",62,0,0,0,62
1267579,886199,2019-06-20,Assembly,"Assembly Floor Vote - Final Passage",126,20,0,4,150
1267579,886678,2019-06-18,Senate,"Senate Rules Committee Vote",19,0,0,0,19
1267582,883041,2019-06-17,Senate,"Senate Floor Vote - Final Passage",62,0,0,0,62
1267582,883042,2019-06-17,Senate,"Senate Rules Committee Vote",19,0,0,0,19
1267582,886240,2019-06-20,Assembly,"Assembly Floor Vote - Final Passage",145,0,0,5,150
1267587,882766,2019-06-17,Assembly,"Assembly Local Governments Committee: Favorable refer to committee Rules",18,0,0,1,19
1267587,883648,2019-06-18,Assembly,"Assembly Rules Committee: Favorable",25,0,0,6,31
1267590,881139,2019-06-13,Assembly,"Assembly Health Committee: Favorable refer to committee Rules",26,0,0,0,26
1267590,882520,2019-06-17,Assembly,"Assembly Rules Committee: Favorable",26,0,0,5,31
1267599,883668,2019-06-13,Senate,"Senate Rules Committee Vote",19,0,0,0,19
1267599,885824,2019-06-18,Senate,"Senate Floor Vote - Final Passage",60,2,0,0,62
1267599,886322,2019-06-21,Assembly,"Assembly Floor Vote - Final Passage",144,0,0,6,150
1267603,973856,2020-07-20,Senate,"Senate Transportation Committee Vote",15,0,0,0,15
1267603,973857,2020-07-21,Senate,"Senate Rules Committee Vote",19,0,0,0,19
1267603,973858,2020-07-22,Senate,"Senate Floor Vote - Final Passage",60,0,0,0,60
1267604,882995,2019-06-17,Senate,"Senate Floor Vote - Final Passage",62,0,0,0,62
1267604,882996,2019-06-17,Senate,"Senate Rules Committee Vote",19,0,0,0,19
1267604,922627,2020-02-12,Senate,"Senate Corporations, Authorities and Commissions Committee Vote",6,0,0,1,7
1267604,937420,2020-02-27,Senate,"Senate Floor Vote - Final Passage",59,0,0,3,62
1267604,973743,2020-07-23,Assembly,"Assembly Floor Vote - Final Passage",141,0,0,4,145
1267611,938297,2020-02-26,Assembly,"Assembly Corporations, Authorities And Commissions Committee: Favorable refer to committee Ways and Means",23,2,0,1,26
1267611,972905,2020-07-22,Assembly,"Assembly Rules Committee: Favorable",29,0,0,1,30
1267611,972906,2020-07-22,Assembly,"Assembly Ways And Means Committee: Favorable refer to committee Rules",32,0,0,2,34
1267613,943158,2020-03-03,Assembly,"Assembly Social Services Committee: Favorable refer to committee Ways and Means",14,2,0,1,17
1267707,971207,2020-07-14,Assembly,"Assembly Election Law Committee: Favorable refer to committee Rules",16,0,0,0,16
1267707,972187,2020-07-20,Assembly,"Assembly Rules Committee: Favorable",27,0,0,3,30
1267727,884814,2019-06-19,Assembly,"Assembly Ways And Means Committee: Favorable refer to committee Rules",33,0,0,2,35
1267727,885225,2019-06-20,Assembly,"Assembly Rules Committee: Favorable",27,0,0,4,31
1267735,882625,2019-06-17,Assembly,"Assembly Real Property Taxation Committee: Favorable refer to committee Ways and Means",10,0,0,0,10
1267735,883493,2019-06-18,Assembly,"Assembly Rules Committee: Favorable",25,0,0,6,31
1267735,883494,2019-06-18,Assembly,"Assembly Ways And Means Committee: Favorable refer to committee Rules",33,0,0,2,35
1267755,885506,2019-06-18,Senate,"Senate Floor Vote - Final Passage",62,0,0,0,62
1267755,886679,2019-06-18,Senate,"Senate Rules Committee Vote",19,0,0,0,19
1267755,973849,2020-07-21,Senate,"Senate Rules Committee Vote",19,0,0,0,19
1267755,973850,2020-07-22,Senate,"Senate Floor Vote - Final Passage",60,0,0,0,60
1267767,886369,2019-06-19,Senate,"Senate Floor Vote - Final Passage",62,0,0,0,62
1267767,887274,2019-06-19,Senate,"Senate Rules Committee Vote",19,0,0,0,19
1267775,886702,2019-06-19,Senate,"Senate Floor Vote - Final Passage",42,20,0,0,62
1267775,887153,2019-06-19,Senate,"Senate Rules Committee Vote",14,5,0,0,19
1267775,932959,2020-02-24,Senate,"Senate Local Government Committee Vote",5,2,0,0,7
1267802,885218,2019-06-20,Assembly,"Assembly Rules Committee: Favorable",27,0,0,4,31
1267802,885219,2019-06-20,Assembly,"Assembly Ways And Means Committee: Favorable refer to committee Rules",34,0,0,1,35
1267803,885563,2019-06-18,Senate,"Senate Floor Vote - Final Passage",62,0,0,0,62
1267803,886692,2019-06-18,Senate,"Senate Rules Committee Vote",19,0,0,0,19
1267806,883069,2019-06-17,Senate,"Senate Floor Vote - Final Passage",54,8,0,0,62
1267806,883070,2019-06-17,Senate,"Senate Rules Committee Vote",16,3,0,0,19
1267806,886611,2019-06-20,Assembly,"Assembly Floor Vote - Final Passage",140,6,0,4,150
1267811,884010,2019-06-18,Assembly,"Assembly Local Governments Committee: Favorable refer to committee Ways and Means",17,0,0,2,19
1267811,884811,2019-06-19,Assembly,"Assembly Ways And Means Committee: Favorable refer to committee Rules",33,0,0,2,35
1267811,885232,2019-06-20,Assembly,"Assembly Rules Committee: Favorable",27,0,0,4,31
1267824,883033,2019-06-17,Senate,"Senate Floor Vote - Final Passage",62,0,0,0,62
1267824,883034,2019-06-17,Senate,"Senate Rules Committee Vote",19,0,0,0,19
1267824,902960,2020-01-14,Senate,"Senate Cultural Affairs, Tourism, Parks and Recreation Committee Vote",7,0,0,0,7
1267824,922347,2020-02-13,Senate,"Senate Floor Vote - Final Passage",57,0,0,5,62
1267885,882055,2019-06-14,Assembly,"Assembly Ways And Means Committee: Favorable refer to committee Rules",30,0,0,5,35
1267885,882502,2019-06-17,Assembly,"Assembly Rules Committee: Favorable",26,0,0,5,31
1267888,883055,2019-06-17,Senate,"Senate Floor Vote - Final Passage",62,0,0,0,62
1267888,883056,2019-06-17,Senate,"Senate Rules Committee Vote",19,0,0,0,19
1267888,883945,2019-06-18,Assembly,"Assembly Floor Vote - Final Passage",148,0,0,2,150
1267892,885243,2019-06-20,Assembly,"Assembly Rules Committee: Favorable",19,8,0,4,31
1267892,885244,2019-06-20,Assembly,"Assembly Ways And Means Committee: Favorable refer to committee Rules",24,10,0,1,35
1267894,884767,2019-06-19,Assembly,"Assembly Ways And Means Committee: Favorable refer to committee Rules",32,1,0,2,35
1267894,886083,2019-06-20,Assembly,"Assembly Rules Committee: Favorable",27,0,0,4,31
1267899,885398,2019-06-19,Assembly,"Assembly Floor Vote - Final Passage",147,1,0,2,150
1267899,886133,2019-06-18,Senate,"Senate Floor Vote - Final Passage",61,1,0,0,62
1267899,886608,2019-06-18,Senate,"Senate Rules Committee Vote",18,1,0,0,19
1267903,885169,2019-06-19,Senate,"Senate Rules Committee Vote",19,0,0,0,19
1267903,886194,2019-06-20,Assembly,"Assembly Floor Vote - Final Passage",111,35,0,4,150
1267903,886674,2019-06-19,Senate,"Senate Floor Vote - Final Passage",62,0,0,0,62
1267904,884838,2019-06-19,Assembly,"Assembly Rules Committee: Favorable",28,0,0,3,31
1267904,884839,2019-06-19,Assembly,"Assembly Ways And Means Committee: Favorable refer to committee Rules",33,0,0,2,35
1267977,881220,2019-06-13,Assembly,"Assembly Housing Committee: Favorable refer to committee Codes",18,9,0,1,28
1267977,881376,2019-06-13,Assembly,"Assembly Rules Committee: Favorable",18,8,0,5,31
1267977,881377,2019-06-13,Assembly,"Assembly Codes Committee: Favorable refer to committee Ways and Means",14,6,0,2,22
1267977,881378,2019-06-13,Assembly,"Assembly Ways And Means Committee: Favorable refer to committee Rules",19,10,0,6,35
1267991,882061,2019-06-14,Senate,"Senate Floor Vote - Final Passage",36,26,0,0,62
1267991,882062,2019-06-14,Senate,"Senate Rules Committee Vote",12,7,0,0,19
1267991,882732,2019-06-14,Assembly,"Assembly Floor Vote - Final Passage",95,46,0,9,150
1268011,885911,2019-06-18,Senate,"Senate Floor Vote - Final Passage",61,1,0,0,62
1268011,886427,2019-06-18,Senate,"Senate Rules Committee Vote",18,1,0,0,19
1268011,886428,2019-06-21,Assembly,"Assembly Floor Vote - Final Passage",130,10,0,10,150
1268014,972927,2020-07-21,Senate,"Senate Finance Committee Vote",23,0,0,0,23
1268014,973881,2020-07-21,Senate,"Senate Finance Committee Vote",23,0,0,0,23
1268014,973882,2020-07-21,Senate,"Senate Rules Committee Vote",19,0,0,0,19
1268014,973883,2020-07-22,Senate,"Senate Floor Vote - Final Passage",60,0,0,0,60
1268018,886601,2019-06-18,Senate,"Senate Rules Committee Vote",12,7,0,0,19
1268018,886602,2019-06-19,Senate,"Senate Floor Vote - Final Passage",42,20,0,0,62
1268018,901542,2020-01-08,Senate,"Senate Floor Vote - Final Passage",40,20,0,2,62
1268018,901543,2020-01-09,Senate,"Senate Floor Vote - Final Passage",40,20,0,2,62
1268018,901884,2020-01-09,Senate,"Senate Elections Committee Vote",5,2,0,0,7
1268018,901885,2020-01-09,Senate,"Senate Rules Committee Vote",12,6,0,1,19
1268038,885055,2019-06-19,Assembly,"Assembly Floor Vote - Final Passage",148,0,0,2,150
1268038,885832,2019-06-18,Senate,"Senate Floor Vote - Final Passage",62,0,0,0,62
1268046,971429,2020-07-16,Assembly,"Assembly Real Property Taxation Committee: Favorable refer to committee Ways and Means",10,0,0,0,10
1268046,971830,2020-07-17,Assembly,"Assembly Ways And Means Committee: Favorable refer to committee Rules",32,0,0,2,34
1268046,972211,2020-07-20,Assembly,"Assembly Rules Committee: Favorable",27,0,0,3,30
1268046,972276,2020-07-20,Assembly,"Assembly Floor Vote - Final Passage",141,0,0,4,145
1268046,973517,2020-07-22,Senate,"Senate Floor Vote - Final Passage",58,2,0,0,60
1268051,972387,2020-01-21,Senate,"Senate Elections Committee Vote",5,2,0,0,7
1268051,972388,2020-07-21,Senate,"Senate Floor Vote - Final Passage",40,20,0,0,60
1268068,881664,2019-06-14,Assembly,"Assembly Governmental Employees Committee: Favorable refer to committee Rules",13,0,0,1,14
1268068,882548,2019-06-17,Assembly,"Assembly Rules Committee: Favorable",26,0,0,5,31
1268068,885380,2019-06-19,Assembly,"Assembly Floor Vote - Final Passage",148,0,0,2,150
1268068,886604,2019-06-20,Senate,"Senate Floor Vote - Final Passage",62,0,0,0,62
1268095,885153,2019-06-19,Senate,"Senate Rules Committee Vote",17,2,0,0,19
1268095,886183,2019-06-21,Assembly,"Assembly Floor Vote - Final Passage",143,1,0,6,150
1268095,886670,2019-06-19,Senate,"Senate Floor Vote - Final Passage",46,16,0,0,62
1268106,881790,2019-06-14,Assembly,"Assembly Cities Committee: Favorable refer to committee Ways and Means",14,1,0,0,15
1268106,882605,2019-06-17,Assembly,"Assembly Rules Committee: Favorable",25,0,0,6,31
1268106,882606,2019-06-17,Assembly,"Assembly Ways And Means Committee: Favorable refer to committee Rules",32,1,0,2,35
1268154,882867,2019-06-17,Assembly,"Assembly Ways And Means Committee: Favorable refer to committee Rules",33,0,0,2,35
1268154,882868,2019-06-17,Assembly,"Assembly Real Property Taxation Committee: Favorable refer to committee Ways and Means",10,0,0,0,10
1268154,883501,2019-06-18,Assembly,"Assembly Rules Committee: Favorable",25,0,0,6,31
1268163,882842,2019-06-17,Assembly,"Assembly Codes Committee: Favorable refer to committee Rules",20,0,0,2,22
1268163,883616,2019-06-18,Assembly,"Assembly Rules Committee: Favorable",25,0,0,6,31
1268175,971108,2020-07-14,Assembly,"Assembly Environmental Conservation Committee: Favorable refer to committee Codes",22,5,0,1,28
1268175,971847,2020-07-17,Assembly,"Assembly Codes Committee: Favorable refer to committee Rules",15,6,0,1,22
1268187,883909,2019-06-18,Assembly,"Assembly Ways And Means Committee: Favorable refer to committee Rules",33,0,0,2,35
1268187,884974,2019-06-19,Assembly,"Assembly Rules Committee: Favorable",27,0,0,4,31
1268218,882882,2019-06-17,Assembly,"Assembly Ways And Means Committee: Favorable refer to committee Rules",33,0,0,2,35
1268218,883498,2019-06-18,Assembly,"Assembly Rules Committee: Favorable",25,0,0,6,31
1268220,963714,2020-06-09,Assembly,"Assembly Rules Committee: Favorable",27,0,0,4,31
1268220,963715,2020-06-09,Assembly,"Assembly Ways And Means Committee: Favorable refer to committee Rules",32,0,0,3,35
1268220,964583,2020-06-09,Assembly,"Assembly Floor Vote - Final Passage",143,1,0,3,147
1268220,973569,2020-07-22,Senate,"Senate Floor Vote - Final Passage",60,0,0,0,60
1268240,885107,2019-06-19,Assembly,"Assembly Floor Vote - Final Passage",148,0,0,2,150
1268240,885907,2019-06-18,Senate,"Senate Floor Vote - Final Passage",62,0,0,0,62
1268240,886409,2019-06-18,Senate,"Senate Rules Committee Vote",19,0,0,0,19
1268243,971701,2020-07-16,Assembly,"Assembly Governmental Employees Committee: Favorable refer to committee Ways and Means",14,0,0,0,14
1268243,971753,2020-07-17,Assembly,"Assembly Ways And Means Committee: Favorable refer to committee Rules",30,2,0,2,34
1268243,972539,2020-07-21,Assembly,"Assembly Floor Vote - Final Passage",139,3,0,3,145
1268243,972540,2020-07-21,Assembly,"Assembly Rules Committee: Favorable",26,0,0,4,30
1268243,973418,2020-07-22,Senate,"Senate Floor Vote - Final Passage",60,0,0,0,60
1268244,881799,2019-06-14,Assembly,"Assembly Transportation Committee: Favorable refer to committee Codes",24,0,0,1,25
1268244,882630,2019-06-17,Assembly,"Assembly Rules Committee: Favorable",25,0,0,6,31
1268244,882631,2019-06-17,Assembly,"Assembly Codes Committee: Favorable refer to committee Rules",20,0,0,2,22
1268244,884891,2019-06-19,Assembly,"Assembly Floor Vote - Final Passage",148,0,0,2,150
1268258,883127,2019-06-17,Assembly,"Assembly Education Committee: Favorable refer to committee Ways and Means",27,0,0,4,31
1268258,883652,2019-06-18,Assembly,"Assembly Rules Committee: Favorable",25,0,0,6,31
1268258,883653,2019-06-18,Assembly,"Assembly Ways And Means Committee: Favorable refer to committee Rules",33,0,0,2,35
1268260,885236,2019-06-20,Assembly,"Assembly Rules Committee: Favorable",27,0,0,4,31
1268260,885237,2019-06-20,Assembly,"Assembly Ways And Means Committee: Favorable refer to committee Rules",33,1,0,1,35
1268311,883140,2019-06-17,Assembly,"Assembly Education Committee: Favorable refer to committee Ways and Means",27,0,0,4,31
1268311,883584,2019-06-18,Assembly,"Assembly Rules Committee: Favorable",25,0,0,6,31
1268311,883585,2019-06-18,Assembly,"Assembly Ways And Means Committee: Favorable refer to committee Rules",33,0,0,2,35
1268324,885903,2019-06-18,Senate,"Senate Floor Vote - Final Passage",62,0,0,0,62
1268324,886415,2019-06-18,Senate,"Senate Rules Committee Vote",19,0,0,0,19
1268324,886416,2019-06-21,Assembly,"Assembly Floor Vote - Final Passage",139,1,0,10,150
1268336,881808,2019-06-14,Assembly,"Assembly Transportation Committee: Favorable refer to committee Codes",23,1,0,1,25
1268336,882667,2019-06-17,Assembly,"Assembly Rules Committee: Favorable",25,0,0,6,31
1268336,882668,2019-06-17,Assembly,"Assembly Codes Committee: Favorable refer to committee Rules",20,0,0,2,22
1268342,973668,2020-07-22,Senate,"Senate Floor Vote - Final Passage",52,8,0,0,60
1268342,974634,2020-07-21,Senate,"Senate Rules Committee Vote",18,1,0,0,19
1268398,882713,2019-06-17,Assembly,"Assembly Codes Committee: Favorable refer to committee Rules",20,0,0,2,22
1268398,883633,2019-06-18,Assembly,"Assembly Rules Committee: Favorable",25,0,0,6,31
1268399,972425,2020-07-20,Senate,"Senate Corporations, Authorities And Commissions Committee Vote",7,0,0,0,7
1268399,973345,2020-07-22,Senate,"Senate Rules Committee Vote",19,0,0,0,19
1268399,973736,2020-07-23,Senate,"Senate Floor Vote - Final Passage",58,2,0,0,60
1268404,885514,2019-06-18,Senate,"Senate Floor Vote - Final Passage",62,0,0,0,62
1268404,886298,2019-06-18,Senate,"Senate Rules Committee Vote",19,0,0,0,19
1268404,907090,2020-01-28,Senate,"Senate Health Committee Vote",15,0,0,0,15
1268404,940999,2020-03-03,Senate,"Senate Finance Committee Vote",23,0,0,0,23
1268404,972396,2020-07-21,Senate,"Senate Floor Vote - Final Passage",59,1,0,0,60
1268404,973383,2020-07-23,Assembly,"Assembly Floor Vote - Final Passage",141,0,0,4,145
1268407,882717,2019-06-17,Assembly,"Assembly Codes Committee: Favorable refer to committee Rules",14,6,0,2,22
1268425,882541,2019-06-17,Assembly,"Assembly Higher Education Committee: Favorable refer to committee Codes",26,0,0,0,26
1268425,882979,2019-06-17,Assembly,"Assembly Codes Committee: Favorable refer to committee Ways and Means",19,1,0,2,22
1268425,883532,2019-06-18,Assembly,"Assembly Rules Committee: Favorable",25,0,0,6,31
1268425,883533,2019-06-18,Assembly,"Assembly Ways And Means Committee: Favorable refer to committee Rules",32,1,0,2,35
1268426,882724,2019-06-17,Assembly,"Assembly Judiciary Committee: Favorable refer to committee Codes",18,0,0,3,21
1268426,883446,2019-06-18,Assembly,"Assembly Codes Committee: Favorable refer to committee Rules",22,0,0,0,22
1268426,884965,2019-06-19,Assembly,"Assembly Rules Committee: Favorable",27,0,0,4,31
1268582,886028,2019-06-18,Senate,"Senate Floor Vote - Final Passage",62,0,0,0,62
1268582,886292,2019-06-18,Senate,"Senate Rules Committee Vote",17,2,0,0,19
1268582,973828,2020-07-20,Senate,"Senate Transportation Committee Vote",15,0,0,0,15
1268604,882664,2019-06-17,Assembly,"Assembly Local Governments Committee: Favorable refer to committee Ways and Means",18,0,0,1,19
1268604,883513,2019-06-18,Assembly,"Assembly Rules Committee: Favorable",25,0,0,6,31
1268604,883514,2019-06-18,Assembly,"Assembly Ways And Means Committee: Favorable refer to committee Rules",33,0,0,2,35
1268619,882628,2019-06-17,Assembly,"Assembly Rules Committee: Favorable",25,0,0,6,31
1268619,882629,2019-06-17,Assembly,"Assembly Ways And Means Committee: Favorable refer to committee Rules",27,6,0,2,35
1268622,886103,2019-06-18,Senate,"Senate Floor Vote - Final Passage",62,0,0,0,62
1268622,886254,2019-06-18,Senate,"Senate Rules Committee Vote",19,0,0,0,19
1268622,886255,2019-06-21,Assembly,"Assembly Floor Vote - Final Passage",143,1,0,6,150
1268626,972858,2020-07-22,Assembly,"Assembly Ways And Means Committee: Favorable refer to committee Rules",31,1,0,2,34
1268626,973102,2020-07-22,Assembly,"Assembly Rules Committee: Favorable",29,0,0,1,30
1268660,886710,2019-06-19,Senate,"Senate Floor Vote - Final Passage",59,3,0,0,62
1268660,887144,2019-06-19,Senate,"Senate Rules Committee Vote",19,0,0,0,19
1268673,885902,2019-06-18,Senate,"Senate Floor Vote - Final Passage",61,1,0,0,62
1268673,886407,2019-06-18,Senate,"Senate Rules Committee Vote",19,0,0,0,19
1268673,886408,2019-06-20,Assembly,"Assembly Floor Vote - Final Passage",145,0,0,5,150
1268682,885142,2019-06-19,Senate,"Senate Rules Committee Vote",19,0,0,0,19
1268682,886435,2019-06-19,Senate,"Senate Floor Vote - Final Passage",59,3,0,0,62
1268682,886436,2019-06-21,Assembly,"Assembly Floor Vote - Final Passage",135,0,0,15,150
1268694,885931,2019-06-18,Senate,"Senate Floor Vote - Final Passage",61,1,0,0,62
1268694,886453,2019-06-18,Senate,"Senate Rules Committee Vote",19,0,0,0,19
1268694,886454,2019-06-20,Assembly,"Assembly Floor Vote - Final Passage",148,0,0,2,150
1268704,883508,2019-06-18,Assembly,"Assembly Rules Committee: Favorable",25,0,0,6,31
1268704,883509,2019-06-18,Assembly,"Assembly Ways And Means Committee: Favorable refer to committee Rules",33,0,0,2,35
1268723,886656,2019-06-20,Senate,"Senate Floor Vote - Final Passage",60,2,0,0,62
1268723,887139,2019-06-20,Senate,"Senate Rules Committee Vote",18,1,0,0,19
1268750,972937,2020-07-20,Senate,"Senate Environmental Conservation Committee Vote",10,1,0,0,11
1268750,972938,2020-07-21,Senate,"Senate Finance Committee Vote",17,6,0,0,23
1268750,973143,2020-07-22,Assembly,"Assembly Floor Vote - Final Passage",100,42,0,3,145
1268750,973433,2020-07-22,Senate,"Senate Floor Vote - Final Passage",45,15,0,0,60
1268750,973793,2020-07-21,Senate,"Senate Finance Committee Vote",17,6,0,0,23
1268755,971855,2020-07-17,Assembly,"Assembly Codes Committee: Favorable refer to committee Rules",21,0,0,1,22
1268755,972198,2020-07-20,Assembly,"Assembly Rules Committee: Favorable",27,0,0,3,30
1268755,972264,2020-07-20,Assembly,"Assembly Floor Vote - Final Passage",141,0,0,4,145
1268755,973437,2020-07-22,Senate,"Senate Floor Vote - Final Passage",60,0,0,0,60
1268764,885890,2019-06-18,Senate,"Senate Floor Vote - Final Passage",62,0,0,0,62
1268764,886584,2019-06-18,Senate,"Senate Rules Committee Vote",19,0,0,0,19
1268768,886447,2019-06-18,Senate,"Senate Rules Committee Vote",19,0,0,0,19
1268768,886448,2019-06-21,Assembly,"Assembly Floor Vote - Final Passage",132,3,0,15,150
1268768,886791,2019-06-20,Senate,"Senate Floor Vote - Final Passage",62,0,0,0,62
1268770,886419,2019-06-18,Senate,"Senate Rules Committee Vote",19,0,0,0,19
1268770,886420,2019-06-19,Senate,"Senate Floor Vote - Final Passage",60,2,0,0,62
1268770,886421,2019-06-21,Assembly,"Assembly Floor Vote - Final Passage",141,3,0,6,150
1268772,883646,2019-06-18,Assembly,"Assembly Rules Committee: Favorable",25,0,0,6,31
1268772,883647,2019-06-18,Assembly,"Assembly Ways And Means Committee: Favorable refer to committee Rules",33,0,0,2,35
1268777,883662,2019-06-18,Assembly,"Assembly Local Governments Committee: Favorable refer to committee Ways and Means",17,0,0,2,19
1268777,884940,2019-06-19,Assembly,"Assembly Rules Committee: Favorable",28,0,0,3,31
1268777,884941,2019-06-19,Assembly,"Assembly Ways And Means Committee: Favorable refer to committee Rules",27,6,0,2,35
1268778,882603,2019-06-17,Assembly,"Assembly Rules Committee: Favorable",25,0,0,6,31
1268778,882604,2019-06-17,Assembly,"Assembly Ways And Means Committee: Favorable refer to committee Rules",33,0,0,2,35
1268779,885845,2019-06-18,Senate,"Senate Floor Vote - Final Passage",62,0,0,0,62
1268779,886326,2019-06-18,Senate,"Senate Rules Committee Vote",19,0,0,0,19
1268779,886327,2019-06-20,Assembly,"Assembly Floor Vote - Final Passage",147,0,0,3,150
1268781,884573,2019-06-18,Senate,"Senate Rules Committee Vote",18,1,0,0,19
1268781,885815,2019-06-18,Senate,"Senate Floor Vote - Final Passage",60,2,0,0,62
1268784,885892,2019-06-18,Senate,"Senate Floor Vote - Final Passage",62,0,0,0,62
1268784,886397,2019-06-18,Senate,"Senate Rules Committee Vote",19,0,0,0,19
1268784,886398,2019-06-21,Assembly,"Assembly Floor Vote - Final Passage",144,0,0,6,150
1268786,973523,2020-07-22,Senate,"Senate Floor Vote - Final Passage",60,0,0,0,60
1268786,973524,2020-07-23,Assembly,"Assembly Floor Vote - Final Passage",140,1,0,4,145
1268786,973842,2020-07-21,Senate,"Senate Rules Committee Vote",19,0,0,0,19
1268787,883540,2019-06-18,Assembly,"Assembly Rules Committee: Favorable",25,0,0,6,31
1268787,883541,2019-06-18,Assembly,"Assembly Ways And Means Committee: Favorable refer to committee Rules",33,0,0,2,35
1268787,886276,2019-06-20,Assembly,"Assembly Floor Vote - Final Passage",148,0,0,2,150
1268787,886732,2019-06-20,Senate,"Senate Floor Vote - Final Passage",62,0,0,0,62
1268798,882722,2019-06-17,Assembly,"Assembly Labor Committee: Favorable refer to committee Codes",27,1,0,1,29
1268799,885083,2019-06-19,Senate,"Senate Rules Committee Vote",19,0,0,0,19
1268799,886370,2019-06-19,Senate,"Senate Floor Vote - Final Passage",55,7,0,0,62
1268799,916865,2020-02-04,Senate,"Senate Children and Families Committee Vote",6,1,0,0,7
1268799,935158,2020-02-25,Senate,"Senate Finance Committee Vote",20,2,0,1,23
1268799,949356,2020-03-11,Senate,"Senate Floor Vote - Final Passage",50,8,0,4,62
1268799,972733,2020-07-21,Assembly,"Assembly Floor Vote - Final Passage",116,26,0,3,145
1268800,882998,2019-06-17,Senate,"Senate Floor Vote - Final Passage",49,13,0,0,62
1268800,882999,2019-06-17,Senate,"Senate Rules Committee Vote",16,3,0,0,19
1268800,886335,2019-06-20,Assembly,"Assembly Floor Vote - Final Passage",147,0,0,3,150
1268801,882708,2019-06-17,Assembly,"Assembly Judiciary Committee: Favorable refer to committee Ways and Means",17,1,0,3,21
1268801,884963,2019-06-19,Assembly,"Assembly Rules Committee: Favorable",28,0,0,3,31
1268801,884964,2019-06-19,Assembly,"Assembly Ways And Means Committee: Favorable refer to committee Rules",31,2,0,2,35
1268802,885594,2019-06-19,Senate,"Senate Rules Committee Vote",19,0,0,0,19
1268802,886356,2019-06-19,Senate,"Senate Floor Vote - Final Passage",62,0,0,0,62
1268805,963728,2020-06-09,Assembly,"Assembly Rules Committee: Favorable",27,0,0,4,31
1268805,963729,2020-06-09,Assembly,"Assembly Ways And Means Committee: Favorable refer to committee Rules",32,0,0,3,35
1268805,964605,2020-06-09,Assembly,"Assembly Floor Vote - Final Passage",144,0,0,3,147
1268806,885179,2019-06-19,Senate,"Senate Rules Committee Vote",14,5,0,0,19
1268806,886665,2019-06-19,Senate,"Senate Floor Vote - Final Passage",44,18,0,0,62
1268806,973522,2020-07-22,Senate,"Senate Floor Vote - Final Passage",44,16,0,0,60
1268806,973836,2020-07-20,Senate,"Senate Judiciary Committee Vote",14,1,0,0,15
1268806,973837,2020-07-21,Senate,"Senate Rules Committee Vote",13,6,0,0,19
1268808,883626,2019-06-18,Assembly,"Assembly Rules Committee: Favorable",25,0,0,6,31
1268808,883627,2019-06-18,Assembly,"Assembly Ways And Means Committee: Favorable refer to committee Rules",29,4,0,2,35
1268810,886630,2019-06-18,Senate,"Senate Rules Committee Vote",12,7,0,0,19
1268810,886631,2019-06-19,Senate,"Senate Floor Vote - Final Passage",40,22,0,0,62
1268810,886632,2019-06-20,Assembly,"Assembly Floor Vote - Final Passage",106,41,0,3,150
1268811,882843,2019-06-17,Assembly,"Assembly Ways And Means Committee: Favorable refer to committee Rules",23,10,0,2,35
1268811,883516,2019-06-18,Assembly,"Assembly Rules Committee: Favorable",25,0,0,6,31
1268811,925003,2020-02-12,Assembly,"Assembly Floor Vote - Final Passage",113,31,0,3,147
1268812,883628,2019-06-18,Assembly,"Assembly Rules Committee: Favorable",25,0,0,6,31
1268812,883629,2019-06-18,Assembly,"Assembly Ways And Means Committee: Favorable refer to committee Rules",33,0,0,2,35
1268814,885201,2019-06-19,Senate,"Senate Rules Committee Vote",13,6,0,0,19
1268814,886467,2019-06-19,Senate,"Senate Floor Vote - Final Passage",42,20,0,0,62
1268814,886468,2019-06-21,Assembly,"Assembly Floor Vote - Final Passage",143,1,0,6,150
1268816,885166,2019-06-19,Senate,"Senate Rules Committee Vote",19,0,0,0,19
1268816,886182,2019-06-21,Assembly,"Assembly Floor Vote - Final Passage",142,0,0,8,150
1268816,886664,2019-06-19,Senate,"Senate Floor Vote - Final Passage",62,0,0,0,62
1268817,883887,2019-06-18,Assembly,"Assembly Ways And Means Committee: Favorable refer to committee Rules",33,0,0,2,35
1268817,884866,2019-06-19,Assembly,"Assembly Rules Committee: Favorable",27,0,0,4,31
1268819,972309,2020-07-20,Senate,"Senate Higher Education Committee Vote",11,0,0,0,11
1268819,972957,2020-07-21,Senate,"Senate Finance Committee Vote",23,0,0,0,23
1268819,973429,2020-07-22,Senate,"Senate Floor Vote - Final Passage",60,0,0,0,60
1268819,973792,2020-07-21,Senate,"Senate Finance Committee Vote",23,0,0,0,23
1268820,883152,2019-06-17,Assembly,"Assembly Education Committee: Favorable refer to committee Rules",27,0,0,4,31
1268820,883551,2019-06-18,Assembly,"Assembly Rules Committee: Favorable",25,0,0,6,31
1268821,886544,2019-06-18,Senate,"Senate Rules Committee Vote",19,0,0,0,19
1268821,886545,2019-06-19,Senate,"Senate Floor Vote - Final Passage",62,0,0,0,62
1268821,886546,2019-06-21,Assembly,"Assembly Floor Vote - Final Passage",144,0,0,6,150
1268823,886488,2019-06-18,Senate,"Senate Rules Committee Vote",19,0,0,0,19
1268823,886489,2019-06-19,Senate,"Senate Floor Vote - Final Passage",62,0,0,0,62
1268823,886490,2019-06-21,Assembly,"Assembly Floor Vote - Final Passage",135,0,0,15,150
1268824,885112,2019-06-19,Senate,"Senate Rules Committee Vote",19,0,0,0,19
1268824,886402,2019-06-19,Senate,"Senate Floor Vote - Final Passage",62,0,0,0,62
1268824,886403,2019-06-21,Assembly,"Assembly Floor Vote - Final Passage",144,0,0,6,150
1268825,882932,2019-06-17,Assembly,"Assembly Codes Committee: Favorable refer to committee Rules",17,3,0,2,22
1268825,883526,2019-06-18,Assembly,"Assembly Rules Committee: Favorable",25,0,0,6,31
1268826,886118,2019-06-18,Senate,"Senate Floor Vote - Final Passage",62,0,0,0,62
1268826,886260,2019-06-18,Senate,"Senate Rules Committee Vote",19,0,0,0,19
1268826,886261,2019-06-21,Assembly,"Assembly Floor Vote - Final Passage",106,38,0,6,150
1268829,886383,2019-06-18,Senate,"Senate Rules Committee Vote",19,0,0,0,19
1268829,886384,2019-06-19,Senate,"Senate Floor Vote - Final Passage",62,0,0,0,62
1268829,886385,2019-06-21,Assembly,"Assembly Floor Vote - Final Passage",141,3,0,6,150
1268831,884816,2019-06-19,Assembly,"Assembly Ways And Means Committee: Favorable refer to committee Rules",33,0,0,2,35
1268831,885231,2019-06-20,Assembly,"Assembly Rules Committee: Favorable",27,0,0,4,31
1268832,886085,2019-06-18,Senate,"Senate Floor Vote - Final Passage",43,19,0,0,62
1268832,886246,2019-06-20,Assembly,"Assembly Floor Vote - Final Passage",126,20,0,4,150
1268832,886713,2019-06-18,Senate,"Senate Rules Committee Vote",14,5,0,0,19
1268835,883654,2019-06-18,Assembly,"Assembly Rules Committee: Favorable",23,2,0,6,31
1268835,883655,2019-06-18,Assembly,"Assembly Ways And Means Committee: Favorable refer to committee Rules",27,6,0,2,35
1268836,882876,2019-06-17,Assembly,"Assembly Codes Committee: Favorable refer to committee Rules",14,6,0,2,22
1268847,883650,2019-06-18,Assembly,"Assembly Local Governments Committee: Favorable refer to committee Ways and Means",17,0,0,2,19
1268847,884815,2019-06-19,Assembly,"Assembly Ways And Means Committee: Favorable refer to committee Rules",33,0,0,2,35
1268847,885247,2019-06-20,Assembly,"Assembly Rules Committee: Favorable",27,0,0,4,31
1268849,882612,2019-06-17,Assembly,"Assembly Real Property Taxation Committee: Favorable refer to committee Ways and Means",10,0,0,0,10
1268849,883604,2019-06-18,Assembly,"Assembly Rules Committee: Favorable",25,0,0,6,31
1268849,883605,2019-06-18,Assembly,"Assembly Ways And Means Committee: Favorable refer to committee Rules",31,2,0,2,35
1268850,882874,2019-06-17,Assembly,"Assembly Codes Committee: Favorable refer to committee Rules",17,3,0,2,22
1268850,883566,2019-06-18,Assembly,"Assembly Rules Committee: Favorable",25,0,0,6,31
1268856,883088,2019-06-17,Assembly,"Assembly Education Committee: Favorable refer to committee Ways and Means",27,0,0,4,31
1268856,883518,2019-06-18,Assembly,"Assembly Rules Committee: Favorable",25,0,0,6,31
1268856,883519,2019-06-18,Assembly,"Assembly Ways And Means Committee: Favorable refer to committee Rules",33,0,0,2,35
1268862,886549,2019-06-18,Senate,"Senate Rules Committee Vote",18,1,0,0,19
1268862,886550,2019-06-19,Senate,"Senate Floor Vote - Final Passage",62,0,0,0,62
1268869,886381,2019-06-19,Senate,"Senate Floor Vote - Final Passage",61,1,0,0,62
1268869,886382,2019-06-21,Assembly,"Assembly Floor Vote - Final Passage",122,22,0,6,150
1268869,887142,2019-06-19,Senate,"Senate Rules Committee Vote",19,0,0,0,19
1268872,886191,2019-06-21,Assembly,"Assembly Floor Vote - Final Passage",96,41,0,13,150
1268872,886668,2019-06-19,Senate,"Senate Floor Vote - Final Passage",43,19,0,0,62
1268872,887137,2019-06-19,Senate,"Senate Rules Committee Vote",15,4,0,0,19
1268879,885491,2019-06-19,Senate,"Senate Rules Committee Vote",19,0,0,0,19
1268879,886660,2019-06-19,Senate,"Senate Floor Vote - Final Passage",62,0,0,0,62
1268879,904467,2020-01-21,Senate,"Senate Housing, Construction and Community Development Committee Vote",11,0,0,0,11
1268887,883510,2019-06-18,Assembly,"Assembly Rules Committee: Favorable",18,7,0,6,31
1268887,883511,2019-06-18,Assembly,"Assembly Ways And Means Committee: Favorable refer to committee Rules",23,10,0,2,35
1268887,885014,2019-06-19,Assembly,"Assembly Floor Vote - Final Passage",118,30,0,2,150
1268887,886735,2019-06-19,Senate,"Senate Floor Vote - Final Passage",42,20,0,0,62
1268895,971814,2020-07-16,Assembly,"Assembly Governmental Employees Committee: Held for Consideration",10,4,0,0,14
1268905,883074,2019-06-17,Assembly,"Assembly Codes Committee: Favorable refer to committee Rules",19,1,0,2,22
1268905,883546,2019-06-18,Assembly,"Assembly Rules Committee: Favorable",25,0,0,6,31
1268916,886344,2019-06-18,Senate,"Senate Rules Committee Vote",19,0,0,0,19
1268916,886345,2019-06-19,Senate,"Senate Floor Vote - Final Passage",62,0,0,0,62
1268916,886346,2019-06-21,Assembly,"Assembly Floor Vote - Final Passage",144,0,0,6,150
1268921,882611,2019-06-17,Assembly,"Assembly Codes Committee: Favorable refer to committee Ways and Means",16,4,0,2,22
1268921,883580,2019-06-18,Assembly,"Assembly Rules Committee: Favorable",19,6,0,6,31
1268921,883581,2019-06-18,Assembly,"Assembly Ways And Means Committee: Favorable refer to committee Rules",27,6,0,2,35
1268921,884925,2019-06-19,Assembly,"Assembly Floor Vote - Final Passage",128,20,0,2,150
1268921,886628,2019-06-19,Senate,"Senate Floor Vote - Final Passage",62,0,0,0,62
1268922,885282,2019-06-19,Assembly,"Assembly Floor Vote - Final Passage",135,13,0,2,150
1268922,886556,2019-06-18,Senate,"Senate Rules Committee Vote",16,3,0,0,19
1268922,886557,2019-06-19,Senate,"Senate Floor Vote - Final Passage",59,3,0,0,62
1268925,882793,2019-06-17,Assembly,"Assembly Real Property Taxation Committee: Favorable refer to committee Codes",10,0,0,0,10
1268925,883777,2019-06-18,Assembly,"Assembly Codes Committee: Favorable refer to committee Ways and Means",22,0,0,0,22
1268927,885900,2019-06-18,Senate,"Senate Floor Vote - Final Passage",62,0,0,0,62
1268927,886237,2019-06-21,Assembly,"Assembly Floor Vote - Final Passage",119,24,0,7,150
1268927,886701,2019-06-18,Senate,"Senate Rules Committee Vote",19,0,0,0,19
1268928,882879,2019-06-17,Assembly,"Assembly Codes Committee: Favorable refer to committee Rules",14,6,0,2,22
1268934,886551,2019-06-18,Senate,"Senate Rules Committee Vote",11,8,0,0,19
1268934,886552,2019-06-20,Senate,"Senate Floor Vote - Final Passage",38,24,0,0,62
1268936,885171,2019-06-19,Senate,"Senate Rules Committee Vote",19,0,0,0,19
1268936,885172,2019-06-19,Assembly,"Assembly Floor Vote - Final Passage",147,0,0,3,150
1268936,886474,2019-06-19,Senate,"Senate Floor Vote - Final Passage",62,0,0,0,62
1268945,885170,2019-06-19,Senate,"Senate Rules Committee Vote",15,4,0,0,19
1268945,886586,2019-06-19,Senate,"Senate Floor Vote - Final Passage",47,15,0,0,62
1268949,885084,2019-06-19,Senate,"Senate Rules Committee Vote",18,1,0,0,19
1268949,886354,2019-06-19,Senate,"Senate Floor Vote - Final Passage",57,5,0,0,62
1268949,886355,2019-06-21,Assembly,"Assembly Floor Vote - Final Passage",101,35,0,14,150
1268958,972928,2020-07-20,Senate,"Senate Investigations and Government Operations Committee Vote",5,1,0,0,6
1268958,972929,2020-07-21,Senate,"Senate Finance Committee Vote",20,3,0,0,23
1268958,973206,2020-07-22,Assembly,"Assembly Floor Vote - Final Passage",101,41,0,3,145
1268958,973566,2020-07-22,Senate,"Senate Floor Vote - Final Passage",43,17,0,0,60
1268958,973944,2020-07-21,Senate,"Senate Finance Committee Vote",20,3,0,0,23
1268960,882644,2019-06-17,Assembly,"Assembly Real Property Taxation Committee: Favorable refer to committee Ways and Means",10,0,0,0,10
1268960,883768,2019-06-18,Assembly,"Assembly Ways And Means Committee: Favorable refer to committee Rules",33,0,0,2,35
1268971,885711,2019-06-19,Senate,"Senate Rules Committee Vote",14,5,0,0,19
1268971,886635,2019-06-19,Senate,"Senate Floor Vote - Final Passage",43,19,0,0,62
1268971,886636,2019-06-20,Assembly,"Assembly Floor Vote - Final Passage",144,0,0,6,150
1268987,884952,2019-06-19,Assembly,"Assembly Floor Vote - Final Passage",143,5,0,2,150
1268987,886485,2019-06-18,Senate,"Senate Rules Committee Vote",19,0,0,0,19
1268987,886486,2019-06-19,Senate,"Senate Floor Vote - Final Passage",62,0,0,0,62
1268996,904768,2020-01-21,Senate,"Senate Crime Victims, Crime and Correction Committee Vote",7,0,0,0,7
1268998,884879,2019-06-19,Assembly,"Assembly Codes Committee: Favorable refer to committee Rules",15,7,0,0,22
1268998,885212,2019-06-20,Assembly,"Assembly Rules Committee: Favorable",19,8,0,4,31
1269000,904825,2020-01-22,Assembly,"Assembly Health Committee: Favorable refer to committee Ways and Means",25,0,0,1,26
1269004,886618,2019-06-20,Senate,"Senate Floor Vote - Final Passage",39,23,0,0,62
1269004,886619,2019-06-21,Assembly,"Assembly Floor Vote - Final Passage",94,44,0,12,150
1269004,887128,2019-06-20,Senate,"Senate Rules Committee Vote",12,7,0,0,19
1269008,885145,2019-06-19,Senate,"Senate Rules Committee Vote",19,0,0,0,19
1269008,886197,2019-06-21,Assembly,"Assembly Floor Vote - Final Passage",144,0,0,6,150
1269008,886667,2019-06-19,Senate,"Senate Floor Vote - Final Passage",62,0,0,0,62
1269011,883657,2019-06-18,Assembly,"Assembly Rules Committee: Favorable",25,0,0,6,31
1269011,883658,2019-06-18,Assembly,"Assembly Ways And Means Committee: Favorable refer to committee Rules",25,7,1,2,35
1269015,883665,2019-06-18,Assembly,"Assembly Rules Committee: Favorable",18,7,0,6,31
1269015,883666,2019-06-18,Assembly,"Assembly Ways And Means Committee: Favorable refer to committee Rules",22,11,0,2,35
1269015,884990,2019-06-19,Assembly,"Assembly Floor Vote - Final Passage",94,54,0,2,150
1269015,886722,2019-06-19,Senate,"Senate Floor Vote - Final Passage",40,22,0,0,62
1269019,971424,2020-07-16,Assembly,"Assembly Transportation Committee: Favorable refer to committee Ways and Means",22,0,0,2,24
1269019,971841,2020-07-17,Assembly,"Assembly Ways And Means Committee: Favorable refer to committee Rules",32,0,0,2,34
1269019,972548,2020-07-21,Assembly,"Assembly Floor Vote - Final Passage",142,0,0,3,145
1269019,972549,2020-07-21,Assembly,"Assembly Rules Committee: Favorable",26,0,0,4,30
1269019,973703,2020-07-23,Senate,"Senate Floor Vote - Final Passage",60,0,0,0,60
1269033,883284,2019-06-18,Assembly,"Assembly Education Committee: Favorable refer to committee Ways and Means",29,0,0,2,31
1269033,883687,2019-06-18,Assembly,"Assembly Ways And Means Committee: Favorable refer to committee Rules",33,0,0,2,35
1269033,884949,2019-06-19,Assembly,"Assembly Rules Committee: Favorable",27,0,0,4,31
1269042,886238,2019-06-20,Assembly,"Assembly Floor Vote - Final Passage",145,0,0,5,150
1269042,886699,2019-06-20,Senate,"Senate Floor Vote - Final Passage",45,17,0,0,62
1269042,887403,2019-06-19,Senate,"Senate Rules Committee Vote",16,3,0,0,19
1269061,886284,2019-06-21,Assembly,"Assembly Floor Vote - Final Passage",139,1,0,10,150
1269061,886767,2019-06-20,Senate,"Senate Floor Vote - Final Passage",62,0,0,0,62
1269061,887371,2019-06-19,Senate,"Senate Rules Committee Vote",19,0,0,0,19
1269088,883920,2019-06-18,Assembly,"Assembly Ways And Means Committee: Favorable refer to committee Rules",29,4,0,2,35
1269088,883921,2019-06-18,Assembly,"Assembly Codes Committee: Favorable refer to committee Ways and Means",18,4,0,0,22
1269088,884955,2019-06-19,Assembly,"Assembly Rules Committee: Favorable",27,0,0,4,31
1269110,884823,2019-06-19,Assembly,"Assembly Ways And Means Committee: Favorable refer to committee Rules",33,0,0,2,35
1269110,885255,2019-06-20,Assembly,"Assembly Rules Committee: Favorable",27,0,0,4,31
1269110,886241,2019-06-21,Assembly,"Assembly Floor Vote - Final Passage",139,0,0,11,150
1269127,884983,2019-06-20,Assembly,"Assembly Floor Vote - Final Passage",111,35,0,4,150
1269127,885934,2019-06-18,Senate,"Senate Floor Vote - Final Passage",41,21,0,0,62
1269127,886406,2019-06-18,Senate,"Senate Rules Committee Vote",16,3,0,0,19
1269136,885340,2019-06-19,Senate,"Senate Rules Committee Vote",19,0,0,0,19
1269136,886331,2019-06-21,Assembly,"Assembly Floor Vote - Final Passage",144,0,0,6,150
1269136,886784,2019-06-20,Senate,"Senate Floor Vote - Final Passage",62,0,0,0,62
1269139,933679,2020-02-25,Assembly,"Assembly Housing Committee: Favorable refer to committee Ways and Means",26,0,0,2,28
1269142,884675,2019-06-19,Assembly,"Assembly Rules Committee: Favorable",22,6,0,3,31
1269142,884676,2019-06-19,Assembly,"Assembly Rules Committee: Favorable",20,8,0,3,31
1269142,884677,2019-06-19,Assembly,"Assembly Ways And Means Committee: Favorable refer to committee Rules",23,10,0,2,35
1269147,886271,2019-06-18,Senate,"Senate Rules Committee Vote",17,2,0,0,19
1269147,886272,2019-06-21,Assembly,"Assembly Floor Vote - Final Passage",136,2,0,12,150
1269147,886727,2019-06-20,Senate,"Senate Floor Vote - Final Passage",62,0,0,0,62
1269153,884812,2019-06-19,Assembly,"Assembly Ways And Means Committee: Favorable refer to committee Rules",32,1,0,2,35
1269153,885239,2019-06-20,Assembly,"Assembly Rules Committee: Favorable",27,0,0,4,31
1269184,964320,2020-06-09,Senate,"Senate Floor Vote - Final Passage",60,2,0,0,62
1269184,964508,2020-06-09,Assembly,"Assembly Floor Vote - Final Passage",109,35,0,3,147
1269184,966196,2020-05-28,Senate,"Senate Rules Committee Vote",18,1,0,0,19
1269299,902681,2020-01-13,Senate,"Senate Transportation Committee Vote",15,0,0,0,15
1269299,902682,2020-01-13,Senate,"Senate Rules Committee Vote",19,0,0,0,19
1269299,902683,2020-01-14,Senate,"Senate Floor Vote - Final Passage",60,0,0,2,62
1269489,964157,2020-06-09,Senate,"Senate Floor Vote - Final Passage",60,2,0,0,62
1269489,966383,2020-05-28,Senate,"Senate Rules Committee Vote",19,0,0,0,19
1269489,966384,2020-06-08,Senate,"Senate Local Government Committee Vote",7,0,0,0,7
1269798,886213,2019-06-20,Assembly,"Assembly Rules Committee: Favorable",26,1,0,4,31
1269798,886214,2019-06-20,Assembly,"Assembly Rules Committee: Favorable",19,8,0,4,31
1269798,886215,2019-06-20,Assembly,"Assembly Ways And Means Committee: Favorable refer to committee Rules",32,1,0,2,35
1269799,886217,2019-06-21,Assembly,"Assembly Floor Vote - Final Passage",97,38,0,15,150
1269799,886690,2019-06-20,Senate,"Senate Floor Vote - Final Passage",40,22,0,0,62
1269803,886218,2019-06-20,Assembly,"Assembly Rules Committee: Favorable",19,8,0,4,31
1269803,886219,2019-06-20,Assembly,"Assembly Rules Committee: Favorable",19,8,0,4,31
1269803,886220,2019-06-20,Assembly,"Assembly Ways And Means Committee: Favorable refer to committee Rules",21,12,0,2,35
1269812,886221,2019-06-21,Assembly,"Assembly Floor Vote - Final Passage",129,6,0,15,150
1269812,886685,2019-06-20,Senate,"Senate Floor Vote - Final Passage",59,3,0,0,62
1269820,886224,2019-06-20,Assembly,"Assembly Rules Committee: Favorable",20,7,0,4,31
1269820,886225,2019-06-20,Assembly,"Assembly Rules Committee: Favorable",19,8,0,4,31
1269820,886226,2019-06-20,Assembly,"Assembly Ways And Means Committee: Favorable refer to committee Rules",24,9,0,2,35
1269822,886227,2019-06-21,Assembly,"Assembly Floor Vote - Final Passage",94,43,0,13,150
1269822,886683,2019-06-20,Senate,"Senate Floor Vote - Final Passage",40,22,0,0,62
1269822,887359,2019-06-20,Senate,"Senate Rules Committee Vote",12,7,0,0,19
1270975,935896,2020-02-25,Assembly,"Assembly Judiciary Committee: Favorable refer to committee Ways and Means",15,4,0,2,21
1271003,950507,2020-03-10,Assembly,"Assembly Transportation Committee: Held for Consideration",17,8,0,0,25
1271020,902596,2020-01-14,Assembly,"Assembly Rules Committee: Favorable",25,0,0,5,30
1271020,902597,2020-01-14,Assembly,"Assembly Codes Committee: Favorable refer to committee Rules",20,0,0,1,21
1271020,902598,2020-01-14,Assembly,"Assembly Transportation Committee: Favorable refer to committee Codes",24,0,0,1,25
1271020,902801,2020-01-14,Senate,"Senate Floor Vote - Final Passage",60,0,0,2,62
1271020,903059,2020-01-14,Assembly,"Assembly Floor Vote - Final Passage",140,0,0,8,148
1271059,971326,2020-07-14,Assembly,"Assembly Higher Education Committee: Held for Consideration",18,7,0,0,25
1271217,906909,2020-01-28,Senate,"Senate Education Committee Vote",9,6,0,0,15
1272710,971124,2020-07-14,Assembly,"Assembly Judiciary Committee: Favorable refer to committee Rules",15,6,0,0,21
1272710,972226,2020-07-20,Assembly,"Assembly Rules Committee: Favorable",20,7,0,3,30
1272710,973182,2020-07-22,Assembly,"Assembly Floor Vote - Final Passage",94,48,0,3,145
1272718,972129,2020-07-17,Assembly,"Assembly Codes Committee: Held for Consideration",15,6,0,1,22
1272728,971156,2020-07-14,Assembly,"Assembly Correction Committee: Held for Consideration",10,2,0,1,13
1272746,904378,2020-01-22,Assembly,"Assembly Governmental Operations Committee: Favorable",13,1,0,0,14
1272771,970900,2020-07-13,Assembly,"Assembly Corporations, Authorities And Commissions Committee: Favorable refer to committee Ways and Means",23,3,0,0,26
1272771,971835,2020-07-17,Assembly,"Assembly Ways And Means Committee: Favorable refer to committee Rules",32,0,0,2,34
1272771,972170,2020-07-20,Assembly,"Assembly Rules Committee: Favorable",27,0,0,3,30
1272771,972327,2020-07-20,Assembly,"Assembly Floor Vote - Final Passage",141,0,0,4,145
1272771,973548,2020-07-23,Senate,"Senate Floor Vote - Final Passage",57,3,0,0,60
1272772,971702,2020-07-16,Assembly,"Assembly Governmental Employees Committee: Favorable refer to committee Ways and Means",14,0,0,0,14
1272772,971754,2020-07-17,Assembly,"Assembly Ways And Means Committee: Favorable refer to committee Rules",31,1,0,2,34
1272772,972891,2020-07-22,Assembly,"Assembly Rules Committee: Favorable",29,0,0,1,30
1272780,971115,2020-07-14,Assembly,"Assembly Judiciary Committee: Favorable refer to committee Codes",15,6,0,0,21
1272780,971836,2020-07-17,Assembly,"Assembly Codes Committee: Favorable refer to committee Rules",15,6,0,1,22
1272780,972221,2020-07-20,Assembly,"Assembly Rules Committee: Favorable",27,0,0,3,30
1272780,973176,2020-07-22,Senate,"Senate Floor Vote - Final Passage",42,18,0,0,60
1272780,973177,2020-07-22,Assembly,"Assembly Floor Vote - Final Passage",100,42,0,3,145
1272830,972404,2020-01-14,Senate,"Senate Education Committee Vote",15,0,0,0,15
1272830,972405,2020-07-21,Senate,"Senate Floor Vote - Final Passage",59,1,0,0,60
1272920,970740,2020-07-13,Assembly,"Assembly Health Committee: Favorable refer to committee Ways and Means",24,0,0,2,26
1272920,972902,2020-07-22,Assembly,"Assembly Rules Committee: Favorable",29,0,0,1,30
1272920,972903,2020-07-22,Assembly,"Assembly Ways And Means Committee: Favorable refer to committee Rules",32,0,0,2,34
1272940,915181,2020-01-13,Senate,"Senate Alcoholism and Substance Abuse Committee Vote",7,0,0,0,7
1272940,915182,2020-02-04,Senate,"Senate Floor Vote - Final Passage",54,7,0,1,62
1272986,907430,2020-01-28,Senate,"Senate Investigations and Government Operations Committee Vote",7,0,0,0,7
1272986,935254,2020-02-25,Senate,"Senate Finance Committee Vote",22,0,0,1,23
1272986,940078,2020-03-02,Senate,"Senate Floor Vote - Final Passage",61,0,0,1,62
1273114,973209,2020-07-22,Assembly,"Assembly Floor Vote - Final Passage",142,0,0,3,145
1273114,973574,2020-07-22,Senate,"Senate Floor Vote - Final Passage",60,0,0,0,60
1273114,973934,2020-07-20,Senate,"Senate Judiciary Committee Vote",15,0,0,0,15
1273114,973935,2020-07-21,Senate,"Senate Rules Committee Vote",19,0,0,0,19
1273124,922054,2020-02-11,Senate,"Senate Health Committee Vote",15,0,0,0,15
1273124,935181,2020-02-25,Senate,"Senate Finance Committee Vote",22,0,0,1,23
1273124,942013,2020-03-04,Senate,"Senate Floor Vote - Final Passage",62,0,0,0,62
1273169,970948,2020-07-13,Assembly,"Assembly Consumer Affairs And Protection Committee: Favorable refer to committee Codes",15,0,0,1,16
1273169,971894,2020-07-17,Assembly,"Assembly Codes Committee: Favorable refer to committee Rules",21,0,0,1,22
1273169,972228,2020-07-20,Assembly,"Assembly Rules Committee: Favorable",27,0,0,3,30
1273189,972911,2020-07-21,Senate,"Senate Social Services Committee Vote",7,0,0,0,7
1273189,973845,2020-07-21,Senate,"Senate Rules Committee Vote",19,0,0,0,19
1273189,973846,2020-07-22,Senate,"Senate Floor Vote - Final Passage",60,0,0,0,60
1273193,963460,2020-06-08,Assembly,"Assembly Governmental Operations Committee: Favorable refer to committee Ways and Means",14,0,0,0,14
1273193,963748,2020-06-09,Assembly,"Assembly Rules Committee: Favorable",27,0,0,4,31
1273193,963749,2020-06-09,Assembly,"Assembly Ways And Means Committee: Favorable refer to committee Rules",30,2,0,3,35
1273196,943123,2020-03-03,Senate,"Senate Higher Education Committee Vote",11,0,0,0,11
1273314,966081,2020-06-08,Senate,"Senate Floor Vote - Final Passage",62,0,0,0,62
1273314,967202,2020-05-28,Senate,"Senate Rules Committee Vote",19,0,0,0,19
1273569,972632,2020-02-10,Senate,"Senate Codes Committee Vote",12,0,0,0,12
1273569,972633,2020-07-21,Senate,"Senate Floor Vote - Final Passage",59,1,0,0,60
1273965,914893,2020-01-15,Senate,"Senate Mental Health and Developmental Disabilities Committee Vote",7,0,0,0,7
1273965,914894,2020-02-04,Senate,"Senate Floor Vote - Final Passage",61,0,0,1,62
1274023,902875,2020-01-14,Senate,"Senate Health Committee Vote",14,0,0,0,14
1274266,918819,2020-02-10,Senate,"Senate Women's Issues Committee Vote",7,0,0,0,7
1274266,935525,2020-02-25,Senate,"Senate Finance Committee Vote",22,0,0,1,23
1274266,942495,2020-03-04,Senate,"Senate Floor Vote - Final Passage",62,0,0,0,62
1274478,971466,2020-07-16,Assembly,"Assembly Transportation Committee: Held for Consideration",16,6,0,2,24
1274488,972962,2020-07-21,Senate,"Senate Finance Committee Vote",23,0,0,0,23
1274488,973510,2020-07-22,Senate,"Senate Floor Vote - Final Passage",60,0,0,0,60
1274488,973835,2020-07-21,Senate,"Senate Finance Committee Vote",23,0,0,0,23
1274491,971102,2020-07-14,Assembly,"Assembly Environmental Conservation Committee: Held for Consideration",19,8,0,1,28
1274536,965150,2020-03-03,Senate,"Senate Finance Committee Vote",22,1,0,0,23
1274536,965151,2020-06-09,Senate,"Senate Floor Vote - Final Passage",62,0,0,0,62
1274536,965152,2020-06-09,Assembly,"Assembly Floor Vote - Final Passage",144,0,0,3,147
1274558,934353,2020-02-25,Assembly,"Assembly Governmental Employees Committee: Favorable refer to committee Ways and Means",13,0,0,1,14
1274855,907893,2020-01-14,Senate,"Senate Judiciary Committee Vote",15,0,0,0,15
1274855,907894,2020-01-28,Senate,"Senate Floor Vote - Final Passage",61,1,0,0,62
1274866,906831,2020-01-13,Senate,"Senate Insurance Committee Vote",11,0,0,0,11
1274866,906832,2020-01-28,Senate,"Senate Floor Vote - Final Passage",61,1,0,0,62
1274872,906925,2020-01-14,Senate,"Senate Labor Committee Vote",13,0,0,0,13
1274872,906926,2020-01-28,Senate,"Senate Floor Vote - Final Passage",62,0,0,0,62
1274893,907501,2020-01-13,Senate,"Senate Codes Committee Vote",13,0,0,0,13
1274893,907502,2020-01-28,Senate,"Senate Floor Vote - Final Passage",60,2,0,0,62
1275227,973631,2020-03-03,Senate,"Senate Investigations and Government Operations Committee Vote",7,0,0,0,7
1275227,973632,2020-07-23,Senate,"Senate Floor Vote - Final Passage",60,0,0,0,60
1275876,901693,2020-01-08,Senate,"Senate Floor Vote - Final Passage",40,20,0,2,62
1275876,901694,2020-01-09,Senate,"Senate Floor Vote - Final Passage",40,20,0,2,62
1275876,901945,2020-01-09,Senate,"Senate Elections Committee Vote",5,2,0,0,7
1275876,901946,2020-01-09,Senate,"Senate Rules Committee Vote",13,5,0,1,19
1276010,974124,2020-07-22,Senate,"Senate Rules Committee Vote",19,0,0,0,19
1276010,974125,2020-07-23,Senate,"Senate Floor Vote - Final Passage",57,3,0,0,60
1276051,964580,2020-06-10,Assembly,"Assembly Rules Committee: Favorable",28,0,0,3,31
1276051,964581,2020-06-10,Assembly,"Assembly Ways And Means Committee: Favorable refer to committee Rules",31,0,0,4,35
1276059,950521,2020-03-10,Assembly,"Assembly Governmental Operations Committee: Favorable",14,0,0,0,14
1276059,965174,2020-06-09,Assembly,"Assembly Floor Vote - Final Passage",143,1,0,3,147
1276059,965175,2020-06-10,Senate,"Senate Floor Vote - Final Passage",54,8,0,0,62
1276066,971295,2020-07-14,Assembly,"Assembly Election Law Committee: Favorable refer to committee Ways and Means",14,2,0,0,16
1276066,971881,2020-07-17,Assembly,"Assembly Ways And Means Committee: Favorable refer to committee Rules",27,5,0,2,34
1276066,973303,2020-07-23,Assembly,"Assembly Rules Committee: Favorable",23,5,0,2,30
1276069,914368,2020-02-04,Assembly,"Assembly Transportation Committee: Favorable refer to committee Codes",24,0,0,1,25
1276069,934962,2020-02-25,Assembly,"Assembly Codes Committee: Favorable",21,0,0,1,22
1276069,940700,2020-03-02,Assembly,"Assembly Floor Vote - Final Passage",138,0,0,9,147
1276069,973567,2020-07-22,Senate,"Senate Floor Vote - Final Passage",57,3,0,0,60
1276079,963819,2020-06-09,Assembly,"Assembly Rules Committee: Favorable",27,0,0,4,31
1276079,963820,2020-06-09,Assembly,"Assembly Ways And Means Committee: Favorable refer to committee Rules",32,0,0,3,35
1276092,971766,2020-07-17,Assembly,"Assembly Codes Committee: Held for Consideration",15,6,0,1,22
1276094,950510,2020-03-10,Assembly,"Assembly Transportation Committee: Held for Consideration",18,7,0,0,25
1276116,971296,2020-07-15,Assembly,"Assembly Social Services Committee: Favorable refer to committee Ways and Means",17,0,0,0,17
1276116,971839,2020-07-17,Assembly,"Assembly Ways And Means Committee: Favorable refer to committee Rules",32,0,0,2,34
1276116,972577,2020-07-21,Assembly,"Assembly Floor Vote - Final Passage",142,0,0,3,145
1276116,972578,2020-07-21,Assembly,"Assembly Rules Committee: Favorable",26,0,0,4,30
1276116,973707,2020-07-23,Senate,"Senate Floor Vote - Final Passage",60,0,0,0,60
1276242,902736,2020-01-14,Senate,"Senate Health Committee Vote",14,0,0,0,14
1276283,964125,2020-06-09,Senate,"Senate Floor Vote - Final Passage",62,0,0,0,62
1276283,964740,2020-06-09,Assembly,"Assembly Floor Vote - Final Passage",144,0,0,3,147
1276283,966356,2020-05-28,Senate,"Senate Rules Committee Vote",19,0,0,0,19
1276283,966357,2020-06-08,Senate,"Senate Local Government Committee Vote",7,0,0,0,7
1276658,907394,2020-01-28,Senate,"Senate Investigations and Government Operations Committee Vote",7,0,0,0,7
1276658,935277,2020-02-25,Senate,"Senate Finance Committee Vote",22,0,0,1,23
1276658,940362,2020-03-02,Senate,"Senate Floor Vote - Final Passage",61,0,0,1,62
1277565,922857,2020-02-10,Senate,"Senate Higher Education Committee Vote",11,0,0,0,11
1277565,922858,2020-02-13,Senate,"Senate Floor Vote - Final Passage",53,4,0,5,62
1277605,949121,2020-03-03,Senate,"Senate Commerce, Economic Development and Small Business Committee Vote",9,0,0,0,9
1277605,949122,2020-03-11,Senate,"Senate Floor Vote - Final Passage",58,0,0,4,62
1277605,972981,2020-07-21,Assembly,"Assembly Floor Vote - Final Passage",142,0,0,3,145
1277608,971615,2020-07-16,Assembly,"Assembly Governmental Operations Committee: Held for Consideration",10,4,0,0,14
1277619,935243,2020-02-25,Assembly,"Assembly Aging Committee: Favorable refer to committee Ways and Means",30,0,0,0,30
1277634,971247,2020-07-14,Assembly,"Assembly Education Committee: Held for Consideration",23,6,0,2,31
1277651,971219,2020-07-14,Assembly,"Assembly Correction Committee: Held for Consideration",10,2,0,1,13
1277656,963795,2020-06-09,Assembly,"Assembly Rules Committee: Favorable",27,0,0,4,31
1277656,963796,2020-06-09,Assembly,"Assembly Ways And Means Committee: Favorable refer to committee Rules",32,0,0,3,35
1277657,970821,2020-07-13,Assembly,"Assembly Health Committee: Held for Consideration",17,7,0,2,26
1277675,963812,2020-06-09,Assembly,"Assembly Rules Committee: Favorable",27,0,0,4,31
1277675,963813,2020-06-09,Assembly,"Assembly Ways And Means Committee: Favorable refer to committee Rules",27,5,0,3,35
1277675,964644,2020-06-09,Assembly,"Assembly Floor Vote - Final Passage",132,12,0,3,147
1277675,964645,2020-06-10,Senate,"Senate Floor Vote - Final Passage",61,1,0,0,62
1277678,963394,2020-06-08,Assembly,"Assembly Governmental Operations Committee: Favorable refer to committee Codes",13,1,0,0,14
1277678,963452,2020-06-08,Assembly,"Assembly Codes Committee: Favorable refer to committee Rules",21,0,0,1,22
1277678,963453,2020-06-08,Assembly,"Assembly Rules Committee: Favorable",24,2,0,5,31
1277926,904592,2020-01-22,Senate,"Senate Committee Vote",7,0,0,0,7
1277945,901695,2020-01-08,Senate,"Senate Floor Vote - Final Passage",42,18,0,2,62
1277945,901696,2020-01-09,Senate,"Senate Floor Vote - Final Passage",42,18,0,2,62
1277945,901901,2020-01-09,Senate,"Senate Elections Committee Vote",7,0,0,0,7
1277945,901902,2020-01-09,Senate,"Senate Rules Committee Vote",14,4,0,1,19
1278150,935161,2020-02-25,Senate,"Senate Cultural Affairs, Tourism, Parks and Recreation Committee Vote",7,0,0,0,7
1278607,964057,2020-06-09,Senate,"Senate Floor Vote - Final Passage",62,0,0,0,62
1278607,964710,2020-06-09,Assembly,"Assembly Floor Vote - Final Passage",144,0,0,3,147
1278607,966296,2020-05-28,Senate,"Senate Rules Committee Vote",19,0,0,0,19
1278607,966297,2020-06-08,Senate,"Senate Transportation Committee Vote",15,0,0,0,15
1278853,972606,2020-07-20,Senate,"Senate Environmental Conservation Committee Vote",11,0,0,0,11
1278853,973399,2020-07-23,Assembly,"Assembly Floor Vote - Final Passage",116,25,0,4,145
1278853,973686,2020-07-22,Senate,"Senate Floor Vote - Final Passage",49,11,0,0,60
1278853,973982,2020-07-21,Senate,"Senate Rules Committee Vote",17,2,0,0,19
1278857,972766,2020-03-03,Senate,"Senate Investigations and Government Operations Committee Vote",7,0,0,0,7
1278857,972767,2020-07-21,Senate,"Senate Floor Vote - Final Passage",53,7,0,0,60
1279240,950870,2020-03-10,Senate,"Senate Energy and Telecommunications Committee Vote",9,0,0,0,9
1279571,973649,2020-07-22,Senate,"Senate Floor Vote - Final Passage",57,3,0,0,60
1279571,973781,2020-07-20,Senate,"Senate Transportation Committee Vote",15,0,0,0,15
1279571,973782,2020-07-21,Senate,"Senate Rules Committee Vote",18,1,0,0,19
1280619,964104,2020-06-09,Senate,"Senate Floor Vote - Final Passage",62,0,0,0,62
1280619,964728,2020-06-09,Assembly,"Assembly Floor Vote - Final Passage",144,0,0,3,147
1280619,966305,2020-05-28,Senate,"Senate Rules Committee Vote",19,0,0,0,19
1280619,966306,2020-06-08,Senate,"Senate Finance Committee Vote",23,0,0,0,23
1285120,943206,2020-03-03,Senate,"Senate Environmental Conservation Committee Vote",11,0,0,0,11
1285194,973840,2020-07-21,Senate,"Senate Rules Committee Vote",19,0,0,0,19
1285194,973841,2020-07-22,Senate,"Senate Floor Vote - Final Passage",60,0,0,0,60
1285206,938371,2020-01-27,Senate,"Senate Local Government Committee Vote",7,0,0,0,7
1285206,938372,2020-02-27,Senate,"Senate Floor Vote - Final Passage",58,1,0,3,62
1285206,965418,2020-06-10,Assembly,"Assembly Floor Vote - Final Passage",144,0,0,3,147
1285249,971367,2020-07-15,Assembly,"Assembly Social Services Committee: Favorable refer to committee Ways and Means",12,5,0,0,17
1285249,972859,2020-07-22,Assembly,"Assembly Ways And Means Committee: Favorable refer to committee Rules",29,3,0,2,34
1285249,973112,2020-07-22,Assembly,"Assembly Rules Committee: Favorable",22,7,0,1,30
1285249,973541,2020-07-23,Assembly,"Assembly Floor Vote - Final Passage",110,31,0,4,145
1285264,933509,2020-02-25,Assembly,"Assembly Agriculture Committee: Favorable refer to committee Codes",18,1,0,2,21
1285264,940774,2020-03-03,Assembly,"Assembly Codes Committee: Favorable",21,0,0,1,22
1285275,971376,2020-07-15,Assembly,"Assembly Tourism, Arts And Sports Development Committee: Favorable refer to committee Ways and Means",14,6,0,0,20
1285278,973297,2020-07-23,Assembly,"Assembly Rules Committee: Favorable",28,0,0,2,30
1285278,973298,2020-07-23,Assembly,"Assembly Ways And Means Committee: Favorable refer to committee Rules",33,0,0,1,34
1285278,973422,2020-07-23,Assembly,"Assembly Floor Vote - Final Passage",141,0,0,4,145
1285291,922170,2020-02-11,Assembly,"Assembly Local Governments Committee: Favorable refer to committee Ways and Means",18,0,0,0,18
1285299,971210,2020-07-14,Assembly,"Assembly Insurance Committee: Held for Consideration",14,6,0,2,22
1285302,971437,2020-07-16,Assembly,"Assembly Transportation Committee: Favorable refer to committee Ways and Means",22,0,0,2,24
1285302,971846,2020-07-17,Assembly,"Assembly Ways And Means Committee: Favorable refer to committee Rules",32,0,0,2,34
1285302,972166,2020-07-20,Assembly,"Assembly Rules Committee: Favorable",27,0,0,3,30
1285302,972311,2020-07-20,Assembly,"Assembly Floor Vote - Final Passage",141,0,0,4,145
1285302,973501,2020-07-22,Senate,"Senate Floor Vote - Final Passage",59,1,0,0,60
1285316,963821,2020-06-09,Assembly,"Assembly Rules Committee: Favorable",27,0,0,4,31
1285316,963822,2020-06-09,Assembly,"Assembly Ways And Means Committee: Favorable refer to committee Rules",32,0,0,3,35
1285334,906740,2020-01-28,Assembly,"Assembly Real Property Taxation Committee: Favorable refer to committee Ways and Means",10,0,0,0,10
1285354,963732,2020-06-09,Assembly,"Assembly Rules Committee: Favorable",27,0,0,4,31
1285354,963733,2020-06-09,Assembly,"Assembly Ways And Means Committee: Favorable refer to committee Rules",32,0,0,3,35
1285358,963789,2020-06-09,Assembly,"Assembly Rules Committee: Favorable",27,0,0,4,31
1285358,963790,2020-06-09,Assembly,"Assembly Ways And Means Committee: Favorable refer to committee Rules",32,0,0,3,35
1285362,970929,2020-07-13,Assembly,"Assembly Consumer Affairs And Protection Committee: Favorable refer to committee Rules",15,0,0,1,16
1285362,972196,2020-07-20,Assembly,"Assembly Rules Committee: Favorable",27,0,0,3,30
1285362,973150,2020-07-22,Assembly,"Assembly Floor Vote - Final Passage",140,2,0,3,145
1285362,973674,2020-07-23,Senate,"Senate Floor Vote - Final Passage",60,0,0,0,60
1285379,972853,2020-07-22,Assembly,"Assembly Ways And Means Committee: Favorable refer to committee Rules",25,7,0,2,34
1285379,973013,2020-07-22,Assembly,"Assembly Rules Committee: Favorable",27,2,0,1,30
1285386,971408,2020-07-16,Assembly,"Assembly Transportation Committee: Favorable refer to committee Codes",21,1,0,2,24
1285386,971740,2020-07-17,Assembly,"Assembly Ways And Means Committee: Favorable refer to committee Rules",24,8,0,2,34
1285386,971741,2020-07-17,Assembly,"Assembly Codes Committee: Favorable refer to committee Ways and Means",19,2,0,1,22
1285387,963804,2020-06-09,Assembly,"Assembly Rules Committee: Favorable",27,0,0,4,31
1285387,963805,2020-06-09,Assembly,"Assembly Ways And Means Committee: Favorable refer to committee Rules",30,2,0,3,35
1285387,964632,2020-06-09,Assembly,"Assembly Floor Vote - Final Passage",140,4,0,3,147
1285409,964821,2020-02-25,Senate,"Senate Judiciary Committee Vote",13,1,0,1,15
1285409,964822,2020-06-09,Senate,"Senate Floor Vote - Final Passage",62,0,0,0,62
1285409,964823,2020-06-09,Assembly,"Assembly Floor Vote - Final Passage",144,0,0,3,147
1285423,973563,2020-07-22,Senate,"Senate Floor Vote - Final Passage",59,1,0,0,60
1285423,973564,2020-07-23,Assembly,"Assembly Floor Vote - Final Passage",141,0,0,4,145
1285423,973925,2020-07-20,Senate,"Senate Judiciary Committee Vote",14,1,0,0,15
1285423,973926,2020-07-21,Senate,"Senate Rules Committee Vote",18,1,0,0,19
1285428,920219,2020-02-11,Assembly,"Assembly Higher Education Committee: Favorable refer to committee Codes",23,0,0,1,24
1285428,933504,2020-02-25,Assembly,"Assembly Codes Committee: Favorable refer to committee Ways and Means",21,0,0,1,22
1285429,971539,2020-07-16,Assembly,"Assembly Governmental Operations Committee: Held for Consideration",10,4,0,0,14
1285434,950511,2020-03-10,Assembly,"Assembly Transportation Committee: Favorable refer to committee Ways and Means",25,0,0,0,25
1286576,915324,2020-01-28,Senate,"Senate Education Committee Vote",12,3,0,0,15
1286576,915325,2020-02-05,Senate,"Senate Floor Vote - Final Passage",42,19,0,1,62
1286588,972310,2020-07-20,Senate,"Senate Local Government Committee Vote",7,0,0,0,7
1286588,973363,2020-07-22,Senate,"Senate Rules Committee Vote",19,0,0,0,19
1286588,973544,2020-07-22,Senate,"Senate Floor Vote - Final Passage",60,0,0,0,60
1286599,915552,2020-01-28,Senate,"Senate Investigations and Government Operations Committee Vote",7,0,0,0,7
1286599,915553,2020-02-05,Senate,"Senate Floor Vote - Final Passage",54,7,0,1,62
1286664,972658,2020-07-21,Senate,"Senate Elections Committee Vote",7,0,0,0,7
1286664,973284,2020-07-22,Senate,"Senate Rules Committee Vote",13,6,0,0,19
1286664,973459,2020-07-22,Senate,"Senate Floor Vote - Final Passage",42,18,0,0,60
1288103,915499,2020-01-22,Senate,"Senate Finance Committee Vote",20,3,0,0,23
1288103,915500,2020-02-05,Senate,"Senate Floor Vote - Final Passage",45,16,0,1,62
1291829,972765,2020-07-21,Senate,"Senate Finance Committee Vote",22,1,0,0,23
1291829,974126,2020-07-21,Senate,"Senate Finance Committee Vote",22,1,0,0,23
1291829,974127,2020-07-22,Senate,"Senate Rules Committee Vote",18,1,0,0,19
1291829,974128,2020-07-23,Senate,"Senate Floor Vote - Final Passage",60,0,0,0,60
1291851,914134,2020-02-03,Senate,"Senate Agriculture Committee Vote",9,0,0,0,9
1291852,964178,2020-06-09,Senate,"Senate Floor Vote - Final Passage",62,0,0,0,62
1291852,966194,2020-05-28,Senate,"Senate Rules Committee Vote",19,0,0,0,19
1291852,966195,2020-06-08,Senate,"Senate Transportation Committee Vote",15,0,0,0,15
1291865,941935,2020-03-03,Senate,"Senate Committee Vote",7,0,0,0,7
1291871,940251,2020-02-03,Senate,"Senate Agriculture Committee Vote",9,0,0,0,9
1291871,940252,2020-03-02,Senate,"Senate Floor Vote - Final Passage",61,0,0,1,62
1291871,948936,2020-03-10,Assembly,"Assembly Floor Vote - Final Passage",129,9,0,9,147
1292166,914682,2020-02-03,Senate,"Senate Agriculture Committee Vote",9,0,0,0,9
1292175,972776,2020-07-21,Senate,"Senate Finance Committee Vote",22,1,0,0,23
1292175,974132,2020-07-21,Senate,"Senate Finance Committee Vote",22,1,0,0,23
1292175,974133,2020-07-22,Senate,"Senate Rules Committee Vote",18,1,0,0,19
1292175,974134,2020-07-23,Senate,"Senate Floor Vote - Final Passage",60,0,0,0,60
1292200,972750,2020-07-21,Senate,"Senate Finance Committee Vote",23,0,0,0,23
1292200,974116,2020-07-21,Senate,"Senate Finance Committee Vote",23,0,0,0,23
1292200,974117,2020-07-22,Senate,"Senate Rules Committee Vote",18,1,0,0,19
1292200,974118,2020-07-23,Senate,"Senate Floor Vote - Final Passage",60,0,0,0,60
1292206,902722,2020-01-14,Senate,"Senate Health Committee Vote",14,0,0,0,14
1292347,970776,2020-07-13,Assembly,"Assembly Health Committee: Held for Consideration",17,7,0,2,26
1292349,970833,2020-07-13,Assembly,"Assembly Health Committee: Held for Consideration",17,7,0,2,26
1292355,949112,2020-03-11,Assembly,"Assembly Tourism, Arts And Sports Development Committee: Favorable",20,0,0,0,20
1292384,935606,2020-02-25,Assembly,"Assembly Real Property Taxation Committee: Favorable refer to committee Ways and Means",8,0,0,2,10
1292384,972062,2020-07-17,Assembly,"Assembly Ways And Means Committee: Favorable refer to committee Rules",32,0,0,2,34
1292384,972535,2020-07-21,Assembly,"Assembly Rules Committee: Favorable",26,0,0,4,30
1292384,973033,2020-07-21,Assembly,"Assembly Floor Vote - Final Passage",142,0,0,3,145
1292408,971958,2020-07-17,Assembly,"Assembly Codes Committee: Favorable refer to committee Rules",15,6,0,1,22
1292694,964170,2020-06-09,Senate,"Senate Floor Vote - Final Passage",62,0,0,0,62
1292694,964760,2020-06-09,Assembly,"Assembly Floor Vote - Final Passage",144,0,0,3,147
1292694,966173,2020-06-08,Senate,"Senate Local Government Committee Vote",7,0,0,0,7
1292694,966385,2020-06-08,Senate,"Senate Local Government Committee Vote",7,0,0,0,7
1292700,901708,2020-01-08,Senate,"Senate Floor Vote - Final Passage",40,20,0,2,62
1292700,901709,2020-01-09,Senate,"Senate Floor Vote - Final Passage",40,20,0,2,62
1292700,901921,2020-01-09,Senate,"Senate Elections Committee Vote",5,2,0,0,7
1292700,901922,2020-01-09,Senate,"Senate Rules Committee Vote",13,5,0,1,19
1292711,941746,2020-03-03,Senate,"Senate Investigations and Government Operations Committee Vote",7,0,0,0,7
1292750,901702,2020-01-08,Senate,"Senate Floor Vote - Final Passage",40,20,0,2,62
1292750,901703,2020-01-09,Senate,"Senate Floor Vote - Final Passage",40,20,0,2,62
1292750,901911,2020-01-09,Senate,"Senate Elections Committee Vote",5,2,0,0,7
1292750,901912,2020-01-09,Senate,"Senate Rules Committee Vote",13,5,0,1,19
1292782,901704,2020-01-08,Senate,"Senate Floor Vote - Final Passage",40,20,0,2,62
1292782,901705,2020-01-09,Senate,"Senate Floor Vote - Final Passage",40,20,0,2,62
1292782,901970,2020-01-09,Senate,"Senate Elections Committee Vote",5,2,0,0,7
1292782,901971,2020-01-09,Senate,"Senate Rules Committee Vote",13,5,0,1,19
1293026,901698,2020-01-08,Senate,"Senate Floor Vote - Final Passage",40,20,0,2,62
1293026,901699,2020-01-09,Senate,"Senate Floor Vote - Final Passage",40,20,0,2,62
1293026,901972,2020-01-09,Senate,"Senate Elections Committee Vote",6,1,0,0,7
1293026,901973,2020-01-09,Senate,"Senate Rules Committee Vote",13,5,0,1,19
1293261,902648,2020-01-14,Senate,"Senate Health Committee Vote",13,1,0,0,14
1293262,919377,2020-01-21,Senate,"Senate Rules Committee Vote",19,0,0,0,19
1293262,919378,2020-02-10,Senate,"Senate Floor Vote - Final Passage",61,0,0,1,62
1293262,941974,2020-03-03,Assembly,"Assembly Floor Vote - Final Passage",140,0,0,7,147
1293271,964105,2020-06-09,Senate,"Senate Floor Vote - Final Passage",60,2,0,0,62
1293271,966359,2020-05-28,Senate,"Senate Rules Committee Vote",19,0,0,0,19
1293271,966360,2020-06-08,Senate,"Senate Local Government Committee Vote",7,0,0,0,7
1293271,973396,2020-07-23,Assembly,"Assembly Floor Vote - Final Passage",141,0,0,4,145
1293276,964183,2020-06-09,Senate,"Senate Floor Vote - Final Passage",60,2,0,0,62
1293276,965444,2020-06-10,Assembly,"Assembly Floor Vote - Final Passage",144,0,0,3,147
1293276,966192,2020-05-28,Senate,"Senate Rules Committee Vote",19,0,0,0,19
1293276,966193,2020-06-08,Senate,"Senate Local Government Committee Vote",7,0,0,0,7
1293493,972384,2020-07-20,Senate,"Senate Local Government Committee Vote",7,0,0,0,7
1293493,973339,2020-07-22,Senate,"Senate Floor Vote - Final Passage",60,0,0,0,60
1293493,973340,2020-07-22,Senate,"Senate Rules Committee Vote",19,0,0,0,19
1293648,971677,2020-07-16,Assembly,"Assembly Real Property Taxation Committee: Held for Consideration",8,2,0,0,10
1293652,971421,2020-07-16,Assembly,"Assembly Transportation Committee: Favorable refer to committee Ways and Means",22,0,0,2,24
1293652,971824,2020-07-17,Assembly,"Assembly Ways And Means Committee: Favorable refer to committee Rules",32,0,0,2,34
1293652,972886,2020-07-22,Assembly,"Assembly Rules Committee: Favorable",29,0,0,1,30
1293652,973576,2020-07-23,Assembly,"Assembly Floor Vote - Final Passage",141,0,0,4,145
1293656,963806,2020-06-09,Assembly,"Assembly Rules Committee: Favorable",27,0,0,4,31
1293656,963807,2020-06-09,Assembly,"Assembly Ways And Means Committee: Favorable refer to committee Rules",31,1,0,3,35
1293656,964630,2020-06-09,Assembly,"Assembly Floor Vote - Final Passage",143,1,0,3,147
1293656,973634,2020-07-23,Senate,"Senate Floor Vote - Final Passage",60,0,0,0,60
1293663,963736,2020-06-09,Assembly,"Assembly Rules Committee: Favorable",27,0,0,4,31
1293663,963737,2020-06-09,Assembly,"Assembly Ways And Means Committee: Favorable refer to committee Rules",31,1,0,3,35
1293663,964607,2020-06-09,Assembly,"Assembly Floor Vote - Final Passage",143,1,0,3,147
1293663,973565,2020-07-23,Senate,"Senate Floor Vote - Final Passage",60,0,0,0,60
1293666,915136,2020-02-04,Assembly,"Assembly Transportation Committee: Favorable refer to committee Ways and Means",24,0,0,1,25
1293678,963762,2020-06-09,Assembly,"Assembly Rules Committee: Favorable",27,0,0,4,31
1293678,963763,2020-06-09,Assembly,"Assembly Ways And Means Committee: Favorable refer to committee Rules",32,0,0,3,35
1293678,964494,2020-06-09,Assembly,"Assembly Floor Vote - Final Passage",144,0,0,3,147
1293690,971243,2020-07-14,Assembly,"Assembly Education Committee: Held for Consideration",23,6,0,2,31
1293698,901706,2020-01-08,Senate,"Senate Floor Vote - Final Passage",54,6,0,2,62
1293698,901707,2020-01-09,Senate,"Senate Floor Vote - Final Passage",54,6,0,2,62
1293698,901899,2020-01-09,Senate,"Senate Elections Committee Vote",7,0,0,0,7
1293698,901900,2020-01-09,Senate,"Senate Rules Committee Vote",16,2,0,1,19
1293718,963712,2020-06-09,Assembly,"Assembly Rules Committee: Favorable",27,0,0,4,31
1293718,963713,2020-06-09,Assembly,"Assembly Ways And Means Committee: Favorable refer to committee Rules",31,1,0,3,35
1293718,964562,2020-06-09,Assembly,"Assembly Floor Vote - Final Passage",143,1,0,3,147
1293718,973553,2020-07-23,Senate,"Senate Floor Vote - Final Passage",60,0,0,0,60
1293722,972845,2020-07-22,Assembly,"Assembly Codes Committee: Favorable refer to committee Rules",21,0,0,1,22
1293722,973064,2020-07-22,Assembly,"Assembly Rules Committee: Favorable",29,0,0,1,30
1293724,971269,2020-07-14,Assembly,"Assembly Education Committee: Held for Consideration",23,6,0,2,31
1293729,935648,2020-02-26,Assembly,"Assembly Veterans' Affairs Committee: Favorable refer to committee Ways and Means",18,0,0,1,19
1293729,972049,2020-07-17,Assembly,"Assembly Ways And Means Committee: Favorable refer to committee Rules",32,0,0,2,34
1293729,972583,2020-07-21,Assembly,"Assembly Floor Vote - Final Passage",142,0,0,3,145
1293729,972584,2020-07-21,Assembly,"Assembly Rules Committee: Favorable",26,0,0,4,30
1294399,970902,2020-07-13,Assembly,"Assembly Corporations, Authorities And Commissions Committee: Favorable refer to committee Codes",26,0,0,0,26
1294399,971891,2020-07-17,Assembly,"Assembly Codes Committee: Favorable refer to committee Rules",21,0,0,1,22
1294399,972556,2020-07-21,Assembly,"Assembly Floor Vote - Final Passage",142,0,0,3,145
1294399,972557,2020-07-21,Assembly,"Assembly Rules Committee: Favorable",26,0,0,4,30
1294399,973698,2020-07-22,Senate,"Senate Floor Vote - Final Passage",60,0,0,0,60
1294684,949144,2020-03-10,Senate,"Senate Health Committee Vote",11,3,0,1,15
1294697,960523,2020-05-24,Senate,"Senate Rules Committee Vote",18,1,0,0,19
1294697,960524,2020-05-26,Senate,"Senate Judiciary Committee Vote",14,1,0,0,15
1294697,960703,2020-05-27,Senate,"Senate Floor Vote - Final Passage",60,2,0,0,62
1294697,961128,2020-05-27,Assembly,"Assembly Floor Vote - Final Passage",134,10,0,3,147
1294699,907010,2020-01-13,Senate,"Senate Racing, Gaming and Wagering Committee Vote",7,0,0,0,7
1294699,907011,2020-01-28,Senate,"Senate Floor Vote - Final Passage",62,0,0,0,62
1294699,942393,2020-03-03,Assembly,"Assembly Floor Vote - Final Passage",136,3,0,8,147
1294766,906033,2020-01-13,Senate,"Senate Racing, Gaming and Wagering Committee Vote",7,0,0,0,7
1294766,906034,2020-01-27,Senate,"Senate Floor Vote - Final Passage",61,0,0,1,62
1295028,906837,2020-01-28,Assembly,"Assembly Consumer Affairs And Protection Committee: Favorable",13,0,0,3,16
1295047,914769,2020-01-14,Senate,"Senate Health Committee Vote",14,0,0,0,14
1295047,914770,2020-02-04,Senate,"Senate Floor Vote - Final Passage",53,8,0,1,62
1295055,972346,2020-07-20,Senate,"Senate Consumer Protection Committee Vote",6,0,0,0,6
1295055,973600,2020-07-22,Senate,"Senate Floor Vote - Final Passage",60,0,0,0,60
1295055,973955,2020-07-21,Senate,"Senate Rules Committee Vote",19,0,0,0,19
1295068,915236,2020-02-04,Assembly,"Assembly Banks Committee: Favorable",26,0,0,5,31
1295116,902765,2020-01-14,Senate,"Senate Education Committee Vote",15,0,0,0,15
1295128,904358,2020-01-22,Assembly,"Assembly Governmental Operations Committee: Favorable refer to committee Ways and Means",14,0,0,0,14
1295144,904383,2020-01-22,Assembly,"Assembly Governmental Operations Committee: Favorable",14,0,0,0,14
1295144,908998,2020-01-28,Assembly,"Assembly Floor Vote - Final Passage",144,0,0,4,148
1295144,913664,2020-02-03,Senate,"Senate Floor Vote - Final Passage",42,17,0,3,62
1295196,908039,2020-01-28,Assembly,"Assembly Environmental Conservation Committee: Favorable",29,0,0,1,30
1295221,934949,2020-02-25,Assembly,"Assembly Governmental Operations Committee: Favorable refer to committee Ways and Means",13,0,0,1,14
1295266,902595,2020-01-14,Assembly,"Assembly Ways And Means Committee: Favorable",33,0,0,2,35
1295266,904312,2020-01-21,Assembly,"Assembly Floor Vote - Final Passage",136,4,0,8,148
1295266,904753,2020-01-22,Senate,"Senate Floor Vote - Final Passage",40,21,0,1,62
1295272,902678,2020-01-14,Assembly,"Assembly Transportation Committee: Favorable",24,0,0,1,25
1295272,904427,2020-01-21,Assembly,"Assembly Floor Vote - Final Passage",140,0,0,8,148
1295272,919970,2020-02-11,Senate,"Senate Floor Vote - Final Passage",62,0,0,0,62
1295288,904435,2020-01-22,Assembly,"Assembly Social Services Committee: Favorable refer to committee Ways and Means",13,5,0,0,18
1295294,908374,2020-01-28,Assembly,"Assembly Veterans' Affairs Committee: Favorable",17,0,0,2,19
1295305,907965,2020-01-28,Assembly,"Assembly Environmental Conservation Committee: Favorable",29,0,0,1,30
1295327,906966,2020-01-28,Assembly,"Assembly Environmental Conservation Committee: Favorable",29,0,0,1,30
1295348,904869,2020-01-22,Assembly,"Assembly Governmental Operations Committee: Favorable refer to committee Codes",14,0,0,0,14
1295348,906947,2020-01-28,Assembly,"Assembly Codes Committee: Favorable",21,0,0,1,22
1295363,972370,2020-01-22,Senate,"Senate Civil Service and Pensions Committee Vote",7,0,0,0,7
1295363,972371,2020-07-21,Senate,"Senate Floor Vote - Final Passage",60,0,0,0,60
1295368,906940,2020-01-28,Assembly,"Assembly Environmental Conservation Committee: Favorable",29,0,0,1,30
1295368,914254,2020-02-03,Assembly,"Assembly Floor Vote - Final Passage",142,0,0,6,148
1295368,920163,2020-02-11,Senate,"Senate Floor Vote - Final Passage",62,0,0,0,62
1295379,920659,2020-02-11,Assembly,"Assembly Economic Development Committee: Favorable",23,0,0,3,26
1295402,907820,2020-01-28,Assembly,"Assembly Environmental Conservation Committee: Favorable",29,0,0,1,30
1295418,906756,2020-01-28,Assembly,"Assembly Veterans' Affairs Committee: Favorable",17,0,0,2,19
1295441,906748,2020-01-28,Assembly,"Assembly Veterans' Affairs Committee: Favorable",17,0,0,2,19
1295441,914061,2020-02-03,Assembly,"Assembly Floor Vote - Final Passage",138,4,0,6,148
1295441,915318,2020-02-05,Senate,"Senate Floor Vote - Final Passage",61,0,0,1,62
1295458,904862,2020-01-22,Assembly,"Assembly Governmental Operations Committee: Favorable",14,0,0,0,14
1295464,904845,2020-01-22,Assembly,"Assembly Governmental Operations Committee: Favorable",14,0,0,0,14
1295475,919672,2020-02-11,Assembly,"Assembly Economic Development Committee: Favorable",23,0,0,3,26
1295500,908500,2020-01-28,Assembly,"Assembly Environmental Conservation Committee: Favorable",29,0,0,1,30
1295500,913495,2020-02-03,Senate,"Senate Floor Vote - Final Passage",45,14,0,3,62
1295500,914257,2020-02-03,Assembly,"Assembly Floor Vote - Final Passage",135,7,0,6,148
1295505,907887,2020-01-28,Assembly,"Assembly Environmental Conservation Committee: Favorable",29,0,0,1,30
1295505,913679,2020-02-03,Senate,"Senate Floor Vote - Final Passage",59,0,0,3,62
1295505,914235,2020-02-03,Assembly,"Assembly Floor Vote - Final Passage",140,2,0,6,148
1295515,907001,2020-01-28,Assembly,"Assembly Environmental Conservation Committee: Favorable",29,0,0,1,30
1295630,902321,2020-01-09,Senate,"Senate Rules Committee Vote",18,0,0,1,19
1295630,902322,2020-01-13,Senate,"Senate Floor Vote - Final Passage",60,0,0,2,62
1295632,904853,2020-01-22,Assembly,"Assembly Governmental Operations Committee: Favorable",14,0,0,0,14
1295639,904456,2020-01-09,Senate,"Senate Rules Committee Vote",18,0,0,1,19
1295639,904457,2020-01-22,Senate,"Senate Floor Vote - Final Passage",61,0,0,1,62
1295639,913875,2020-02-03,Assembly,"Assembly Floor Vote - Final Passage",142,0,0,6,148
1295646,902977,2020-01-09,Senate,"Senate Rules Committee Vote",16,2,0,1,19
1295646,902978,2020-01-15,Senate,"Senate Floor Vote - Final Passage",56,5,0,1,62
1295657,921941,2020-02-11,Assembly,"Assembly Economic Development Committee: Favorable",22,1,0,3,26
1295663,902937,2020-01-09,Senate,"Senate Rules Committee Vote",18,0,0,1,19
1295663,902938,2020-01-15,Senate,"Senate Floor Vote - Final Passage",61,0,0,1,62
1295663,936900,2020-02-26,Assembly,"Assembly Floor Vote - Final Passage",141,0,0,6,147
1295666,901917,2020-01-09,Senate,"Senate Rules Committee Vote",18,0,0,1,19
1295666,901918,2020-01-13,Senate,"Senate Floor Vote - Final Passage",60,0,0,2,62
1295666,913867,2020-02-03,Assembly,"Assembly Floor Vote - Final Passage",134,7,0,7,148
1295668,935256,2020-02-25,Assembly,"Assembly Governmental Employees Committee: Favorable refer to committee Codes",13,0,0,1,14
1295668,940723,2020-03-03,Assembly,"Assembly Codes Committee: Favorable",21,0,0,1,22
1295672,914774,2020-01-14,Senate,"Senate Health Committee Vote",14,0,0,0,14
1295672,914775,2020-02-04,Senate,"Senate Floor Vote - Final Passage",61,0,0,1,62
1295672,935098,2020-02-25,Assembly,"Assembly Floor Vote - Final Passage",139,0,0,8,147
1295678,902923,2020-01-09,Senate,"Senate Rules Committee Vote",18,0,0,1,19
1295678,902924,2020-01-15,Senate,"Senate Floor Vote - Final Passage",61,0,0,1,62
1295678,915048,2020-02-04,Assembly,"Assembly Floor Vote - Final Passage",140,0,0,8,148
1295680,901967,2020-01-09,Senate,"Senate Rules Committee Vote",18,0,0,1,19
1295680,901968,2020-01-13,Senate,"Senate Floor Vote - Final Passage",59,1,0,2,62
1295680,909018,2020-01-28,Assembly,"Assembly Floor Vote - Final Passage",139,5,0,4,148
1295683,934790,2020-02-25,Assembly,"Assembly Governmental Employees Committee: Favorable refer to committee Codes",13,0,0,1,14
1295683,940657,2020-03-03,Assembly,"Assembly Codes Committee: Favorable",21,0,0,1,22
1295686,903065,2020-01-09,Senate,"Senate Rules Committee Vote",18,0,0,1,19
1295686,903066,2020-01-15,Senate,"Senate Floor Vote - Final Passage",61,0,0,1,62
1295686,913920,2020-02-03,Assembly,"Assembly Floor Vote - Final Passage",142,0,0,6,148
1295693,904180,2020-01-09,Senate,"Senate Rules Committee Vote",17,1,0,1,19
1295693,904181,2020-01-21,Senate,"Senate Floor Vote - Final Passage",56,5,0,1,62
1295693,914129,2020-02-03,Assembly,"Assembly Floor Vote - Final Passage",140,2,0,6,148
1295701,904285,2020-01-09,Senate,"Senate Rules Committee Vote",18,0,0,1,19
1295701,904286,2020-01-21,Senate,"Senate Floor Vote - Final Passage",61,0,0,1,62
1295701,950008,2020-03-10,Assembly,"Assembly Floor Vote - Final Passage",138,0,0,9,147
1295702,934088,2020-02-25,Assembly,"Assembly Governmental Employees Committee: Favorable",13,0,0,1,14
1295707,913979,2020-01-09,Senate,"Senate Rules Committee Vote",18,0,0,1,19
1295707,913980,2020-02-03,Senate,"Senate Floor Vote - Final Passage",59,0,0,3,62
1295710,909250,2020-01-09,Senate,"Senate Rules Committee Vote",17,1,0,1,19
1295710,909251,2020-01-28,Senate,"Senate Floor Vote - Final Passage",57,5,0,0,62
1295710,950395,2020-03-10,Assembly,"Assembly Floor Vote - Final Passage",135,3,0,9,147
1295716,902900,2020-01-09,Senate,"Senate Rules Committee Vote",18,0,0,1,19
1295716,902901,2020-01-15,Senate,"Senate Floor Vote - Final Passage",61,0,0,1,62
1295716,944558,2020-03-04,Assembly,"Assembly Floor Vote - Final Passage",138,0,0,9,147
1295723,903974,2020-01-09,Senate,"Senate Rules Committee Vote",18,0,0,1,19
1295723,903975,2020-01-21,Senate,"Senate Floor Vote - Final Passage",61,0,0,1,62
1295724,902360,2020-01-09,Senate,"Senate Rules Committee Vote",18,0,0,1,19
1295724,902361,2020-01-13,Senate,"Senate Floor Vote - Final Passage",60,0,0,2,62
1295724,914016,2020-02-03,Assembly,"Assembly Floor Vote - Final Passage",142,0,0,6,148
1295731,934474,2020-02-25,Assembly,"Assembly Governmental Employees Committee: Favorable",13,0,0,1,14
1295734,909460,2020-01-09,Senate,"Senate Rules Committee Vote",16,2,0,1,19
1295734,909461,2020-01-28,Senate,"Senate Floor Vote - Final Passage",60,2,0,0,62
1295734,940967,2020-03-02,Assembly,"Assembly Floor Vote - Final Passage",133,5,0,9,147
1295743,902950,2020-01-09,Senate,"Senate Rules Committee Vote",18,0,0,1,19
1295743,902951,2020-01-15,Senate,"Senate Floor Vote - Final Passage",61,0,0,1,62
1295743,933910,2020-02-24,Assembly,"Assembly Floor Vote - Final Passage",125,7,0,15,147
1295746,904144,2020-01-09,Senate,"Senate Rules Committee Vote",16,2,0,1,19
1295746,904145,2020-01-21,Senate,"Senate Floor Vote - Final Passage",46,15,0,1,62
1295746,913825,2020-02-03,Assembly,"Assembly Floor Vote - Final Passage",137,5,0,6,148
1295755,904176,2020-01-09,Senate,"Senate Rules Committee Vote",17,1,0,1,19
1295755,904177,2020-01-21,Senate,"Senate Floor Vote - Final Passage",60,1,0,1,62
1295755,935635,2020-02-25,Assembly,"Assembly Floor Vote - Final Passage",135,3,0,9,147
1295758,902998,2020-01-09,Senate,"Senate Rules Committee Vote",18,0,0,1,19
1295758,902999,2020-01-15,Senate,"Senate Floor Vote - Final Passage",61,0,0,1,62
1295765,903834,2020-01-09,Senate,"Senate Rules Committee Vote",18,0,0,1,19
1295765,903835,2020-01-21,Senate,"Senate Floor Vote - Final Passage",60,1,0,1,62
1295765,943922,2020-03-04,Assembly,"Assembly Floor Vote - Final Passage",137,1,0,9,147
1295768,901960,2020-01-09,Senate,"Senate Rules Committee Vote",18,0,0,1,19
1295768,901961,2020-01-13,Senate,"Senate Floor Vote - Final Passage",60,0,0,2,62
1295768,933405,2020-02-24,Assembly,"Assembly Floor Vote - Final Passage",132,0,0,15,147
1295771,901936,2020-01-09,Senate,"Senate Rules Committee Vote",18,0,0,1,19
1295771,901937,2020-01-13,Senate,"Senate Floor Vote - Final Passage",60,0,0,2,62
1295771,913869,2020-02-03,Assembly,"Assembly Floor Vote - Final Passage",140,2,0,6,148
1295773,902966,2020-01-09,Senate,"Senate Rules Committee Vote",18,0,0,1,19
1295773,902967,2020-01-15,Senate,"Senate Floor Vote - Final Passage",61,0,0,1,62
1295775,903113,2020-01-09,Senate,"Senate Rules Committee Vote",18,0,0,1,19
1295775,903114,2020-01-15,Senate,"Senate Floor Vote - Final Passage",61,0,0,1,62
1295781,902972,2020-01-09,Senate,"Senate Rules Committee Vote",18,0,0,1,19
1295781,902973,2020-01-15,Senate,"Senate Floor Vote - Final Passage",61,0,0,1,62
1295781,914048,2020-02-03,Assembly,"Assembly Floor Vote - Final Passage",141,0,0,7,148
1295782,915258,2020-01-09,Senate,"Senate Rules Committee Vote",18,0,0,1,19
1295782,915259,2020-02-05,Senate,"Senate Floor Vote - Final Passage",60,1,0,1,62
1295787,919746,2020-02-11,Assembly,"Assembly Economic Development Committee: Favorable",22,1,0,3,26
1295790,907086,2020-01-09,Senate,"Senate Rules Committee Vote",18,0,0,1,19
1295790,907087,2020-01-28,Senate,"Senate Floor Vote - Final Passage",52,10,0,0,62
1295796,901995,2020-01-09,Senate,"Senate Rules Committee Vote",18,0,0,1,19
1295796,901996,2020-01-13,Senate,"Senate Floor Vote - Final Passage",58,2,0,2,62
1295797,901919,2020-01-09,Senate,"Senate Rules Committee Vote",17,1,0,1,19
1295797,901920,2020-01-13,Senate,"Senate Floor Vote - Final Passage",56,4,0,2,62
1295800,902102,2020-01-09,Senate,"Senate Rules Committee Vote",18,0,0,1,19
1295800,902103,2020-01-13,Senate,"Senate Floor Vote - Final Passage",55,5,0,2,62
1295800,910075,2020-01-28,Assembly,"Assembly Floor Vote - Final Passage",144,0,0,4,148
1295806,902179,2020-01-09,Senate,"Senate Rules Committee Vote",18,0,0,1,19
1295806,902180,2020-01-13,Senate,"Senate Floor Vote - Final Passage",60,0,0,2,62
1295812,902913,2020-01-09,Senate,"Senate Rules Committee Vote",18,0,0,1,19
1295812,902914,2020-01-15,Senate,"Senate Floor Vote - Final Passage",61,0,0,1,62
1295812,914055,2020-02-03,Assembly,"Assembly Floor Vote - Final Passage",142,0,0,6,148
1295951,902576,2020-01-14,Assembly,"Assembly Ways And Means Committee: Favorable",32,1,0,2,35
1295951,902577,2020-01-14,Assembly,"Assembly Codes Committee: Favorable refer to committee Ways and Means",20,0,0,1,21
1295951,902578,2020-01-14,Assembly,"Assembly Agriculture Committee: Favorable refer to committee Codes",19,1,0,1,21
1295951,904076,2020-01-21,Senate,"Senate Floor Vote - Final Passage",61,0,0,1,62
1295951,904317,2020-01-21,Assembly,"Assembly Floor Vote - Final Passage",137,3,0,8,148
1296019,907143,2020-01-28,Assembly,"Assembly Environmental Conservation Committee: Favorable",29,0,0,1,30
1296078,972973,2020-01-14,Senate,"Senate Higher Education Committee Vote",10,0,0,1,11
1296078,972974,2020-07-21,Senate,"Senate Floor Vote - Final Passage",56,4,0,0,60
1296078,972975,2020-07-21,Assembly,"Assembly Floor Vote - Final Passage",136,6,0,3,145
1296084,904668,2020-01-22,Assembly,"Assembly Governmental Operations Committee: Favorable refer to committee Codes",14,0,0,0,14
1296084,906854,2020-01-28,Assembly,"Assembly Codes Committee: Favorable",21,0,0,1,22
1296164,906999,2020-01-28,Assembly,"Assembly Real Property Taxation Committee: Favorable refer to committee Ways and Means",10,0,0,0,10
1296183,907067,2020-01-28,Assembly,"Assembly Labor Committee: Favorable",28,1,0,0,29
1296251,949603,2020-03-03,Senate,"Senate Commerce, Economic Development and Small Business Committee Vote",9,0,0,0,9
1296251,949604,2020-03-11,Senate,"Senate Floor Vote - Final Passage",58,0,0,4,62
1296285,907312,2020-01-28,Assembly,"Assembly Labor Committee: Favorable",22,7,0,0,29
1296304,902691,2020-01-14,Assembly,"Assembly Transportation Committee: Favorable refer to committee Codes",23,1,0,1,25
1296304,908062,2020-01-28,Assembly,"Assembly Codes Committee: Favorable",20,1,0,1,22
1296304,913972,2020-02-03,Assembly,"Assembly Floor Vote - Final Passage",140,1,0,7,148
1296304,918531,2020-02-10,Senate,"Senate Floor Vote - Final Passage",61,0,0,1,62
1296397,908478,2020-01-28,Assembly,"Assembly Labor Committee: Favorable refer to committee Codes",24,5,0,0,29
1296397,914594,2020-02-04,Assembly,"Assembly Codes Committee: Favorable refer to committee Ways and Means",19,0,0,3,22
1296561,906801,2020-01-28,Assembly,"Assembly Housing Committee: Favorable refer to committee Ways and Means",27,0,0,1,28
1296724,904818,2020-01-22,Assembly,"Assembly Corporations, Authorities And Commissions Committee: Favorable",24,0,0,2,26
1296810,904797,2020-01-22,Assembly,"Assembly Governmental Operations Committee: Favorable",14,0,0,0,14
1296810,909813,2020-01-28,Assembly,"Assembly Floor Vote - Final Passage",144,0,0,4,148
1296810,915156,2020-02-05,Senate,"Senate Floor Vote - Final Passage",60,1,0,1,62
1296820,915008,2020-01-14,Senate,"Senate Higher Education Committee Vote",10,0,0,1,11
1296820,915009,2020-02-04,Senate,"Senate Floor Vote - Final Passage",61,0,0,1,62
1296873,904636,2020-01-22,Assembly,"Assembly Corporations, Authorities And Commissions Committee: Favorable refer to committee Ways and Means",24,0,0,2,26
1296884,972297,2020-07-20,Senate,"Senate Local Government Committee Vote",7,0,0,0,7
1296884,973430,2020-07-22,Senate,"Senate Floor Vote - Final Passage",59,1,0,0,60
1296884,973787,2020-07-21,Senate,"Senate Rules Committee Vote",18,1,0,0,19
1297682,904445,2020-01-22,Assembly,"Assembly Governmental Operations Committee: Favorable",14,0,0,0,14
1298903,902610,2020-01-14,Assembly,"Assembly Rules Committee: Favorable",25,0,0,5,30
1298903,902611,2020-01-14,Assembly,"Assembly Codes Committee: Favorable refer to committee Rules",20,0,0,1,21
1298903,902612,2020-01-14,Assembly,"Assembly Transportation Committee: Favorable refer to committee Codes",23,1,0,1,25
1298903,902881,2020-01-14,Senate,"Senate Floor Vote - Final Passage",60,0,0,2,62
1298903,902897,2020-01-14,Assembly,"Assembly Floor Vote - Final Passage",137,3,0,8,148
1298927,908194,2020-01-28,Assembly,"Assembly Aging Committee: Favorable refer to committee Ways and Means",27,1,0,2,30
1299057,904720,2020-01-22,Assembly,"Assembly Social Services Committee: Favorable",13,5,0,0,18
1299057,911619,2020-01-29,Assembly,"Assembly Floor Vote - Final Passage",102,34,0,12,148
1299062,904828,2020-01-22,Assembly,"Assembly Corporations, Authorities And Commissions Committee: Favorable",21,3,0,2,26
1299133,904409,2020-01-22,Assembly,"Assembly Corporations, Authorities And Commissions Committee: Favorable refer to committee Ways and Means",24,0,0,2,26
1299191,902640,2020-01-13,Senate,"Senate Rules Committee Vote",19,0,0,0,19
1299191,902641,2020-01-13,Senate,"Senate Transportation Committee Vote",15,0,0,0,15
1299191,903571,2020-01-14,Senate,"Senate Floor Vote - Final Passage",60,0,0,2,62
1299270,901414,2020-01-08,Assembly,"Assembly Floor Vote - Final Passage",139,0,0,9,148
1299412,904709,2020-01-22,Assembly,"Assembly Ways And Means Committee: Favorable",32,0,0,3,35
1299412,911629,2020-01-29,Assembly,"Assembly Floor Vote - Final Passage",136,0,0,12,148
1299546,904814,2020-01-22,Senate,"Senate Health Committee Vote",14,1,0,0,15
1299579,950204,2020-03-11,Assembly,"Assembly Insurance Committee: Favorable",20,0,0,2,22
1299807,949187,2020-01-28,Senate,"Senate Education Committee Vote",15,0,0,0,15
1299807,949188,2020-03-10,Senate,"Senate Floor Vote - Final Passage",59,0,0,3,62
1299807,972246,2020-07-20,Assembly,"Assembly Floor Vote - Final Passage",141,0,0,4,145
1299855,941735,2020-03-02,Senate,"Senate Corporations, Authorities and Commissions Committee Vote",6,0,0,1,7
1299855,972788,2020-07-21,Senate,"Senate Finance Committee Vote",23,0,0,0,23
1299855,974075,2020-07-22,Senate,"Senate Floor Vote - Final Passage",60,0,0,0,60
1299855,974076,2020-07-22,Senate,"Senate Rules Committee Vote",19,0,0,0,19
1300383,964095,2020-06-09,Senate,"Senate Floor Vote - Final Passage",62,0,0,0,62
1300383,967735,2020-05-28,Senate,"Senate Rules Committee Vote",19,0,0,0,19
1300383,967736,2020-06-08,Senate,"Senate Local Government Committee Vote",7,0,0,0,7
1300447,936239,2020-02-26,Assembly,"Assembly Children And Families Committee: Favorable refer to committee Codes",15,0,0,1,16
1300447,940729,2020-03-03,Assembly,"Assembly Codes Committee: Favorable",21,0,0,1,22
1300532,936109,2020-02-26,Assembly,"Assembly Election Law Committee: Favorable",11,4,0,1,16
1300575,910814,2020-01-29,Assembly,"Assembly Election Law Committee: Favorable",12,0,0,4,16
1300575,914020,2020-02-03,Assembly,"Assembly Floor Vote - Final Passage",110,31,0,7,148
1300575,915316,2020-02-05,Senate,"Senate Floor Vote - Final Passage",61,0,0,1,62
1300689,972340,2020-07-20,Senate,"Senate Insurance Committee Vote",9,2,0,0,11
1300689,973645,2020-07-22,Senate,"Senate Floor Vote - Final Passage",50,10,0,0,60
1300689,973980,2020-07-21,Senate,"Senate Rules Committee Vote",17,2,0,0,19
1301045,904745,2020-01-13,Senate,"Senate Rules Committee Vote",15,4,0,0,19
1301045,904746,2020-01-22,Senate,"Senate Floor Vote - Final Passage",40,21,0,1,62
1301051,907314,2020-01-13,Senate,"Senate Rules Committee Vote",19,0,0,0,19
1301051,907315,2020-01-28,Senate,"Senate Floor Vote - Final Passage",62,0,0,0,62
1301051,950183,2020-03-11,Assembly,"Assembly Floor Vote - Final Passage",134,0,0,13,147
1301060,906643,2020-01-13,Senate,"Senate Rules Committee Vote",19,0,0,0,19
1301060,906644,2020-01-27,Senate,"Senate Floor Vote - Final Passage",58,3,0,1,62
1301072,919200,2020-01-13,Senate,"Senate Rules Committee Vote",19,0,0,0,19
1301072,919201,2020-02-10,Senate,"Senate Floor Vote - Final Passage",61,0,0,1,62
1301090,907038,2020-01-13,Senate,"Senate Rules Committee Vote",19,0,0,0,19
1301090,907039,2020-01-28,Senate,"Senate Floor Vote - Final Passage",62,0,0,0,62
1301090,913835,2020-02-03,Assembly,"Assembly Floor Vote - Final Passage",131,11,0,6,148
1301094,915511,2020-01-13,Senate,"Senate Rules Committee Vote",19,0,0,0,19
1301094,915512,2020-02-05,Senate,"Senate Floor Vote - Final Passage",61,0,0,1,62
1301101,906599,2020-01-13,Senate,"Senate Rules Committee Vote",19,0,0,0,19
1301101,906600,2020-01-27,Senate,"Senate Floor Vote - Final Passage",61,0,0,1,62
1301101,916258,2020-02-05,Assembly,"Assembly Floor Vote - Final Passage",143,0,0,5,148
1301106,905133,2020-01-13,Senate,"Senate Rules Committee Vote",19,0,0,0,19
1301106,905134,2020-01-23,Senate,"Senate Floor Vote - Final Passage",59,0,0,3,62
1301106,939882,2020-02-11,Assembly,"Assembly Floor Vote - Final Passage",145,0,0,2,147
1301128,904821,2020-01-13,Senate,"Senate Rules Committee Vote",17,2,0,0,19
1301128,904822,2020-01-22,Senate,"Senate Floor Vote - Final Passage",60,1,0,1,62
1301142,906574,2020-01-13,Senate,"Senate Rules Committee Vote",19,0,0,0,19
1301142,906575,2020-01-27,Senate,"Senate Floor Vote - Final Passage",61,0,0,1,62
1301142,916572,2020-02-05,Assembly,"Assembly Floor Vote - Final Passage",138,5,0,5,148
1301148,906010,2020-01-13,Senate,"Senate Rules Committee Vote",19,0,0,0,19
1301148,906011,2020-01-27,Senate,"Senate Floor Vote - Final Passage",61,0,0,1,62
1301174,916136,2020-01-13,Senate,"Senate Rules Committee Vote",19,0,0,0,19
1301174,916137,2020-02-05,Senate,"Senate Floor Vote - Final Passage",61,0,0,1,62
1301174,919661,2020-02-10,Assembly,"Assembly Floor Vote - Final Passage",143,0,0,4,147
1301196,915359,2020-01-13,Senate,"Senate Rules Committee Vote",18,1,0,0,19
1301196,915360,2020-02-05,Senate,"Senate Floor Vote - Final Passage",61,0,0,1,62
1301196,940553,2020-02-11,Assembly,"Assembly Floor Vote - Final Passage",141,4,0,2,147
1301203,915277,2020-01-13,Senate,"Senate Rules Committee Vote",19,0,0,0,19
1301203,915278,2020-02-05,Senate,"Senate Floor Vote - Final Passage",61,0,0,1,62
1301203,919595,2020-02-10,Assembly,"Assembly Floor Vote - Final Passage",143,0,0,4,147
1301208,909025,2020-01-28,Assembly,"Assembly Labor Committee: Favorable refer to committee Codes",26,3,0,0,29
1301208,914767,2020-02-04,Assembly,"Assembly Codes Committee: Favorable",19,0,0,3,22
1301225,911247,2020-01-29,Assembly,"Assembly Election Law Committee: Favorable",12,0,0,4,16
1301225,914077,2020-02-03,Assembly,"Assembly Floor Vote - Final Passage",134,7,0,7,148
1301225,915363,2020-02-05,Senate,"Senate Floor Vote - Final Passage",57,4,0,1,62
1301236,905194,2020-01-13,Senate,"Senate Rules Committee Vote",19,0,0,0,19
1301236,905195,2020-01-23,Senate,"Senate Floor Vote - Final Passage",58,1,0,3,62
1301236,909817,2020-01-28,Assembly,"Assembly Floor Vote - Final Passage",133,11,0,4,148
1301247,909305,2020-01-13,Senate,"Senate Rules Committee Vote",19,0,0,0,19
1301247,909306,2020-01-28,Senate,"Senate Floor Vote - Final Passage",62,0,0,0,62
1301247,914064,2020-02-03,Assembly,"Assembly Floor Vote - Final Passage",142,0,0,6,148
1301256,905005,2020-01-13,Senate,"Senate Rules Committee Vote",16,3,0,0,19
1301256,905006,2020-01-23,Senate,"Senate Floor Vote - Final Passage",44,15,0,3,62
1301256,943502,2020-03-04,Assembly,"Assembly Floor Vote - Final Passage",129,9,0,9,147
1301272,904439,2020-01-13,Senate,"Senate Rules Committee Vote",19,0,0,0,19
1301272,904440,2020-01-22,Senate,"Senate Floor Vote - Final Passage",61,0,0,1,62
1301272,908879,2020-01-28,Assembly,"Assembly Floor Vote - Final Passage",144,0,0,4,148
1301299,913173,2020-01-13,Senate,"Senate Rules Committee Vote",16,3,0,0,19
1301299,913174,2020-02-03,Senate,"Senate Floor Vote - Final Passage",42,17,0,3,62
1301299,923642,2020-02-13,Assembly,"Assembly Floor Vote - Final Passage",95,44,0,8,147
1301308,905082,2020-01-13,Senate,"Senate Rules Committee Vote",19,0,0,0,19
1301308,905083,2020-01-23,Senate,"Senate Floor Vote - Final Passage",49,10,0,3,62
1301308,936940,2020-02-26,Assembly,"Assembly Floor Vote - Final Passage",97,43,0,7,147
1301318,905034,2020-01-13,Senate,"Senate Rules Committee Vote",19,0,0,0,19
1301318,905035,2020-01-23,Senate,"Senate Floor Vote - Final Passage",59,0,0,3,62
1301318,950460,2020-03-11,Assembly,"Assembly Floor Vote - Final Passage",135,0,0,12,147
1301344,904498,2020-01-13,Senate,"Senate Rules Committee Vote",18,1,0,0,19
1301344,904499,2020-01-22,Senate,"Senate Floor Vote - Final Passage",59,2,0,1,62
1301350,903977,2020-01-13,Senate,"Senate Rules Committee Vote",19,0,0,0,19
1301350,903978,2020-01-21,Senate,"Senate Floor Vote - Final Passage",61,0,0,1,62
1301358,904903,2020-01-13,Senate,"Senate Rules Committee Vote",19,0,0,0,19
1301358,904904,2020-01-23,Senate,"Senate Floor Vote - Final Passage",59,0,0,3,62
1301358,913826,2020-02-03,Assembly,"Assembly Floor Vote - Final Passage",140,2,0,6,148
1301391,915406,2020-01-13,Senate,"Senate Rules Committee Vote",19,0,0,0,19
1301391,915407,2020-02-05,Senate,"Senate Floor Vote - Final Passage",61,0,0,1,62
1301391,933412,2020-02-24,Assembly,"Assembly Floor Vote - Final Passage",130,1,0,16,147
1301397,904749,2020-01-13,Senate,"Senate Rules Committee Vote",19,0,0,0,19
1301397,904750,2020-01-22,Senate,"Senate Floor Vote - Final Passage",61,0,0,1,62
1301397,941846,2020-03-02,Assembly,"Assembly Floor Vote - Final Passage",137,1,0,9,147
1301407,936152,2020-02-26,Assembly,"Assembly Election Law Committee: Favorable",15,0,0,1,16
1301423,904525,2020-01-13,Senate,"Senate Rules Committee Vote",19,0,0,0,19
1301423,904526,2020-01-22,Senate,"Senate Floor Vote - Final Passage",60,1,0,1,62
1301423,908809,2020-01-28,Assembly,"Assembly Floor Vote - Final Passage",140,4,0,4,148
1301430,913525,2020-01-13,Senate,"Senate Rules Committee Vote",17,2,0,0,19
1301430,913526,2020-02-03,Senate,"Senate Floor Vote - Final Passage",40,19,0,3,62
1301435,905115,2020-01-13,Senate,"Senate Rules Committee Vote",15,4,0,0,19
1301435,905116,2020-01-23,Senate,"Senate Floor Vote - Final Passage",39,20,0,3,62
1301441,905197,2020-01-13,Senate,"Senate Rules Committee Vote",19,0,0,0,19
1301441,905198,2020-01-23,Senate,"Senate Floor Vote - Final Passage",59,0,0,3,62
1301441,935318,2020-02-25,Assembly,"Assembly Floor Vote - Final Passage",138,0,0,9,147
1301450,913823,2020-01-13,Senate,"Senate Rules Committee Vote",17,2,0,0,19
1301450,913824,2020-02-03,Senate,"Senate Floor Vote - Final Passage",48,11,0,3,62
1301450,937020,2020-02-26,Assembly,"Assembly Floor Vote - Final Passage",111,28,0,8,147
1301467,972667,2020-07-20,Senate,"Senate Labor Committee Vote",13,0,0,0,13
1301467,974202,2020-07-21,Senate,"Senate Rules Committee Vote",19,0,0,0,19
1301467,974203,2020-07-22,Senate,"Senate Floor Vote - Final Passage",60,0,0,0,60
1301478,904549,2020-01-22,Assembly,"Assembly Ways And Means Committee: Favorable",32,0,0,3,35
1301478,904550,2020-01-22,Assembly,"Assembly Governmental Operations Committee: Favorable refer to committee Ways and Means",14,0,0,0,14
1301478,911264,2020-01-29,Assembly,"Assembly Floor Vote - Final Passage",136,0,0,12,148
1301574,904762,2020-01-22,Assembly,"Assembly Ways And Means Committee: Favorable",32,0,0,3,35
1301574,911261,2020-01-29,Assembly,"Assembly Floor Vote - Final Passage",135,1,0,12,148
1301640,935857,2020-02-26,Assembly,"Assembly Election Law Committee: Favorable",11,4,0,1,16
1301652,972925,2020-07-20,Senate,"Senate Civil Service and Pensions Committee Vote",7,0,0,0,7
1301652,973596,2020-07-22,Senate,"Senate Floor Vote - Final Passage",60,0,0,0,60
1301652,973931,2020-07-21,Senate,"Senate Rules Committee Vote",19,0,0,0,19
1301655,973561,2020-07-22,Senate,"Senate Floor Vote - Final Passage",56,4,0,0,60
1301655,973924,2020-07-21,Senate,"Senate Rules Committee Vote",18,1,0,0,19
1301663,935701,2020-02-25,Assembly,"Assembly Judiciary Committee: Favorable",19,0,0,2,21
1301708,904878,2020-01-22,Assembly,"Assembly Health Committee: Favorable refer to committee Ways and Means",25,0,0,1,26
1302203,902582,2020-01-14,Assembly,"Assembly Rules Committee: Favorable",25,0,0,5,30
1302203,902583,2020-01-14,Assembly,"Assembly Codes Committee: Favorable refer to committee Rules",20,0,0,1,21
1302203,902584,2020-01-14,Assembly,"Assembly Transportation Committee: Favorable refer to committee Codes",24,0,0,1,25
1302203,902869,2020-01-14,Senate,"Senate Floor Vote - Final Passage",60,0,0,2,62
1302203,902932,2020-01-14,Assembly,"Assembly Floor Vote - Final Passage",140,0,0,8,148
1302231,902579,2020-01-14,Assembly,"Assembly Rules Committee: Favorable",25,0,0,5,30
1302231,902580,2020-01-14,Assembly,"Assembly Codes Committee: Favorable refer to committee Rules",20,0,0,1,21
1302231,902581,2020-01-14,Assembly,"Assembly Transportation Committee: Favorable refer to committee Codes",24,0,0,1,25
1302231,902867,2020-01-14,Senate,"Senate Floor Vote - Final Passage",60,0,0,2,62
1302231,902930,2020-01-14,Assembly,"Assembly Floor Vote - Final Passage",139,1,0,8,148
1302251,908612,2020-01-28,Assembly,"Assembly Health Committee: Favorable refer to committee Ways and Means",24,0,0,2,26
1302303,971216,2020-07-14,Assembly,"Assembly Judiciary Committee: Favorable refer to committee Codes",15,6,0,0,21
1302343,908615,2020-01-28,Assembly,"Assembly Health Committee: Favorable refer to committee Ways and Means",24,0,0,2,26
1302359,960577,2020-05-26,Assembly,"Assembly Codes Committee: Favorable refer to committee Rules",21,0,0,1,22
1302359,960708,2020-05-27,Assembly,"Assembly Rules Committee: Favorable",29,0,0,2,31
1302361,963726,2020-06-09,Assembly,"Assembly Rules Committee: Favorable",27,0,0,4,31
1302361,963727,2020-06-09,Assembly,"Assembly Ways And Means Committee: Favorable refer to committee Rules",32,0,0,3,35
1302400,920076,2020-02-11,Assembly,"Assembly Higher Education Committee: Favorable",23,0,0,1,24
1302406,971487,2020-07-16,Assembly,"Assembly Transportation Committee: Held for Consideration",16,6,0,2,24
1302442,902591,2020-01-14,Assembly,"Assembly Rules Committee: Favorable",25,0,0,5,30
1302442,902592,2020-01-14,Assembly,"Assembly Codes Committee: Favorable refer to committee Rules",20,0,0,1,21
1302442,902593,2020-01-14,Assembly,"Assembly Transportation Committee: Favorable refer to committee Codes",24,0,0,1,25
1302442,902870,2020-01-14,Senate,"Senate Floor Vote - Final Passage",60,0,0,2,62
1302442,902934,2020-01-14,Assembly,"Assembly Floor Vote - Final Passage",140,0,0,8,148
1302443,902624,2020-01-14,Assembly,"Assembly Rules Committee: Favorable",25,0,0,5,30
1302443,902625,2020-01-14,Assembly,"Assembly Codes Committee: Favorable refer to committee Rules",20,0,0,1,21
1302443,902626,2020-01-14,Assembly,"Assembly Transportation Committee: Favorable refer to committee Codes",24,0,0,1,25
1302443,902883,2020-01-14,Senate,"Senate Floor Vote - Final Passage",60,0,0,2,62
1302443,903058,2020-01-14,Assembly,"Assembly Floor Vote - Final Passage",140,0,0,8,148
1302451,933598,2020-02-25,Senate,"Senate Crime Victims, Crime and Correction Committee Vote",5,2,0,0,7
1302549,972326,2020-07-20,Senate,"Senate Higher Education Committee Vote",10,1,0,0,11
1302549,973582,2020-07-22,Senate,"Senate Floor Vote - Final Passage",58,2,0,0,60
1302549,973946,2020-07-21,Senate,"Senate Rules Committee Vote",17,2,0,0,19
1302563,907107,2020-01-28,Assembly,"Assembly Correction Committee: Favorable",11,0,0,2,13
1302563,915467,2020-02-04,Assembly,"Assembly Floor Vote - Final Passage",140,0,0,8,148
1302563,918552,2020-02-10,Senate,"Senate Floor Vote - Final Passage",40,21,0,1,62
1302718,907952,2020-01-28,Assembly,"Assembly Correction Committee: Favorable",11,0,0,2,13
1302736,909288,2020-01-28,Assembly,"Assembly Correction Committee: Favorable",11,0,0,2,13
1302736,915543,2020-02-04,Assembly,"Assembly Floor Vote - Final Passage",138,2,0,8,148
1302736,915544,2020-02-05,Senate,"Senate Floor Vote - Final Passage",61,0,0,1,62
1302821,909278,2020-01-21,Senate,"Senate Elections Committee Vote",6,1,0,0,7
1302821,909279,2020-01-29,Senate,"Senate Floor Vote - Final Passage",58,0,0,4,62
1302821,915328,2020-02-04,Assembly,"Assembly Floor Vote - Final Passage",138,2,0,8,148
1302844,908406,2020-01-28,Assembly,"Assembly Labor Committee: Favorable refer to committee Codes",28,1,0,0,29
1302844,914465,2020-02-04,Assembly,"Assembly Codes Committee: Favorable refer to committee Ways and Means",19,0,0,3,22
1303584,904671,2020-01-22,Assembly,"Assembly Social Services Committee: Favorable refer to committee Ways and Means",13,5,0,0,18
1303627,920962,2020-02-11,Assembly,"Assembly Local Governments Committee: Favorable refer to committee Ways and Means",18,0,0,0,18
1303697,906706,2020-01-28,Senate,"Senate Higher Education Committee Vote",11,0,0,0,11
1303727,906765,2020-01-28,Senate,"Senate Higher Education Committee Vote",11,0,0,0,11
1304424,904363,2020-01-22,Assembly,"Assembly Social Services Committee: Favorable refer to committee Ways and Means",13,5,0,0,18
1307665,973571,2020-07-23,Senate,"Senate Floor Vote - Final Passage",40,20,0,0,60
1307665,973806,2020-07-20,Senate,"Senate Judiciary Committee Vote",11,4,0,0,15
1307665,973807,2020-07-21,Senate,"Senate Rules Committee Vote",13,6,0,0,19
1308407,971272,2020-07-14,Assembly,"Assembly Education Committee: Favorable refer to committee Rules",29,0,0,2,31
1308407,972194,2020-07-20,Assembly,"Assembly Rules Committee: Favorable",27,0,0,3,30
1308487,970937,2020-07-13,Assembly,"Assembly Consumer Affairs And Protection Committee: Favorable refer to committee Rules",15,0,0,1,16
1308487,972214,2020-07-20,Assembly,"Assembly Rules Committee: Favorable",27,0,0,3,30
1308980,964174,2020-06-09,Senate,"Senate Floor Vote - Final Passage",62,0,0,0,62
1308980,967753,2020-05-28,Senate,"Senate Rules Committee Vote",19,0,0,0,19
1308980,967754,2020-06-08,Senate,"Senate Transportation Committee Vote",15,0,0,0,15
1309102,973082,2020-02-25,Senate,"Senate Cultural Affairs, Tourism, Parks And Recreation Committee Vote",7,0,0,0,7
1309102,973083,2020-07-21,Senate,"Senate Floor Vote - Final Passage",60,0,0,0,60
1309102,973084,2020-07-21,Assembly,"Assembly Floor Vote - Final Passage",142,0,0,3,145
1309560,964074,2020-06-09,Senate,"Senate Floor Vote - Final Passage",62,0,0,0,62
1309560,966290,2020-05-28,Senate,"Senate Rules Committee Vote",19,0,0,0,19
1309560,966291,2020-06-08,Senate,"Senate Transportation Committee Vote",15,0,0,0,15
1310573,919840,2020-02-11,Senate,"Senate Housing, Construction and Community Development Committee Vote",9,2,0,0,11
1310573,919841,2020-02-11,Senate,"Senate Rules Committee Vote",16,3,0,0,19
1310573,921686,2020-02-12,Senate,"Senate Floor Vote - Final Passage",41,19,0,2,62
1310655,919676,2020-02-11,Senate,"Senate Housing, Construction and Community Development Committee Vote",8,3,0,0,11
1310655,919892,2020-02-11,Senate,"Senate Housing, Construction and Community Development Committee Vote",8,3,0,0,11
1310655,921564,2020-02-12,Senate,"Senate Floor Vote - Final Passage",35,25,0,2,62
1310719,964144,2020-06-09,Senate,"Senate Floor Vote - Final Passage",62,0,0,0,62
1310719,964754,2020-06-09,Assembly,"Assembly Floor Vote - Final Passage",144,0,0,3,147
1310719,966358,2020-05-28,Senate,"Senate Rules Committee Vote",19,0,0,0,19
1310789,919838,2020-02-11,Senate,"Senate Housing, Construction and Community Development Committee Vote",7,4,0,0,11
1310789,919839,2020-02-11,Senate,"Senate Rules Committee Vote",16,3,0,0,19
1310789,921482,2020-02-12,Senate,"Senate Floor Vote - Final Passage",41,19,0,2,62
1310823,950212,2020-03-11,Assembly,"Assembly Insurance Committee: Favorable",14,6,0,2,22
1311107,919852,2020-02-11,Senate,"Senate Housing, Construction And Community Development Committee Vote",10,1,0,0,11
1311107,919853,2020-02-11,Senate,"Senate Rules Committee Vote",19,0,0,0,19
1311107,921760,2020-02-12,Senate,"Senate Floor Vote - Final Passage",47,13,0,2,62
1311113,904342,2020-01-22,Assembly,"Assembly Education Committee: Favorable refer to committee Ways and Means",27,1,0,2,30
1311113,904628,2020-01-22,Assembly,"Assembly Ways And Means Committee: Favorable",32,0,0,3,35
1311220,904339,2020-01-22,Assembly,"Assembly Education Committee: Favorable refer to committee Ways and Means",27,1,0,2,30
1311220,904626,2020-01-22,Assembly,"Assembly Ways And Means Committee: Favorable",32,0,0,3,35
1311375,972785,2020-07-20,Senate,"Senate Investigations and Government Operations Committee Vote",5,1,0,0,6
1311375,973195,2020-07-22,Senate,"Senate Floor Vote - Final Passage",41,19,0,0,60
1311375,973283,2020-07-22,Senate,"Senate Rules Committee Vote",14,5,0,0,19
1311375,973402,2020-07-23,Assembly,"Assembly Floor Vote - Final Passage",107,34,0,4,145
1311587,919662,2020-02-11,Senate,"Senate Housing, Construction And Community Development Committee Vote",11,0,0,0,11
1311587,919883,2020-02-11,Senate,"Senate Housing, Construction And Community Development Committee Vote",11,0,0,0,11
1311587,942340,2020-03-04,Senate,"Senate Floor Vote - Final Passage",62,0,0,0,62
1312166,919856,2020-02-11,Senate,"Senate Housing, Construction and Community Development Committee Vote",9,2,0,0,11
1312166,919857,2020-02-11,Senate,"Senate Rules Committee Vote",17,2,0,0,19
1312166,922120,2020-02-12,Senate,"Senate Floor Vote - Final Passage",50,10,0,2,62
1313282,938471,2020-01-21,Senate,"Senate Rules Committee Vote",19,0,0,0,19
1313282,938472,2020-02-27,Senate,"Senate Floor Vote - Final Passage",59,0,0,3,62
1313299,915307,2020-01-21,Senate,"Senate Rules Committee Vote",19,0,0,0,19
1313299,915308,2020-02-05,Senate,"Senate Floor Vote - Final Passage",59,2,0,1,62
1313311,909238,2020-01-21,Senate,"Senate Rules Committee Vote",18,1,0,0,19
1313311,910492,2020-01-29,Senate,"Senate Floor Vote - Final Passage",42,16,0,4,62
1313311,915226,2020-02-04,Assembly,"Assembly Floor Vote - Final Passage",111,28,0,9,148
1313319,903878,2020-01-21,Senate,"Senate Floor Vote - Final Passage",49,12,0,1,62
1313319,904265,2020-01-21,Senate,"Senate Rules Committee Vote",15,4,0,0,19
1313319,906922,2020-01-27,Assembly,"Assembly Floor Vote - Final Passage",140,1,0,7,148
1313323,906024,2020-01-21,Senate,"Senate Rules Committee Vote",18,1,0,0,19
1313323,906025,2020-01-27,Senate,"Senate Floor Vote - Final Passage",48,13,0,1,62
1313323,933344,2020-02-24,Assembly,"Assembly Floor Vote - Final Passage",127,4,0,16,147
1313339,907006,2020-01-21,Senate,"Senate Rules Committee Vote",16,3,0,0,19
1313339,907007,2020-01-28,Senate,"Senate Floor Vote - Final Passage",46,16,0,0,62
1313363,909361,2020-01-21,Senate,"Senate Rules Committee Vote",19,0,0,0,19
1313363,909362,2020-01-29,Senate,"Senate Floor Vote - Final Passage",57,1,0,4,62
1313363,941527,2020-03-02,Assembly,"Assembly Floor Vote - Final Passage",136,0,0,11,147
1313477,903871,2020-01-21,Senate,"Senate Floor Vote - Final Passage",50,11,0,1,62
1313477,904320,2020-01-21,Senate,"Senate Rules Committee Vote",15,4,0,0,19
1313477,906804,2020-01-27,Assembly,"Assembly Floor Vote - Final Passage",140,1,0,7,148
1313524,934039,2020-02-25,Assembly,"Assembly Cities Committee: Favorable",14,0,0,1,15
1313524,941923,2020-03-03,Assembly,"Assembly Floor Vote - Final Passage",139,0,0,8,147
1313524,965110,2020-06-09,Senate,"Senate Floor Vote - Final Passage",62,0,0,0,62
1313589,936891,2020-02-26,Assembly,"Assembly Corporations, Authorities And Commissions Committee: Favorable",25,0,0,1,26
1313589,942049,2020-03-03,Assembly,"Assembly Floor Vote - Final Passage",139,0,0,8,147
1313589,973376,2020-07-22,Senate,"Senate Floor Vote - Final Passage",60,0,0,0,60
1313703,970808,2020-07-13,Assembly,"Assembly Health Committee: Favorable refer to committee Rules",24,0,0,2,26
1313703,973019,2020-07-22,Assembly,"Assembly Rules Committee: Favorable",25,0,0,5,30
1313882,934689,2020-02-25,Assembly,"Assembly Judiciary Committee: Favorable",15,4,0,2,21
1313913,940157,2020-02-24,Senate,"Senate Local Government Committee Vote",7,0,0,0,7
1313913,940158,2020-03-02,Senate,"Senate Floor Vote - Final Passage",60,1,0,1,62
1313913,964712,2020-06-09,Assembly,"Assembly Floor Vote - Final Passage",144,0,0,3,147
1315356,971401,2020-07-16,Assembly,"Assembly Transportation Committee: Held for Consideration",16,6,0,2,24
1315388,971909,2020-07-17,Assembly,"Assembly Codes Committee: Held for Consideration",15,6,0,1,22
1315405,972523,2020-02-11,Senate,"Senate Health Committee Vote",15,0,0,0,15
1315405,972524,2020-07-21,Senate,"Senate Floor Vote - Final Passage",60,0,0,0,60
1315433,972847,2020-07-22,Assembly,"Assembly Ways And Means Committee: Favorable refer to committee Rules",32,0,0,2,34
1315433,973105,2020-07-22,Assembly,"Assembly Rules Committee: Favorable",29,0,0,1,30
1315524,920261,2020-02-11,Senate,"Senate Health Committee Vote",15,0,0,0,15
1315524,941273,2020-03-03,Senate,"Senate Finance Committee Vote",23,0,0,0,23
1315604,906962,2020-01-28,Assembly,"Assembly Labor Committee: Favorable refer to committee Codes",27,2,0,0,29
1315604,914350,2020-02-04,Assembly,"Assembly Codes Committee: Favorable refer to committee Ways and Means",19,0,0,3,22
1315626,941762,2020-03-03,Senate,"Senate Committee Vote",7,0,0,0,7
1315680,941743,2020-03-03,Senate,"Senate Committee Vote",7,0,0,0,7
1315693,964134,2020-06-09,Senate,"Senate Floor Vote - Final Passage",60,2,0,0,62
1315693,965431,2020-06-10,Assembly,"Assembly Floor Vote - Final Passage",143,1,0,3,147
1315693,966363,2020-05-28,Senate,"Senate Rules Committee Vote",19,0,0,0,19
1315693,966364,2020-06-08,Senate,"Senate Local Government Committee Vote",7,0,0,0,7
1315738,950378,2020-02-04,Senate,"Senate Commerce, Economic Development and Small Business Committee Vote",9,0,0,0,9
1315738,950379,2020-03-10,Senate,"Senate Floor Vote - Final Passage",59,0,0,3,62
1315748,964175,2020-06-09,Senate,"Senate Floor Vote - Final Passage",60,2,0,0,62
1315748,964768,2020-06-09,Assembly,"Assembly Floor Vote - Final Passage",143,1,0,3,147
1315748,966186,2020-05-28,Senate,"Senate Rules Committee Vote",19,0,0,0,19
1315748,966187,2020-06-08,Senate,"Senate Local Government Committee Vote",7,0,0,0,7
1315862,948596,2020-02-25,Senate,"Senate Finance Committee Vote",22,0,0,1,23
1315862,948597,2020-03-10,Senate,"Senate Floor Vote - Final Passage",59,0,0,3,62
1315862,972824,2020-07-21,Assembly,"Assembly Floor Vote - Final Passage",142,0,0,3,145
1315941,948436,2020-03-02,Senate,"Senate Corporations, Authorities And Commissions Committee Vote",6,0,0,1,7
1315941,948437,2020-03-10,Senate,"Senate Floor Vote - Final Passage",59,0,0,3,62
1317039,972964,2020-07-21,Senate,"Senate Finance Committee Vote",22,1,0,0,23
1317039,973492,2020-07-22,Senate,"Senate Floor Vote - Final Passage",59,1,0,0,60
1317039,973832,2020-07-21,Senate,"Senate Finance Committee Vote",22,1,0,0,23
1317039,973833,2020-07-21,Senate,"Senate Rules Committee Vote",18,1,0,0,19
1317157,942156,2020-02-12,Senate,"Senate Consumer Protection Committee Vote",7,0,0,0,7
1317157,942157,2020-03-04,Senate,"Senate Floor Vote - Final Passage",62,0,0,0,62
1317157,972478,2020-07-20,Assembly,"Assembly Floor Vote - Final Passage",141,0,0,4,145
1317220,936883,2020-02-26,Assembly,"Assembly Racing And Wagering Committee: Favorable",11,0,0,0,11
1317358,909427,2020-01-29,Assembly,"Assembly Racing And Wagering Committee: Favorable refer to committee Ways and Means",11,0,0,0,11
1317372,906877,2020-01-28,Assembly,"Assembly Housing Committee: Favorable",27,0,0,1,28
1317394,972790,2020-07-21,Senate,"Senate Finance Committee Vote",22,1,0,0,23
1317394,974136,2020-07-21,Senate,"Senate Finance Committee Vote",22,1,0,0,23
1317394,974137,2020-07-22,Senate,"Senate Rules Committee Vote",19,0,0,0,19
1317394,974138,2020-07-23,Senate,"Senate Floor Vote - Final Passage",60,0,0,0,60
1317436,909748,2020-01-29,Assembly,"Assembly Election Law Committee: Favorable",12,0,0,4,16
1317513,973007,2020-07-20,Senate,"Senate Investigations and Government Operations Committee Vote",6,0,0,0,6
1317513,973528,2020-07-22,Senate,"Senate Floor Vote - Final Passage",60,0,0,0,60
1317513,973918,2020-07-21,Senate,"Senate Rules Committee Vote",19,0,0,0,19
1317521,910086,2020-01-29,Assembly,"Assembly Racing And Wagering Committee: Favorable refer to committee Codes",11,0,0,0,11
1317521,933480,2020-02-25,Assembly,"Assembly Codes Committee: Favorable",21,0,0,1,22
1317583,906929,2020-01-28,Assembly,"Assembly Health Committee: Favorable",24,0,0,2,26
1317590,955930,2020-03-31,Assembly,"Assembly Ways And Means Committee: Favorable refer to committee Rules",20,7,0,8,35
1317590,955931,2020-03-31,Assembly,"Assembly Rules Committee: Favorable",18,6,0,7,31
1317603,955807,2020-04-02,Assembly,"Assembly Rules Committee: Favorable",22,6,0,3,31
1317603,955808,2020-04-02,Assembly,"Assembly Rules Committee: Favorable",21,7,0,3,31
1317603,955809,2020-04-02,Assembly,"Assembly Ways And Means Committee: Favorable refer to committee Rules",20,9,0,6,35
1317626,908107,2020-01-28,Assembly,"Assembly Labor Committee: Favorable refer to committee Ways and Means",27,2,0,0,29
1317626,914100,2020-02-04,Assembly,"Assembly Rules Committee: Favorable",27,0,0,4,31
1317626,914101,2020-02-04,Assembly,"Assembly Ways And Means Committee: Favorable refer to committee Rules",30,2,0,3,35
1317633,955936,2020-03-31,Assembly,"Assembly Ways And Means Committee: Favorable refer to committee Rules",18,9,0,8,35
1317633,955937,2020-04-01,Assembly,"Assembly Rules Committee: Favorable",20,7,0,4,31
1317633,955938,2020-04-01,Assembly,"Assembly Rules Committee: Favorable",20,7,0,4,31
1317666,955773,2020-04-02,Assembly,"Assembly Rules Committee: Favorable",21,7,0,3,31
1317666,955774,2020-04-02,Assembly,"Assembly Rules Committee: Favorable",21,7,0,3,31
1317666,955775,2020-04-02,Assembly,"Assembly Ways And Means Committee: Favorable refer to committee Rules",20,10,0,5,35
1317670,955516,2020-04-02,Senate,"Senate Floor Vote - Final Passage",40,21,0,1,62
1317670,955637,2020-04-02,Senate,"Senate Finance Committee Vote",15,7,0,1,23
1317670,955638,2020-04-03,Assembly,"Assembly Floor Vote - Final Passage",108,34,0,5,147
1317676,955802,2020-04-02,Assembly,"Assembly Rules Committee: Favorable",20,6,0,5,31
1317676,955803,2020-04-02,Assembly,"Assembly Rules Committee: Favorable",20,6,0,5,31
1317676,955804,2020-04-02,Assembly,"Assembly Ways And Means Committee: Favorable refer to committee Rules",19,10,0,6,35
1317692,955481,2020-04-01,Senate,"Senate Floor Vote - Final Passage",39,22,0,1,62
1317692,955633,2020-04-01,Senate,"Senate Finance Committee Vote",15,7,0,1,23
1317692,955634,2020-04-02,Assembly,"Assembly Floor Vote - Final Passage",99,42,0,6,147
1317695,953313,2020-03-18,Senate,"Senate Floor Vote - Final Passage",55,1,0,6,62
1317695,953418,2020-03-18,Senate,"Senate Finance Committee Vote",19,0,0,4,23
1317695,955382,2020-03-31,Assembly,"Assembly Floor Vote - Final Passage",93,31,0,23,147
1317700,955562,2020-04-02,Senate,"Senate Floor Vote - Final Passage",40,21,0,1,62
1317700,955608,2020-04-03,Assembly,"Assembly Floor Vote - Final Passage",100,42,0,5,147
1317700,955679,2020-04-02,Senate,"Senate Finance Committee Vote",16,6,0,1,23
1317713,955933,2020-04-01,Assembly,"Assembly Rules Committee: Favorable",21,6,0,4,31
1317713,955934,2020-04-01,Assembly,"Assembly Rules Committee: Favorable",20,7,0,4,31
1317713,955935,2020-04-01,Assembly,"Assembly Ways And Means Committee: Favorable refer to committee Rules",21,9,0,5,35
1317732,906912,2020-01-28,Assembly,"Assembly Health Committee: Favorable",24,0,0,2,26
1317736,955779,2020-04-01,Assembly,"Assembly Rules Committee: Favorable",21,6,0,4,31
1317736,955780,2020-04-01,Assembly,"Assembly Rules Committee: Favorable",20,7,0,4,31
1317736,955781,2020-04-01,Assembly,"Assembly Ways And Means Committee: Favorable refer to committee Rules",21,9,0,5,35
1317745,907745,2020-01-28,Assembly,"Assembly Health Committee: Favorable",24,0,0,2,26
1317765,907106,2020-01-28,Assembly,"Assembly Health Committee: Favorable",24,0,0,2,26
1317765,916424,2020-02-05,Assembly,"Assembly Floor Vote - Final Passage",141,2,0,5,148
1317765,919155,2020-02-10,Senate,"Senate Floor Vote - Final Passage",61,0,0,1,62
1317777,955819,2020-04-01,Assembly,"Assembly Rules Committee: Favorable",20,7,0,4,31
1317777,955820,2020-04-01,Assembly,"Assembly Ways And Means Committee: Favorable refer to committee Rules",22,8,0,5,35
1317783,955554,2020-03-31,Senate,"Senate Floor Vote - Final Passage",39,22,0,1,62
1317783,955594,2020-04-01,Assembly,"Assembly Floor Vote - Final Passage",103,38,0,6,147
1317783,955631,2020-03-31,Senate,"Senate Finance Committee Vote",15,7,0,1,23
1317790,955789,2020-03-31,Assembly,"Assembly Ways And Means Committee: Favorable refer to committee Rules",19,8,0,8,35
1317790,955790,2020-04-01,Assembly,"Assembly Rules Committee: Favorable",21,6,0,4,31
1317790,955791,2020-04-01,Assembly,"Assembly Rules Committee: Favorable",20,7,0,4,31
1318197,921213,2020-02-11,Senate,"Senate Health Committee Vote",12,3,0,0,15
1318197,941303,2020-03-03,Senate,"Senate Finance Committee Vote",17,6,0,0,23
1318245,933949,2020-02-25,Assembly,"Assembly Real Property Taxation Committee: Favorable refer to committee Ways and Means",8,0,0,2,10
1318245,963766,2020-06-09,Assembly,"Assembly Rules Committee: Favorable",27,0,0,4,31
1318245,963767,2020-06-09,Assembly,"Assembly Ways And Means Committee: Favorable refer to committee Rules",32,0,0,3,35
1318250,915026,2020-02-04,Assembly,"Assembly Banks Committee: Favorable refer to committee Codes",19,7,0,5,31
1318250,933965,2020-02-25,Assembly,"Assembly Codes Committee: Favorable",15,6,0,1,22
1318280,955131,2020-03-31,Senate,"Senate Floor Vote - Final Passage",37,24,0,1,62
1318280,955617,2020-03-31,Senate,"Senate Finance Committee Vote",16,6,0,1,23
1318280,955618,2020-04-02,Assembly,"Assembly Floor Vote - Final Passage",96,45,0,6,147
1318312,955517,2020-04-02,Senate,"Senate Floor Vote - Final Passage",35,26,0,1,62
1318312,955622,2020-04-02,Senate,"Senate Finance Committee Vote",16,6,0,1,23
1318312,955623,2020-04-02,Assembly,"Assembly Floor Vote - Final Passage",45,97,0,5,147
1318354,914602,2020-02-04,Assembly,"Assembly Health Committee: Favorable refer to committee Ways and Means",18,5,0,3,26
1318382,955129,2020-03-31,Senate,"Senate Floor Vote - Final Passage",37,24,0,1,62
1318382,955612,2020-03-31,Senate,"Senate Finance Committee Vote",16,6,0,1,23
1318382,955613,2020-04-01,Assembly,"Assembly Floor Vote - Final Passage",53,88,0,6,147
1318403,937250,2020-02-11,Senate,"Senate Health Committee Vote",15,0,0,0,15
1318403,937251,2020-02-27,Senate,"Senate Floor Vote - Final Passage",59,0,0,3,62
1318403,973350,2020-07-22,Assembly,"Assembly Floor Vote - Final Passage",142,0,0,3,145
1318417,972846,2020-07-22,Assembly,"Assembly Ways And Means Committee: Favorable refer to committee Rules",27,5,0,2,34
1318417,973079,2020-07-22,Assembly,"Assembly Rules Committee: Favorable",27,2,0,1,30
1318424,955483,2020-04-01,Senate,"Senate Floor Vote - Final Passage",39,22,0,1,62
1318424,955626,2020-04-01,Senate,"Senate Finance Committee Vote",16,6,0,1,23
1318424,955627,2020-04-02,Assembly,"Assembly Floor Vote - Final Passage",81,60,0,6,147
1318442,971707,2020-07-16,Assembly,"Assembly Local Governments Committee: Favorable refer to committee Ways and Means",19,0,0,1,20
1318442,971762,2020-07-17,Assembly,"Assembly Ways And Means Committee: Favorable refer to committee Rules",32,0,0,2,34
1318442,972220,2020-07-20,Assembly,"Assembly Rules Committee: Favorable",27,0,0,3,30
1318442,972272,2020-07-20,Assembly,"Assembly Floor Vote - Final Passage",141,0,0,4,145
1318442,973181,2020-07-22,Senate,"Senate Floor Vote - Final Passage",56,4,0,0,60
1318553,914116,2020-02-04,Assembly,"Assembly Health Committee: Favorable",23,0,0,3,26
1318633,920930,2020-02-11,Assembly,"Assembly Health Committee: Favorable",22,0,0,4,26
1318702,921209,2020-02-11,Assembly,"Assembly Health Committee: Favorable",22,0,0,4,26
1318760,919659,2020-02-11,Assembly,"Assembly Health Committee: Favorable refer to committee Ways and Means",22,0,0,4,26
1318791,914074,2020-02-04,Assembly,"Assembly Health Committee: Favorable refer to committee Codes",23,0,0,3,26
1318791,934278,2020-02-25,Assembly,"Assembly Codes Committee: Favorable",21,0,0,1,22
1319477,973092,2020-03-02,Senate,"Senate Corporations, Authorities and Commissions Committee Vote",6,0,0,1,7
1319477,973093,2020-07-21,Senate,"Senate Floor Vote - Final Passage",60,0,0,0,60
1319485,964164,2020-06-09,Senate,"Senate Floor Vote - Final Passage",62,0,0,0,62
1319485,967751,2020-05-28,Senate,"Senate Rules Committee Vote",19,0,0,0,19
1319485,967752,2020-06-08,Senate,"Senate Local Government Committee Vote",7,0,0,0,7
1319613,920295,2020-02-11,Assembly,"Assembly Health Committee: Favorable",22,0,0,4,26
1319613,937259,2020-02-26,Assembly,"Assembly Floor Vote - Final Passage",141,0,0,6,147
1319613,972532,2020-07-21,Senate,"Senate Floor Vote - Final Passage",58,2,0,0,60
1319623,943364,2020-03-03,Assembly,"Assembly Mental Health Committee: Favorable refer to committee Ways and Means",12,0,0,1,13
1319624,920912,2020-02-11,Assembly,"Assembly Health Committee: Favorable",22,0,0,4,26
1319624,936038,2020-02-26,Senate,"Senate Floor Vote - Final Passage",45,15,0,2,62
1319624,936924,2020-02-26,Assembly,"Assembly Floor Vote - Final Passage",142,0,0,5,147
1319627,970907,2020-07-13,Assembly,"Assembly Alcoholism And Drug Abuse Committee: Favorable refer to committee Rules",13,0,0,1,14
1319627,973768,2020-07-21,Assembly,"Assembly Rules Committee: Favorable",26,0,0,4,30
1319663,934813,2020-02-25,Assembly,"Assembly Governmental Operations Committee: Favorable refer to committee Codes",13,0,0,1,14
1319664,919716,2020-02-11,Assembly,"Assembly Health Committee: Favorable refer to committee Ways and Means",22,0,0,4,26
1319726,971183,2020-07-14,Assembly,"Assembly Correction Committee: Favorable refer to committee Rules",12,0,0,1,13
1319726,972195,2020-07-20,Assembly,"Assembly Rules Committee: Favorable",27,0,0,3,30
1319726,972722,2020-07-21,Assembly,"Assembly Floor Vote - Final Passage",142,0,0,3,145
1319730,933461,2020-02-25,Assembly,"Assembly Governmental Operations Committee: Favorable refer to committee Codes",12,1,0,1,14
1319730,972042,2020-07-17,Assembly,"Assembly Codes Committee: Favorable refer to committee Rules",15,6,0,1,22
1319730,972569,2020-07-21,Assembly,"Assembly Rules Committee: Favorable",19,7,0,4,30
1319749,971205,2020-07-14,Assembly,"Assembly Judiciary Committee: Favorable refer to committee Rules",19,2,0,0,21
1319749,972168,2020-07-20,Assembly,"Assembly Rules Committee: Favorable",20,7,0,3,30
1319781,934719,2020-02-25,Assembly,"Assembly Governmental Operations Committee: Favorable refer to committee Codes",13,0,0,1,14
1320153,950194,2020-03-11,Assembly,"Assembly Local Governments Committee: Favorable refer to committee Ways and Means",16,0,0,2,18
1320241,973308,2020-07-22,Senate,"Senate Rules Committee Vote",19,0,0,0,19
1320241,973427,2020-07-23,Assembly,"Assembly Floor Vote - Final Passage",141,0,0,4,145
1320241,973711,2020-07-23,Senate,"Senate Floor Vote - Final Passage",60,0,0,0,60
1320241,973786,2020-07-22,Senate,"Senate Rules Committee Vote",19,0,0,0,19
1320267,939760,2020-02-25,Senate,"Senate Cultural Affairs, Tourism, Parks and Recreation Committee Vote",7,0,0,0,7
1320267,939761,2020-03-02,Senate,"Senate Floor Vote - Final Passage",58,3,0,1,62
1320450,963750,2020-06-09,Assembly,"Assembly Rules Committee: Favorable",27,0,0,4,31
1320450,963751,2020-06-09,Assembly,"Assembly Ways And Means Committee: Favorable refer to committee Rules",32,0,0,3,35
1320482,963784,2020-06-09,Assembly,"Assembly Rules Committee: Favorable",27,0,0,4,31
1320482,963785,2020-06-09,Assembly,"Assembly Ways And Means Committee: Favorable refer to committee Rules",32,0,0,3,35
1320520,964569,2020-06-10,Assembly,"Assembly Rules Committee: Favorable",28,0,0,3,31
1320520,964570,2020-06-10,Assembly,"Assembly Ways And Means Committee: Favorable refer to committee Rules",31,0,0,4,35
1320536,950504,2020-03-10,Assembly,"Assembly Governmental Operations Committee: Favorable",14,0,0,0,14
1320536,965119,2020-06-09,Assembly,"Assembly Floor Vote - Final Passage",143,1,0,3,147
1320537,971821,2020-07-16,Assembly,"Assembly Governmental Employees Committee: Held for Consideration",10,4,0,0,14
1320543,971852,2020-07-17,Assembly,"Assembly Codes Committee: Favorable refer to committee Rules",15,6,0,1,22
1320543,972877,2020-07-22,Assembly,"Assembly Rules Committee: Favorable",22,7,0,1,30
1320586,970820,2020-07-13,Assembly,"Assembly Health Committee: Held for Consideration",17,7,0,2,26
1320617,935005,2020-02-25,Assembly,"Assembly Judiciary Committee: Favorable",18,1,0,2,21
1320698,921225,2020-02-11,Senate,"Senate Health Committee Vote",13,2,0,0,15
1321589,936012,2020-02-26,Assembly,"Assembly Veterans' Affairs Committee: Favorable refer to committee Ways and Means",18,0,0,1,19
1321790,970922,2020-07-13,Assembly,"Assembly Consumer Affairs And Protection Committee: Favorable refer to committee Codes",15,0,0,1,16
1321790,971837,2020-07-17,Assembly,"Assembly Codes Committee: Favorable refer to committee Rules",21,0,0,1,22
1321790,973766,2020-07-21,Assembly,"Assembly Rules Committee: Favorable",26,0,0,4,30
1321799,964158,2020-06-09,Senate,"Senate Floor Vote - Final Passage",62,0,0,0,62
1321799,964756,2020-06-09,Assembly,"Assembly Floor Vote - Final Passage",144,0,0,3,147
1321799,966174,2020-06-08,Senate,"Senate Local Government Committee Vote",7,0,0,0,7
1321799,966377,2020-06-08,Senate,"Senate Local Government Committee Vote",7,0,0,0,7
1321855,971145,2020-07-14,Assembly,"Assembly Election Law Committee: Held for Consideration",12,4,0,0,16
1321980,964123,2020-06-09,Senate,"Senate Floor Vote - Final Passage",62,0,0,0,62
1321980,964741,2020-06-09,Assembly,"Assembly Floor Vote - Final Passage",144,0,0,3,147
1321980,966335,2020-05-28,Senate,"Senate Rules Committee Vote",19,0,0,0,19
1321980,966336,2020-06-08,Senate,"Senate Local Government Committee Vote",7,0,0,0,7
1322072,948946,2020-03-11,Assembly,"Assembly Health Committee: Favorable refer to committee Ways and Means",23,0,0,3,26
1322113,964142,2020-06-09,Senate,"Senate Floor Vote - Final Passage",60,2,0,0,62
1322113,965435,2020-06-10,Assembly,"Assembly Floor Vote - Final Passage",144,0,0,3,147
1322113,966175,2020-06-08,Senate,"Senate Local Government Committee Vote",7,0,0,0,7
1322113,966378,2020-06-08,Senate,"Senate Local Government Committee Vote",7,0,0,0,7
1322385,921344,2020-02-12,Assembly,"Assembly Tourism, Arts And Sports Development Committee: Favorable refer to committee Ways and Means",20,0,0,0,20
1323049,971708,2020-07-16,Assembly,"Assembly Transportation Committee: Favorable refer to committee Ways and Means",22,0,0,2,24
1323049,971755,2020-07-17,Assembly,"Assembly Ways And Means Committee: Favorable refer to committee Rules",32,0,0,2,34
1323049,973069,2020-07-22,Assembly,"Assembly Rules Committee: Favorable",29,0,0,1,30
1323063,972342,2020-07-20,Senate,"Senate Local Government Committee Vote",7,0,0,0,7
1323063,973859,2020-07-21,Senate,"Senate Rules Committee Vote",19,0,0,0,19
1323063,973860,2020-07-22,Senate,"Senate Floor Vote - Final Passage",60,0,0,0,60
1323082,919612,2020-02-10,Senate,"Senate Racing, Gaming and Wagering Committee Vote",6,0,0,1,7
1323218,935830,2020-02-26,Assembly,"Assembly Veterans' Affairs Committee: Favorable",18,0,0,1,19
1323218,944069,2020-03-04,Assembly,"Assembly Floor Vote - Final Passage",138,0,0,9,147
1323352,972922,2020-07-21,Senate,"Senate Finance Committee Vote",23,0,0,0,23
1323352,973853,2020-07-21,Senate,"Senate Finance Committee Vote",23,0,0,0,23
1323352,973854,2020-07-22,Senate,"Senate Floor Vote - Final Passage",60,0,0,0,60
1323396,973461,2020-07-22,Senate,"Senate Floor Vote - Final Passage",40,20,0,0,60
1323396,973802,2020-07-21,Senate,"Senate Rules Committee Vote",13,6,0,0,19
1323396,974058,2020-07-21,Senate,"Senate Rules Committee Vote",13,6,0,0,19
1324089,972945,2020-07-20,Senate,"Senate Environmental Conservation Committee Vote",11,0,0,0,11
1324089,973586,2020-07-22,Senate,"Senate Floor Vote - Final Passage",58,2,0,0,60
1324089,973943,2020-07-21,Senate,"Senate Rules Committee Vote",19,0,0,0,19
1324850,914102,2020-02-04,Assembly,"Assembly Rules Committee: Favorable",27,0,0,4,31
1324850,914103,2020-02-04,Assembly,"Assembly Codes Committee: Favorable refer to committee Rules",19,0,0,3,22
1324850,914104,2020-02-04,Assembly,"Assembly Transportation Committee: Favorable refer to committee Codes",23,1,0,1,25
1324850,915010,2020-02-04,Assembly,"Assembly Floor Vote - Final Passage",137,3,0,8,148
1324850,919072,2020-02-10,Senate,"Senate Floor Vote - Final Passage",61,0,0,1,62
1324949,913987,2020-02-04,Assembly,"Assembly Judiciary Committee: Favorable refer to committee Ways and Means",20,0,0,1,21
1325852,920188,2020-02-11,Assembly,"Assembly Health Committee: Favorable",22,0,0,4,26
1326590,973065,2020-03-10,Senate,"Senate Judiciary Committee Vote",14,0,0,1,15
1326590,973066,2020-07-21,Senate,"Senate Floor Vote - Final Passage",60,0,0,0,60
1326673,922920,2020-02-10,Senate,"Senate Education Committee Vote",15,0,0,0,15
1326673,922921,2020-02-13,Senate,"Senate Floor Vote - Final Passage",57,0,0,5,62
1326681,922562,2020-02-10,Senate,"Senate Education Committee Vote",15,0,0,0,15
1326681,922563,2020-02-13,Senate,"Senate Floor Vote - Final Passage",57,0,0,5,62
1326709,934887,2020-02-10,Senate,"Senate Racing, Gaming and Wagering Committee Vote",6,0,0,1,7
1326709,934888,2020-02-25,Senate,"Senate Floor Vote - Final Passage",59,1,0,2,62
1326709,972594,2020-07-21,Assembly,"Assembly Floor Vote - Final Passage",142,0,0,3,145
1327840,934541,2020-02-25,Assembly,"Assembly Environmental Conservation Committee: Favorable refer to committee Codes",20,7,0,2,29
1327840,940757,2020-03-03,Assembly,"Assembly Codes Committee: Favorable",15,6,0,1,22
1327866,963768,2020-06-09,Assembly,"Assembly Rules Committee: Favorable",27,0,0,4,31
1327866,963769,2020-06-09,Assembly,"Assembly Ways And Means Committee: Favorable refer to committee Rules",32,0,0,3,35
1327866,964621,2020-06-09,Assembly,"Assembly Floor Vote - Final Passage",143,1,0,3,147
1327866,973377,2020-07-22,Senate,"Senate Floor Vote - Final Passage",60,0,0,0,60
1327891,963716,2020-06-09,Assembly,"Assembly Rules Committee: Favorable",27,0,0,4,31
1327891,963717,2020-06-09,Assembly,"Assembly Ways And Means Committee: Favorable refer to committee Rules",32,0,0,3,35
1327891,964592,2020-06-09,Assembly,"Assembly Floor Vote - Final Passage",143,1,0,3,147
1327891,973375,2020-07-22,Senate,"Senate Floor Vote - Final Passage",60,0,0,0,60
1327899,971256,2020-07-14,Assembly,"Assembly Education Committee: Held for Consideration",23,6,0,2,31
1327917,918548,2020-02-10,Senate,"Senate Education Committee Vote",15,0,0,0,15
1327917,935840,2020-02-25,Senate,"Senate Finance Committee Vote",22,0,0,1,23
1327917,942315,2020-03-04,Senate,"Senate Floor Vote - Final Passage",60,2,0,0,62
1327950,973021,2020-03-03,Senate,"Senate Education Committee Vote",15,0,0,0,15
1327950,973022,2020-07-21,Senate,"Senate Floor Vote - Final Passage",60,0,0,0,60
1328003,972303,2020-07-20,Senate,"Senate Local Government Committee Vote",7,0,0,0,7
1328003,973594,2020-07-22,Senate,"Senate Floor Vote - Final Passage",60,0,0,0,60
1328003,973954,2020-07-21,Senate,"Senate Rules Committee Vote",19,0,0,0,19
1328030,942104,2020-03-03,Assembly,"Assembly Banks Committee: Favorable refer to committee Codes",19,7,0,5,31
1328030,972051,2020-07-17,Assembly,"Assembly Codes Committee: Favorable refer to committee Rules",15,6,0,1,22
1328030,972553,2020-07-21,Assembly,"Assembly Rules Committee: Favorable",19,7,0,4,30
1328159,935319,2020-02-25,Assembly,"Assembly Judiciary Committee: Favorable refer to committee Codes",14,5,0,2,21
1328159,940768,2020-03-03,Assembly,"Assembly Codes Committee: Favorable refer to committee Ways and Means",16,5,0,1,22
1328192,971492,2020-07-16,Assembly,"Assembly Transportation Committee: Held for Consideration",16,6,0,2,24
1328406,964614,2020-06-10,Assembly,"Assembly Rules Committee: Favorable",28,0,0,3,31
1328406,964615,2020-06-10,Assembly,"Assembly Ways And Means Committee: Favorable refer to committee Rules",31,0,0,4,35
1328406,965411,2020-06-10,Assembly,"Assembly Floor Vote - Final Passage",138,6,0,3,147
1328406,973529,2020-07-22,Senate,"Senate Floor Vote - Final Passage",60,0,0,0,60
1328416,920054,2020-02-11,Assembly,"Assembly Mental Health Committee: Favorable refer to committee Codes",11,0,0,2,13
1328416,940739,2020-03-03,Assembly,"Assembly Codes Committee: Favorable",21,0,0,1,22
1328416,948917,2020-03-10,Assembly,"Assembly Floor Vote - Final Passage",138,0,0,9,147
1328536,971362,2020-07-14,Assembly,"Assembly Environmental Conservation Committee: Favorable refer to committee Rules",25,2,0,1,28
1328536,973012,2020-07-22,Assembly,"Assembly Rules Committee: Favorable",25,0,0,5,30
1328536,973127,2020-07-22,Assembly,"Assembly Floor Vote - Final Passage",140,2,0,3,145
1328659,932919,2020-02-24,Senate,"Senate Local Government Committee Vote",7,0,0,0,7
1328719,971443,2020-07-16,Assembly,"Assembly Transportation Committee: Favorable refer to committee Codes",22,0,0,2,24
1328719,971882,2020-07-17,Assembly,"Assembly Ways And Means Committee: Favorable refer to committee Rules",27,5,0,2,34
1328719,971883,2020-07-17,Assembly,"Assembly Codes Committee: Favorable refer to committee Ways and Means",18,3,0,1,22
1328719,972567,2020-07-21,Assembly,"Assembly Floor Vote - Final Passage",132,10,0,3,145
1328719,972568,2020-07-21,Assembly,"Assembly Rules Committee: Favorable",26,0,0,4,30
1328719,973420,2020-07-22,Senate,"Senate Floor Vote - Final Passage",60,0,0,0,60
1329072,972961,2020-07-21,Senate,"Senate Finance Committee Vote",23,0,0,0,23
1329072,973608,2020-07-22,Senate,"Senate Floor Vote - Final Passage",60,0,0,0,60
1329072,973609,2020-07-23,Assembly,"Assembly Floor Vote - Final Passage",141,0,0,4,145
1329072,973951,2020-07-21,Senate,"Senate Finance Committee Vote",23,0,0,0,23
1329270,971455,2020-07-15,Assembly,"Assembly Labor Committee: Favorable refer to committee Rules",25,0,0,3,28
1329270,972227,2020-07-20,Assembly,"Assembly Rules Committee: Favorable",27,0,0,3,30
1330012,921445,2020-02-12,Assembly,"Assembly Tourism, Arts And Sports Development Committee: Favorable refer to committee Ways and Means",20,0,0,0,20
1332119,971194,2020-07-14,Assembly,"Assembly Correction Committee: Favorable refer to committee Rules",12,0,0,1,13
1332119,972538,2020-07-21,Assembly,"Assembly Rules Committee: Favorable",26,0,0,4,30
1332119,973136,2020-07-22,Assembly,"Assembly Floor Vote - Final Passage",142,0,0,3,145
1332119,973715,2020-07-23,Senate,"Senate Floor Vote - Final Passage",46,14,0,0,60
1332171,964571,2020-06-10,Assembly,"Assembly Rules Committee: Favorable",28,0,0,3,31
1332171,964572,2020-06-10,Assembly,"Assembly Ways And Means Committee: Favorable refer to committee Rules",31,0,0,4,35
1332242,970805,2020-07-13,Assembly,"Assembly Health Committee: Held for Consideration",17,7,0,2,26
1332315,963730,2020-06-09,Assembly,"Assembly Rules Committee: Favorable",26,1,0,4,31
1332315,963731,2020-06-09,Assembly,"Assembly Ways And Means Committee: Favorable refer to committee Rules",27,5,0,3,35
1332315,964622,2020-06-09,Assembly,"Assembly Floor Vote - Final Passage",110,34,0,3,147
1332315,973204,2020-07-22,Senate,"Senate Floor Vote - Final Passage",39,21,0,0,60
1332551,933871,2020-02-25,Assembly,"Assembly Agriculture Committee: Favorable",19,0,0,2,21
1332882,934737,2020-02-25,Assembly,"Assembly Energy Committee: Favorable",16,0,0,0,16
1333898,963669,2020-06-08,Assembly,"Assembly Governmental Operations Committee: Favorable refer to committee Rules",13,1,0,0,14
1333898,963781,2020-06-09,Assembly,"Assembly Rules Committee: Favorable",27,0,0,4,31
1334020,919632,2020-02-11,Assembly,"Assembly Economic Development Committee: Favorable refer to committee Ways and Means",17,6,0,3,26
1334116,972959,2020-07-21,Senate,"Senate Social Services Committee Vote",7,0,0,0,7
1334116,973602,2020-07-22,Senate,"Senate Floor Vote - Final Passage",50,10,0,0,60
1334116,973948,2020-07-21,Senate,"Senate Rules Committee Vote",15,4,0,0,19
1334390,935672,2020-02-25,Senate,"Senate Transportation Committee Vote",15,0,0,0,15
1334402,935508,2020-02-25,Senate,"Senate Health Committee Vote",13,2,0,0,15
1334402,941050,2020-03-03,Senate,"Senate Finance Committee Vote",20,3,0,0,23
1334444,934610,2020-02-25,Senate,"Senate Judiciary Committee Vote",14,0,0,1,15
1334444,973170,2020-07-22,Senate,"Senate Floor Vote - Final Passage",54,6,0,0,60
1334444,973354,2020-07-22,Senate,"Senate Rules Committee Vote",17,2,0,0,19
1334444,973519,2020-07-23,Assembly,"Assembly Floor Vote - Final Passage",141,0,0,4,145
1334491,971282,2020-07-15,Assembly,"Assembly Racing And Wagering Committee: Favorable refer to committee Rules",11,0,0,0,11
1334491,972165,2020-07-20,Assembly,"Assembly Rules Committee: Favorable",27,0,0,3,30
1334536,942930,2020-03-04,Senate,"Senate Aging Committee Vote",7,0,0,0,7
1334628,971329,2020-07-14,Assembly,"Assembly Higher Education Committee: Favorable refer to committee Rules",22,3,0,0,25
1334628,973767,2020-07-21,Assembly,"Assembly Rules Committee: Favorable",26,0,0,4,30
1334760,964118,2020-06-09,Senate,"Senate Floor Vote - Final Passage",62,0,0,0,62
1334760,964748,2020-06-09,Assembly,"Assembly Floor Vote - Final Passage",144,0,0,3,147
1334760,966373,2020-05-28,Senate,"Senate Rules Committee Vote",19,0,0,0,19
1334760,966374,2020-06-08,Senate,"Senate Local Government Committee Vote",7,0,0,0,7
1334824,973741,2020-07-22,Senate,"Senate Rules Committee Vote",14,5,0,0,19
1334824,973742,2020-07-23,Senate,"Senate Floor Vote - Final Passage",43,17,0,0,60
1334913,972351,2020-03-04,Senate,"Senate Aging Committee Vote",7,0,0,0,7
1334913,972518,2020-07-21,Senate,"Senate Floor Vote - Final Passage",60,0,0,0,60
1334988,935370,2020-02-26,Assembly,"Assembly Insurance Committee: Favorable refer to committee Codes",14,6,0,2,22
1334988,940720,2020-03-03,Assembly,"Assembly Codes Committee: Favorable",16,5,0,1,22
1334988,972983,2020-07-21,Assembly,"Assembly Floor Vote - Final Passage",102,40,0,3,145
1334988,973660,2020-07-22,Senate,"Senate Floor Vote - Final Passage",60,0,0,0,60
1335005,933479,2020-02-25,Assembly,"Assembly Environmental Conservation Committee: Favorable",26,1,0,2,29
1335005,950160,2020-03-11,Assembly,"Assembly Floor Vote - Final Passage",134,3,0,10,147
1335025,935257,2020-02-26,Assembly,"Assembly Insurance Committee: Favorable",14,6,0,2,22
1335106,936469,2020-02-26,Assembly,"Assembly Insurance Committee: Favorable refer to committee Codes",14,6,0,2,22
1335106,940734,2020-03-03,Assembly,"Assembly Codes Committee: Favorable",15,6,0,1,22
1335281,935513,2020-02-26,Assembly,"Assembly Insurance Committee: Favorable refer to committee Codes",14,6,0,2,22
1335281,940667,2020-03-03,Assembly,"Assembly Codes Committee: Favorable",15,6,0,1,22
1335617,972407,2020-03-02,Senate,"Senate Racing, Gaming and Wagering Committee Vote",7,0,0,0,7
1335617,972408,2020-07-21,Senate,"Senate Floor Vote - Final Passage",60,0,0,0,60
1335772,971425,2020-07-16,Assembly,"Assembly Governmental Operations Committee: Favorable refer to committee Ways and Means",14,0,0,0,14
1335772,971832,2020-07-17,Assembly,"Assembly Ways And Means Committee: Favorable refer to committee Rules",32,0,0,2,34
1335772,972585,2020-07-21,Assembly,"Assembly Floor Vote - Final Passage",142,0,0,3,145
1335772,972586,2020-07-21,Assembly,"Assembly Rules Committee: Favorable",26,0,0,4,30
1335772,973536,2020-07-22,Senate,"Senate Floor Vote - Final Passage",60,0,0,0,60
1335792,935471,2020-02-26,Assembly,"Assembly Corporations, Authorities And Commissions Committee: Favorable refer to committee Ways and Means",25,0,0,1,26
1335856,942113,2020-03-03,Assembly,"Assembly Children And Families Committee: Favorable refer to committee Codes",11,4,0,1,16
1335856,972015,2020-07-17,Assembly,"Assembly Codes Committee: Favorable refer to committee Rules",15,6,0,1,22
1335954,933549,2020-02-25,Assembly,"Assembly Judiciary Committee: Favorable",19,0,0,2,21
1335975,935001,2020-02-25,Assembly,"Assembly Judiciary Committee: Favorable",19,0,0,2,21
1336064,972781,2020-07-20,Senate,"Senate Investigations and Government Operations Committee Vote",4,2,0,0,6
1336064,974069,2020-07-22,Senate,"Senate Floor Vote - Final Passage",44,16,0,0,60
1336064,974070,2020-07-22,Senate,"Senate Rules Committee Vote",18,1,0,0,19
1336084,934878,2020-02-25,Assembly,"Assembly Labor Committee: Favorable",28,0,0,1,29
1336112,935311,2020-02-25,Assembly,"Assembly Judiciary Committee: Favorable",19,0,0,2,21
1336184,964099,2020-06-09,Senate,"Senate Floor Vote - Final Passage",62,0,0,0,62
1336184,964727,2020-06-09,Assembly,"Assembly Floor Vote - Final Passage",144,0,0,3,147
1336184,966331,2020-05-28,Senate,"Senate Rules Committee Vote",19,0,0,0,19
1336184,966332,2020-06-08,Senate,"Senate Local Government Committee Vote",7,0,0,0,7
1336276,972444,2020-02-25,Senate,"Senate Crime Victims, Crime and Correction Committee Vote",7,0,0,0,7
1336276,972445,2020-07-21,Senate,"Senate Floor Vote - Final Passage",60,0,0,0,60
1336317,972631,2020-07-20,Senate,"Senate Investigations and Government Operations Committee Vote",4,2,0,0,6
1336317,973130,2020-07-22,Senate,"Senate Floor Vote - Final Passage",48,12,0,0,60
1336317,973263,2020-07-22,Senate,"Senate Rules Committee Vote",18,1,0,0,19
1336531,960592,2020-05-27,Assembly,"Assembly Ways And Means Committee: Favorable refer to committee Rules",24,9,0,2,35
1336531,960674,2020-05-27,Assembly,"Assembly Rules Committee: Favorable",28,1,0,2,31
1337226,973874,2020-07-20,Senate,"Senate Transportation Committee Vote",15,0,0,0,15
1337226,973875,2020-07-21,Senate,"Senate Rules Committee Vote",19,0,0,0,19
1337226,973876,2020-07-22,Senate,"Senate Floor Vote - Final Passage",60,0,0,0,60
1337478,972769,2020-07-20,Senate,"Senate Investigations and Government Operations Committee Vote",5,1,0,0,6
1337478,973189,2020-07-22,Senate,"Senate Floor Vote - Final Passage",40,20,0,0,60
1337478,973287,2020-07-22,Senate,"Senate Rules Committee Vote",15,4,0,0,19
1337478,973403,2020-07-23,Assembly,"Assembly Floor Vote - Final Passage",113,28,0,4,145
1337913,964093,2020-06-09,Senate,"Senate Floor Vote - Final Passage",62,0,0,0,62
1337913,964719,2020-06-09,Assembly,"Assembly Floor Vote - Final Passage",138,6,0,3,147
1337913,966310,2020-05-28,Senate,"Senate Rules Committee Vote",19,0,0,0,19
1337913,966311,2020-06-08,Senate,"Senate Local Government Committee Vote",7,0,0,0,7
1338069,963779,2020-06-09,Assembly,"Assembly Rules Committee: Favorable",27,0,0,4,31
1338069,963780,2020-06-09,Assembly,"Assembly Ways And Means Committee: Favorable refer to committee Rules",29,3,0,3,35
1338198,963810,2020-06-09,Assembly,"Assembly Rules Committee: Favorable",27,0,0,4,31
1338198,963811,2020-06-09,Assembly,"Assembly Ways And Means Committee: Favorable refer to committee Rules",32,0,0,3,35
1338213,971794,2020-07-16,Assembly,"Assembly Local Governments Committee: Held for Consideration",15,4,0,1,20
1338352,964121,2020-06-09,Senate,"Senate Floor Vote - Final Passage",62,0,0,0,62
1338352,966361,2020-05-28,Senate,"Senate Rules Committee Vote",19,0,0,0,19
1338352,966362,2020-06-08,Senate,"Senate Local Government Committee Vote",7,0,0,0,7
1338376,949099,2020-03-11,Assembly,"Assembly Local Governments Committee: Favorable refer to committee Ways and Means",16,0,0,2,18
1338410,949228,2020-03-11,Assembly,"Assembly Tourism, Arts And Sports Development Committee: Favorable",20,0,0,0,20
1338410,972601,2020-07-21,Assembly,"Assembly Floor Vote - Final Passage",141,1,0,3,145
1338425,963720,2020-06-09,Assembly,"Assembly Rules Committee: Favorable",26,1,0,4,31
1338425,963721,2020-06-09,Assembly,"Assembly Ways And Means Committee: Favorable refer to committee Rules",27,5,0,3,35
1338425,964558,2020-06-09,Assembly,"Assembly Floor Vote - Final Passage",107,37,0,3,147
1338425,973216,2020-07-22,Senate,"Senate Floor Vote - Final Passage",44,16,0,0,60
1338476,971287,2020-07-14,Assembly,"Assembly Higher Education Committee: Favorable refer to committee Ways and Means",25,0,0,0,25
1338476,971873,2020-07-17,Assembly,"Assembly Ways And Means Committee: Favorable refer to committee Rules",32,0,0,2,34
1338476,972580,2020-07-21,Assembly,"Assembly Floor Vote - Final Passage",142,0,0,3,145
1338476,972581,2020-07-21,Assembly,"Assembly Rules Committee: Favorable",26,0,0,4,30
1338476,973439,2020-07-22,Senate,"Senate Floor Vote - Final Passage",60,0,0,0,60
1338500,970752,2020-07-13,Assembly,"Assembly Health Committee: Held for Consideration",18,6,0,2,26
1338534,963704,2020-06-09,Assembly,"Assembly Rules Committee: Favorable",27,0,0,4,31
1338534,963705,2020-06-09,Assembly,"Assembly Ways And Means Committee: Favorable refer to committee Rules",32,0,0,3,35
1338549,963774,2020-06-09,Assembly,"Assembly Rules Committee: Favorable",27,0,0,4,31
1338549,963775,2020-06-09,Assembly,"Assembly Ways And Means Committee: Favorable refer to committee Rules",31,1,0,3,35
1338549,964635,2020-06-09,Assembly,"Assembly Floor Vote - Final Passage",143,1,0,3,147
1338549,973654,2020-07-23,Senate,"Senate Floor Vote - Final Passage",59,1,0,0,60
1340230,973374,2020-07-22,Senate,"Senate Rules Committee Vote",14,5,0,0,19
1340230,973700,2020-07-23,Senate,"Senate Floor Vote - Final Passage",40,20,0,0,60
1340337,973244,2020-07-22,Senate,"Senate Rules Committee Vote",14,5,0,0,19
1340337,973621,2020-07-23,Senate,"Senate Floor Vote - Final Passage",43,17,0,0,60
1340599,972269,2020-07-20,Senate,"Senate Local Government Committee Vote",7,0,0,0,7
1340599,973485,2020-07-22,Senate,"Senate Floor Vote - Final Passage",60,0,0,0,60
1340599,973817,2020-07-21,Senate,"Senate Rules Committee Vote",19,0,0,0,19
1340745,934632,2020-02-25,Senate,"Senate Cultural Affairs, Tourism, Parks and Recreation Committee Vote",7,0,0,0,7
1340745,941598,2020-03-03,Senate,"Senate Finance Committee Vote",23,0,0,0,23
1340745,972791,2020-07-21,Senate,"Senate Floor Vote - Final Passage",60,0,0,0,60
1342257,935597,2020-02-25,Senate,"Senate Children and Families Committee Vote",7,0,0,0,7
1342257,940921,2020-03-03,Senate,"Senate Finance Committee Vote",23,0,0,0,23
1342352,935332,2020-02-25,Senate,"Senate Health Committee Vote",15,0,0,0,15
1342352,940925,2020-03-03,Senate,"Senate Finance Committee Vote",23,0,0,0,23
1342549,972641,2020-07-21,Senate,"Senate Finance Committee Vote",22,1,0,0,23
1342549,973321,2020-07-22,Senate,"Senate Rules Committee Vote",19,0,0,0,19
1342549,974200,2020-07-22,Senate,"Senate Rules Committee Vote",19,0,0,0,19
1342549,974201,2020-07-23,Senate,"Senate Floor Vote - Final Passage",60,0,0,0,60
1343375,972789,2020-07-20,Senate,"Senate Investigations and Government Operations Committee Vote",4,2,0,0,6
1343375,974071,2020-07-22,Senate,"Senate Floor Vote - Final Passage",44,16,0,0,60
1343375,974072,2020-07-22,Senate,"Senate Rules Committee Vote",18,1,0,0,19
1343574,963786,2020-06-09,Assembly,"Assembly Rules Committee: Favorable",27,0,0,4,31
1343574,963787,2020-06-09,Assembly,"Assembly Ways And Means Committee: Favorable refer to committee Rules",32,0,0,3,35
1343651,933477,2020-02-25,Assembly,"Assembly Housing Committee: Favorable refer to committee Ways and Means",26,0,0,2,28
1343733,933994,2020-02-25,Assembly,"Assembly Environmental Conservation Committee: Favorable",27,0,0,2,29
1343888,933467,2020-02-25,Assembly,"Assembly Environmental Conservation Committee: Favorable",21,6,0,2,29
1344868,934210,2020-02-25,Assembly,"Assembly Cities Committee: Favorable",14,0,0,1,15
1344921,964141,2020-06-09,Senate,"Senate Floor Vote - Final Passage",62,0,0,0,62
1344921,964503,2020-06-09,Assembly,"Assembly Floor Vote - Final Passage",143,1,0,3,147
1344921,966206,2020-05-28,Senate,"Senate Rules Committee Vote",19,0,0,0,19
1344921,966207,2020-06-08,Senate,"Senate Investigations and Government Operations Committee Vote",7,0,0,0,7
1344933,935638,2020-02-26,Assembly,"Assembly Corporations, Authorities And Commissions Committee: Favorable refer to committee Ways and Means",25,0,0,1,26
1344935,935847,2020-02-26,Assembly,"Assembly Corporations, Authorities And Commissions Committee: Favorable refer to committee Codes",22,3,0,1,26
1344997,972926,2020-07-21,Senate,"Senate Finance Committee Vote",23,0,0,0,23
1344997,973879,2020-07-21,Senate,"Senate Finance Committee Vote",23,0,0,0,23
1344997,973880,2020-07-22,Senate,"Senate Floor Vote - Final Passage",60,0,0,0,60
1345008,972783,2020-07-20,Senate,"Senate Investigations and Government Operations Committee Vote",5,1,0,0,6
1345008,974073,2020-07-22,Senate,"Senate Floor Vote - Final Passage",39,21,0,0,60
1345008,974074,2020-07-22,Senate,"Senate Rules Committee Vote",16,3,0,0,19
1345033,948177,2020-03-10,Assembly,"Assembly Transportation Committee: Favorable refer to committee Ways and Means",24,1,0,0,25
1345033,972017,2020-07-17,Assembly,"Assembly Ways And Means Committee: Favorable refer to committee Rules",32,0,0,2,34
1345033,972179,2020-07-20,Assembly,"Assembly Rules Committee: Favorable",27,0,0,3,30
1345033,972652,2020-07-21,Assembly,"Assembly Floor Vote - Final Passage",142,0,0,3,145
1345080,963793,2020-06-09,Assembly,"Assembly Rules Committee: Favorable",27,0,0,4,31
1345080,963794,2020-06-09,Assembly,"Assembly Ways And Means Committee: Favorable refer to committee Rules",32,0,0,3,35
1345118,935350,2020-02-26,Assembly,"Assembly Education Committee: Favorable",31,0,0,0,31
1345161,971307,2020-07-14,Assembly,"Assembly Higher Education Committee: Held for Consideration",18,7,0,0,25
1345202,935921,2020-02-26,Assembly,"Assembly Education Committee: Favorable refer to committee Ways and Means",31,0,0,0,31
1345228,936129,2020-02-26,Assembly,"Assembly Election Law Committee: Favorable",15,0,0,1,16
1346166,964063,2020-06-09,Senate,"Senate Floor Vote - Final Passage",62,0,0,0,62
1346166,966341,2020-05-28,Senate,"Senate Rules Committee Vote",19,0,0,0,19
1346166,966342,2020-06-08,Senate,"Senate Local Government Committee Vote",7,0,0,0,7
1348099,971472,2020-07-16,Assembly,"Assembly Transportation Committee: Favorable refer to committee Rules",22,0,0,2,24
1348099,972200,2020-07-20,Assembly,"Assembly Rules Committee: Favorable",27,0,0,3,30
1348099,972724,2020-07-21,Assembly,"Assembly Floor Vote - Final Passage",142,0,0,3,145
1348287,948248,2020-03-10,Senate,"Senate Civil Service and Pensions Committee Vote",6,1,0,0,7
1348383,948218,2020-03-10,Assembly,"Assembly Transportation Committee: Favorable",25,0,0,0,25
1348465,948230,2020-03-10,Senate,"Senate Health Committee Vote",14,0,0,1,15
1349223,939662,2020-03-02,Senate,"Senate Agriculture Committee Vote",9,0,0,0,9
1349255,949167,2020-03-11,Assembly,"Assembly Health Committee: Favorable refer to committee Ways and Means",23,0,0,3,26
1349255,972028,2020-07-17,Assembly,"Assembly Ways And Means Committee: Favorable refer to committee Rules",32,0,0,2,34
1350172,972332,2020-07-20,Senate,"Senate Local Government Committee Vote",7,0,0,0,7
1350172,973868,2020-07-21,Senate,"Senate Rules Committee Vote",19,0,0,0,19
1350172,973869,2020-07-22,Senate,"Senate Floor Vote - Final Passage",60,0,0,0,60
1350256,965205,2020-03-03,Senate,"Senate Labor Committee Vote",13,0,0,0,13
1350256,965206,2020-06-09,Senate,"Senate Floor Vote - Final Passage",61,1,0,0,62
1350256,965387,2020-06-10,Assembly,"Assembly Floor Vote - Final Passage",112,32,0,3,147
1350818,949182,2020-03-11,Assembly,"Assembly Health Committee: Favorable refer to committee Codes",23,0,0,3,26
1350894,964112,2020-06-09,Senate,"Senate Floor Vote - Final Passage",62,0,0,0,62
1350894,966381,2020-05-28,Senate,"Senate Rules Committee Vote",19,0,0,0,19
1350894,966382,2020-06-08,Senate,"Senate Transportation Committee Vote",15,0,0,0,15
1351680,963412,2020-06-08,Assembly,"Assembly Governmental Operations Committee: Favorable refer to committee Rules",13,1,0,0,14
1351680,963817,2020-06-09,Assembly,"Assembly Rules Committee: Favorable",27,0,0,4,31
1351680,964629,2020-06-09,Assembly,"Assembly Floor Vote - Final Passage",143,1,0,3,147
1351680,973540,2020-07-22,Senate,"Senate Floor Vote - Final Passage",60,0,0,0,60
1351715,963758,2020-06-09,Assembly,"Assembly Rules Committee: Favorable",27,0,0,4,31
1351715,963759,2020-06-09,Assembly,"Assembly Ways And Means Committee: Favorable refer to committee Rules",31,1,0,3,35
1351715,964617,2020-06-09,Assembly,"Assembly Floor Vote - Final Passage",143,1,0,3,147
1351715,973474,2020-07-22,Senate,"Senate Floor Vote - Final Passage",60,0,0,0,60
1351722,963760,2020-06-09,Assembly,"Assembly Rules Committee: Favorable",27,0,0,4,31
1351722,963761,2020-06-09,Assembly,"Assembly Ways And Means Committee: Favorable refer to committee Rules",31,1,0,3,35
1351722,964623,2020-06-09,Assembly,"Assembly Floor Vote - Final Passage",143,1,0,3,147
1351722,973570,2020-07-23,Senate,"Senate Floor Vote - Final Passage",60,0,0,0,60
1351758,971936,2020-07-17,Assembly,"Assembly Ways And Means Committee: Favorable refer to committee Rules",32,0,0,2,34
1351758,972230,2020-07-20,Assembly,"Assembly Rules Committee: Favorable",27,0,0,3,30
1351758,972736,2020-07-21,Assembly,"Assembly Floor Vote - Final Passage",142,0,0,3,145
1351758,973436,2020-07-22,Senate,"Senate Floor Vote - Final Passage",60,0,0,0,60
1351774,971288,2020-07-15,Assembly,"Assembly Labor Committee: Favorable refer to committee Ways and Means",25,0,0,3,28
1351774,971895,2020-07-17,Assembly,"Assembly Ways And Means Committee: Favorable refer to committee Rules",32,0,0,2,34
1351774,972542,2020-07-21,Assembly,"Assembly Floor Vote - Final Passage",140,2,0,3,145
1351774,972543,2020-07-21,Assembly,"Assembly Rules Committee: Favorable",26,0,0,4,30
1351791,963392,2020-06-08,Assembly,"Assembly Governmental Operations Committee: Favorable refer to committee Rules",13,1,0,0,14
1351791,963799,2020-06-09,Assembly,"Assembly Rules Committee: Favorable",27,0,0,4,31
1351805,963823,2020-06-09,Assembly,"Assembly Rules Committee: Favorable",27,0,0,4,31
1351805,963824,2020-06-09,Assembly,"Assembly Ways And Means Committee: Favorable refer to committee Rules",32,0,0,3,35
1351835,972956,2020-07-20,Senate,"Senate Investigations and Government Operations Committee Vote",5,1,0,0,6
1351835,973916,2020-07-21,Senate,"Senate Rules Committee Vote",19,0,0,0,19
1351835,973917,2020-07-22,Senate,"Senate Floor Vote - Final Passage",60,0,0,0,60
1351846,964117,2020-06-09,Senate,"Senate Floor Vote - Final Passage",43,19,0,0,62
1351846,966255,2020-05-28,Senate,"Senate Rules Committee Vote",16,3,0,0,19
1351846,966256,2020-06-08,Senate,"Senate Local Government Committee Vote",5,2,0,0,7
1351856,971786,2020-07-16,Assembly,"Assembly Governmental Employees Committee: Held for Consideration",10,4,0,0,14
1351891,971202,2020-07-14,Assembly,"Assembly Judiciary Committee: Favorable refer to committee Rules",20,1,0,0,21
1352527,972939,2020-07-20,Senate,"Senate Health Committee Vote",14,0,0,1,15
1352527,973892,2020-07-21,Senate,"Senate Rules Committee Vote",19,0,0,0,19
1352527,973893,2020-07-22,Senate,"Senate Floor Vote - Final Passage",60,0,0,0,60
1352939,972317,2020-07-20,Senate,"Senate Insurance Committee Vote",11,0,0,0,11
1352939,973890,2020-07-21,Senate,"Senate Rules Committee Vote",19,0,0,0,19
1352939,973891,2020-07-22,Senate,"Senate Floor Vote - Final Passage",60,0,0,0,60
1352972,964124,2020-06-09,Senate,"Senate Floor Vote - Final Passage",62,0,0,0,62
1352972,964736,2020-06-09,Assembly,"Assembly Floor Vote - Final Passage",144,0,0,3,147
1352972,966249,2020-05-28,Senate,"Senate Rules Committee Vote",19,0,0,0,19
1352983,973503,2020-07-22,Senate,"Senate Floor Vote - Final Passage",57,3,0,0,60
1352983,973830,2020-07-20,Senate,"Senate Transportation Committee Vote",15,0,0,0,15
1352983,973831,2020-07-21,Senate,"Senate Rules Committee Vote",19,0,0,0,19
1353068,963814,2020-06-09,Assembly,"Assembly Rules Committee: Favorable",27,0,0,4,31
1353068,963815,2020-06-09,Assembly,"Assembly Ways And Means Committee: Favorable refer to committee Rules",32,0,0,3,35
1353289,964172,2020-06-09,Senate,"Senate Floor Vote - Final Passage",62,0,0,0,62
1353289,964642,2020-06-09,Assembly,"Assembly Floor Vote - Final Passage",144,0,0,3,147
1353289,966250,2020-05-28,Senate,"Senate Rules Committee Vote",19,0,0,0,19
1353289,966251,2020-06-08,Senate,"Senate Transportation Committee Vote",15,0,0,0,15
1353883,964720,2020-06-10,Senate,"Senate Floor Vote - Final Passage",61,1,0,0,62
1353883,966314,2020-05-28,Senate,"Senate Rules Committee Vote",19,0,0,0,19
1353883,966315,2020-06-08,Senate,"Senate Local Government Committee Vote",7,0,0,0,7
1354039,940926,2020-03-03,Assembly,"Assembly Higher Education Committee: Favorable refer to committee Rules",23,0,0,2,25
1354039,940927,2020-03-03,Assembly,"Assembly Rules Committee: Favorable",25,0,0,6,31
1354039,940928,2020-03-03,Assembly,"Assembly Education Committee: Favorable refer to committee Higher Education",26,0,0,5,31
1354039,942291,2020-03-03,Assembly,"Assembly Floor Vote - Final Passage",138,1,0,8,147
1354194,940572,2020-03-02,Senate,"Senate Floor Vote - Final Passage",53,4,0,5,62
1354194,940678,2020-03-02,Senate,"Senate Rules Committee Vote",19,0,0,0,19
1354194,940679,2020-03-03,Assembly,"Assembly Floor Vote - Final Passage",122,12,0,13,147
1354317,940573,2020-03-02,Assembly,"Assembly Rules Committee: Favorable",28,1,0,2,31
1354317,940574,2020-03-02,Assembly,"Assembly Rules Committee: Favorable",29,0,0,2,31
1354317,940575,2020-03-02,Assembly,"Assembly Ways And Means Committee: Favorable refer to committee Rules",32,0,0,3,35
1354317,946185,2020-03-02,Assembly,"Assembly Floor Vote - Final Passage",47,85,2,13,147
1354658,964120,2020-06-09,Senate,"Senate Floor Vote - Final Passage",62,0,0,0,62
1354658,965416,2020-06-10,Assembly,"Assembly Floor Vote - Final Passage",144,0,0,3,147
1354658,966348,2020-05-28,Senate,"Senate Rules Committee Vote",19,0,0,0,19
1354658,966349,2020-06-08,Senate,"Senate Transportation Committee Vote",15,0,0,0,15
1354667,972936,2020-07-20,Senate,"Senate Children and Families Committee Vote",7,0,0,0,7
1354667,973884,2020-07-21,Senate,"Senate Rules Committee Vote",19,0,0,0,19
1354667,973885,2020-07-22,Senate,"Senate Floor Vote - Final Passage",60,0,0,0,60
1354696,973587,2020-07-22,Senate,"Senate Floor Vote - Final Passage",47,13,0,0,60
1354696,973936,2020-07-20,Senate,"Senate Judiciary Committee Vote",13,2,0,0,15
1354696,973937,2020-07-21,Senate,"Senate Rules Committee Vote",17,2,0,0,19
1354787,973294,2020-07-23,Assembly,"Assembly Rules Committee: Favorable",27,1,0,2,30
1354787,973295,2020-07-23,Assembly,"Assembly Ways And Means Committee: Favorable refer to committee Rules",27,6,0,1,34
1354872,971132,2020-07-14,Assembly,"Assembly Correction Committee: Favorable refer to committee Rules",12,0,0,1,13
1354872,972809,2020-07-21,Assembly,"Assembly Floor Vote - Final Passage",142,0,0,3,145
1354872,972810,2020-07-21,Assembly,"Assembly Rules Committee: Favorable",26,0,0,4,30
1354886,972932,2020-07-20,Senate,"Senate Children and Families Committee Vote",7,0,0,0,7
1354886,973593,2020-07-22,Senate,"Senate Floor Vote - Final Passage",54,6,0,0,60
1354886,973932,2020-07-21,Senate,"Senate Rules Committee Vote",18,1,0,0,19
1354895,971966,2020-07-17,Assembly,"Assembly Ways And Means Committee: Favorable refer to committee Rules",32,0,0,2,34
1354895,972190,2020-07-20,Assembly,"Assembly Rules Committee: Favorable",27,0,0,3,30
1354895,973148,2020-07-22,Assembly,"Assembly Floor Vote - Final Passage",142,0,0,3,145
1354895,973719,2020-07-22,Senate,"Senate Floor Vote - Final Passage",60,0,0,0,60
1355276,963746,2020-06-09,Assembly,"Assembly Rules Committee: Favorable",27,0,0,4,31
1355276,963747,2020-06-09,Assembly,"Assembly Ways And Means Committee: Favorable refer to committee Rules",30,2,0,3,35
1355276,965341,2020-06-10,Assembly,"Assembly Floor Vote - Final Passage",140,4,0,3,147
1355322,971433,2020-07-16,Assembly,"Assembly Transportation Committee: Favorable refer to committee Ways and Means",22,0,0,2,24
1355322,971862,2020-07-17,Assembly,"Assembly Ways And Means Committee: Favorable refer to committee Rules",32,0,0,2,34
1355323,971442,2020-07-16,Assembly,"Assembly Real Property Taxation Committee: Favorable refer to committee Ways and Means",10,0,0,0,10
1355323,971870,2020-07-17,Assembly,"Assembly Ways And Means Committee: Favorable refer to committee Rules",32,0,0,2,34
1355362,972638,2020-07-20,Senate,"Senate Investigations and Government Operations Committee Vote",4,2,0,0,6
1355362,973133,2020-07-22,Senate,"Senate Floor Vote - Final Passage",49,11,0,0,60
1355362,973270,2020-07-22,Senate,"Senate Rules Committee Vote",18,1,0,0,19
1355366,963800,2020-06-09,Assembly,"Assembly Rules Committee: Favorable",27,0,0,4,31
1355366,963801,2020-06-09,Assembly,"Assembly Ways And Means Committee: Favorable refer to committee Rules",32,0,0,3,35
1355400,964115,2020-06-09,Senate,"Senate Floor Vote - Final Passage",60,2,0,0,62
1355400,966339,2020-05-28,Senate,"Senate Rules Committee Vote",19,0,0,0,19
1355400,966340,2020-06-08,Senate,"Senate Local Government Committee Vote",7,0,0,0,7
1355400,972756,2020-07-21,Assembly,"Assembly Floor Vote - Final Passage",142,0,0,3,145
1355431,971129,2020-07-14,Assembly,"Assembly Judiciary Committee: Favorable refer to committee Codes",21,0,0,0,21
1355431,971880,2020-07-17,Assembly,"Assembly Codes Committee: Favorable refer to committee Rules",21,0,0,1,22
1355431,972551,2020-07-21,Assembly,"Assembly Floor Vote - Final Passage",142,0,0,3,145
1355431,972552,2020-07-21,Assembly,"Assembly Rules Committee: Favorable",26,0,0,4,30
1355431,973417,2020-07-22,Senate,"Senate Floor Vote - Final Passage",60,0,0,0,60
1355461,964566,2020-06-10,Assembly,"Assembly Rules Committee: Favorable",28,0,0,3,31
1355461,964567,2020-06-10,Assembly,"Assembly Ways And Means Committee: Favorable refer to committee Rules",31,0,0,4,35
1355461,965283,2020-06-10,Assembly,"Assembly Floor Vote - Final Passage",141,3,0,3,147
1355461,973483,2020-07-22,Senate,"Senate Floor Vote - Final Passage",60,0,0,0,60
1355476,970781,2020-07-13,Assembly,"Assembly Health Committee: Favorable refer to committee Codes",24,0,0,2,26
1355476,971851,2020-07-17,Assembly,"Assembly Codes Committee: Favorable refer to committee Rules",21,0,0,1,22
1355476,973023,2020-07-22,Assembly,"Assembly Rules Committee: Favorable",25,0,0,5,30
1355476,973125,2020-07-22,Assembly,"Assembly Floor Vote - Final Passage",142,0,0,3,145
1355476,973577,2020-07-22,Senate,"Senate Floor Vote - Final Passage",60,0,0,0,60
1355507,971118,2020-07-14,Assembly,"Assembly Environmental Conservation Committee: Favorable refer to committee Codes",23,4,0,1,28
1355507,971845,2020-07-17,Assembly,"Assembly Codes Committee: Favorable refer to committee Rules",21,0,0,1,22
1355507,973015,2020-07-22,Assembly,"Assembly Rules Committee: Favorable",25,0,0,5,30
1355507,973123,2020-07-22,Assembly,"Assembly Floor Vote - Final Passage",140,2,0,3,145
1355507,973385,2020-07-22,Senate,"Senate Floor Vote - Final Passage",60,0,0,0,60
1355539,971071,2020-07-14,Assembly,"Assembly Higher Education Committee: Favorable refer to committee Ways and Means",25,0,0,0,25
1355539,971864,2020-07-17,Assembly,"Assembly Ways And Means Committee: Favorable refer to committee Rules",32,0,0,2,34
1355539,972192,2020-07-20,Assembly,"Assembly Rules Committee: Favorable",27,0,0,3,30
1355539,972615,2020-07-21,Assembly,"Assembly Floor Vote - Final Passage",142,0,0,3,145
1355539,973414,2020-07-22,Senate,"Senate Floor Vote - Final Passage",59,1,0,0,60
1355562,964589,2020-06-10,Assembly,"Assembly Rules Committee: Favorable",28,0,0,3,31
1355562,964590,2020-06-10,Assembly,"Assembly Ways And Means Committee: Favorable refer to committee Rules",31,0,0,4,35
1355584,963686,2020-06-09,Assembly,"Assembly Ways And Means Committee: Favorable refer to committee Rules",23,9,0,3,35
1355584,963776,2020-06-09,Assembly,"Assembly Rules Committee: Favorable",20,7,0,4,31
1355601,970831,2020-07-13,Assembly,"Assembly Health Committee: Held for Consideration",18,6,0,2,26
1355619,964697,2020-06-10,Assembly,"Assembly Rules Committee: Favorable",27,1,0,3,31
1355619,964698,2020-06-10,Assembly,"Assembly Ways And Means Committee: Favorable refer to committee Rules",26,5,0,4,35
1355619,965288,2020-06-10,Assembly,"Assembly Floor Vote - Final Passage",114,30,0,3,147
1355619,973389,2020-07-22,Senate,"Senate Floor Vote - Final Passage",44,16,0,0,60
1355629,949183,2020-03-11,Assembly,"Assembly Local Governments Committee: Favorable refer to committee Ways and Means",16,0,0,2,18
1355666,971289,2020-07-14,Assembly,"Assembly Energy Committee: Favorable refer to committee Ways and Means",15,0,0,0,15
1355666,971885,2020-07-17,Assembly,"Assembly Ways And Means Committee: Favorable refer to committee Rules",32,0,0,2,34
1355676,971706,2020-07-16,Assembly,"Assembly Local Governments Committee: Favorable refer to committee Ways and Means",18,1,0,1,20
1355676,971759,2020-07-17,Assembly,"Assembly Ways And Means Committee: Favorable refer to committee Rules",32,0,0,2,34
1355676,972562,2020-07-21,Assembly,"Assembly Floor Vote - Final Passage",141,1,0,3,145
1355676,972563,2020-07-21,Assembly,"Assembly Rules Committee: Favorable",26,0,0,4,30
1355676,973416,2020-07-22,Senate,"Senate Floor Vote - Final Passage",59,1,0,0,60
1356249,970823,2020-07-13,Assembly,"Assembly Consumer Affairs And Protection Committee: Favorable refer to committee Codes",15,0,0,1,16
1356249,971775,2020-07-17,Assembly,"Assembly Codes Committee: Favorable refer to committee Rules",21,0,0,1,22
1356249,972806,2020-07-21,Assembly,"Assembly Floor Vote - Final Passage",142,0,0,3,145
1356249,972807,2020-07-21,Assembly,"Assembly Rules Committee: Favorable",26,0,0,4,30
1356361,964143,2020-06-09,Senate,"Senate Floor Vote - Final Passage",62,0,0,0,62
1356361,965430,2020-06-10,Assembly,"Assembly Floor Vote - Final Passage",144,0,0,3,147
1356361,966367,2020-05-28,Senate,"Senate Rules Committee Vote",19,0,0,0,19
1356361,966368,2020-06-08,Senate,"Senate Local Government Committee Vote",7,0,0,0,7
1356841,948627,2020-03-10,Assembly,"Assembly Governmental Operations Committee: Favorable",14,0,0,0,14
1356973,964560,2020-06-10,Assembly,"Assembly Rules Committee: Favorable",28,0,0,3,31
1356973,964561,2020-06-10,Assembly,"Assembly Ways And Means Committee: Favorable refer to committee Rules",31,0,0,4,35
1356973,965392,2020-06-10,Assembly,"Assembly Floor Vote - Final Passage",144,0,0,3,147
1356973,973726,2020-07-22,Senate,"Senate Floor Vote - Final Passage",58,2,0,0,60
1356975,971112,2020-07-14,Assembly,"Assembly Environmental Conservation Committee: Held for Consideration",19,8,0,1,28
1357002,963718,2020-06-09,Assembly,"Assembly Rules Committee: Favorable",27,0,0,4,31
1357002,963719,2020-06-09,Assembly,"Assembly Ways And Means Committee: Favorable refer to committee Rules",32,0,0,3,35
1357002,965293,2020-06-10,Assembly,"Assembly Floor Vote - Final Passage",144,0,0,3,147
1357002,973669,2020-07-22,Senate,"Senate Floor Vote - Final Passage",58,2,0,0,60
1357009,963752,2020-06-09,Assembly,"Assembly Rules Committee: Favorable",27,0,0,4,31
1357009,963753,2020-06-09,Assembly,"Assembly Ways And Means Committee: Favorable refer to committee Rules",32,0,0,3,35
1357009,965291,2020-06-10,Assembly,"Assembly Floor Vote - Final Passage",144,0,0,3,147
1357009,973604,2020-07-22,Senate,"Senate Floor Vote - Final Passage",58,2,0,0,60
1357012,963710,2020-06-09,Assembly,"Assembly Rules Committee: Favorable",27,0,0,4,31
1357012,963711,2020-06-09,Assembly,"Assembly Ways And Means Committee: Favorable refer to committee Rules",32,0,0,3,35
1357012,965334,2020-06-10,Assembly,"Assembly Floor Vote - Final Passage",144,0,0,3,147
1357012,973722,2020-07-22,Senate,"Senate Floor Vote - Final Passage",60,0,0,0,60
1357024,972312,2020-07-20,Senate,"Senate Higher Education Committee Vote",11,0,0,0,11
1357024,973912,2020-07-21,Senate,"Senate Rules Committee Vote",18,1,0,0,19
1357024,973913,2020-07-22,Senate,"Senate Floor Vote - Final Passage",59,1,0,0,60
1357036,971369,2020-07-15,Assembly,"Assembly Social Services Committee: Favorable refer to committee Rules",12,5,0,0,17
1357069,970759,2020-07-13,Assembly,"Assembly Economic Development Committee: Favorable refer to committee Ways and Means",23,1,0,1,25
1357069,971859,2020-07-17,Assembly,"Assembly Ways And Means Committee: Favorable refer to committee Rules",32,0,0,2,34
1357069,973771,2020-07-21,Assembly,"Assembly Rules Committee: Favorable",26,0,0,4,30
1357113,963797,2020-06-09,Assembly,"Assembly Rules Committee: Favorable",27,0,0,4,31
1357113,963798,2020-06-09,Assembly,"Assembly Ways And Means Committee: Favorable refer to committee Rules",32,0,0,3,35
1357113,965358,2020-06-10,Assembly,"Assembly Floor Vote - Final Passage",144,0,0,3,147
1357113,973672,2020-07-22,Senate,"Senate Floor Vote - Final Passage",60,0,0,0,60
1357120,964550,2020-06-10,Assembly,"Assembly Rules Committee: Favorable",28,0,0,3,31
1357120,964551,2020-06-10,Assembly,"Assembly Ways And Means Committee: Favorable refer to committee Rules",31,0,0,4,35
1357120,965396,2020-06-10,Assembly,"Assembly Floor Vote - Final Passage",144,0,0,3,147
1357120,973692,2020-07-22,Senate,"Senate Floor Vote - Final Passage",58,2,0,0,60
1357122,971857,2020-07-17,Assembly,"Assembly Ways And Means Committee: Favorable refer to committee Rules",32,0,0,2,34
1357122,972558,2020-07-21,Assembly,"Assembly Rules Committee: Favorable",26,0,0,4,30
1357130,963734,2020-06-09,Assembly,"Assembly Rules Committee: Favorable",27,0,0,4,31
1357130,963735,2020-06-09,Assembly,"Assembly Ways And Means Committee: Favorable refer to committee Rules",32,0,0,3,35
1357130,965292,2020-06-10,Assembly,"Assembly Floor Vote - Final Passage",144,0,0,3,147
1357130,973619,2020-07-22,Senate,"Senate Floor Vote - Final Passage",58,2,0,0,60
1357140,963782,2020-06-09,Assembly,"Assembly Rules Committee: Favorable",27,0,0,4,31
1357140,963783,2020-06-09,Assembly,"Assembly Ways And Means Committee: Favorable refer to committee Rules",32,0,0,3,35
1357140,965284,2020-06-10,Assembly,"Assembly Floor Vote - Final Passage",144,0,0,3,147
1357140,973688,2020-07-22,Senate,"Senate Floor Vote - Final Passage",58,2,0,0,60
1357194,960527,2020-05-24,Senate,"Senate Rules Committee Vote",19,0,0,0,19
1357194,960772,2020-05-27,Senate,"Senate Floor Vote - Final Passage",62,0,0,0,62
1357194,961086,2020-05-27,Assembly,"Assembly Floor Vote - Final Passage",144,0,0,3,147
1357194,966245,2020-05-26,Senate,"Senate Finance Committee Vote",23,0,0,0,23
1357241,973464,2020-07-22,Senate,"Senate Floor Vote - Final Passage",60,0,0,0,60
1357241,973797,2020-07-21,Senate,"Senate Rules Committee Vote",19,0,0,0,19
1357241,974051,2020-07-21,Senate,"Senate Rules Committee Vote",19,0,0,0,19
1357612,970798,2020-07-13,Assembly,"Assembly Health Committee: Held for Consideration",18,6,0,2,26
1357628,964180,2020-06-09,Senate,"Senate Floor Vote - Final Passage",61,1,0,0,62
1357628,965446,2020-06-10,Assembly,"Assembly Floor Vote - Final Passage",144,0,0,3,147
1357628,966188,2020-05-28,Senate,"Senate Rules Committee Vote",19,0,0,0,19
1357628,966189,2020-06-08,Senate,"Senate Local Government Committee Vote",7,0,0,0,7
1357669,972597,2020-07-21,Senate,"Senate Finance Committee Vote",23,0,0,0,23
1357669,973228,2020-07-22,Senate,"Senate Rules Committee Vote",19,0,0,0,19
1357669,973580,2020-07-23,Senate,"Senate Floor Vote - Final Passage",60,0,0,0,60
1357669,973967,2020-07-22,Senate,"Senate Rules Committee Vote",19,0,0,0,19
1357929,972678,2020-07-21,Senate,"Senate Elections Committee Vote",5,2,0,0,7
1357929,973304,2020-07-22,Senate,"Senate Rules Committee Vote",13,6,0,0,19
1357929,973395,2020-07-23,Assembly,"Assembly Floor Vote - Final Passage",118,23,0,4,145
1357929,973579,2020-07-22,Senate,"Senate Floor Vote - Final Passage",42,18,0,0,60
1358125,972924,2020-07-21,Senate,"Senate Finance Committee Vote",23,0,0,0,23
1358125,973863,2020-07-21,Senate,"Senate Finance Committee Vote",23,0,0,0,23
1358125,973864,2020-07-21,Senate,"Senate Rules Committee Vote",19,0,0,0,19
1358125,973865,2020-07-22,Senate,"Senate Floor Vote - Final Passage",60,0,0,0,60
1358168,964140,2020-06-09,Senate,"Senate Floor Vote - Final Passage",60,2,0,0,62
1358168,964755,2020-06-09,Assembly,"Assembly Floor Vote - Final Passage",144,0,0,3,147
1358168,966369,2020-05-28,Senate,"Senate Rules Committee Vote",19,0,0,0,19
1358168,966370,2020-06-08,Senate,"Senate Local Government Committee Vote",7,0,0,0,7
1358175,972302,2020-07-20,Senate,"Senate Local Government Committee Vote",7,0,0,0,7
1358175,973877,2020-07-21,Senate,"Senate Rules Committee Vote",19,0,0,0,19
1358175,973878,2020-07-22,Senate,"Senate Floor Vote - Final Passage",59,1,0,0,60
1358297,972953,2020-07-20,Senate,"Senate Environmental Conservation Committee Vote",11,0,0,0,11
1358297,973914,2020-07-21,Senate,"Senate Rules Committee Vote",19,0,0,0,19
1358297,973915,2020-07-22,Senate,"Senate Floor Vote - Final Passage",60,0,0,0,60
1358322,964156,2020-06-09,Senate,"Senate Floor Vote - Final Passage",60,2,0,0,62
1358322,966379,2020-05-28,Senate,"Senate Rules Committee Vote",19,0,0,0,19
1358322,966380,2020-06-08,Senate,"Senate Local Government Committee Vote",7,0,0,0,7
1358352,971698,2020-07-16,Assembly,"Assembly Real Property Taxation Committee: Favorable refer to committee Ways and Means",10,0,0,0,10
1358352,971752,2020-07-17,Assembly,"Assembly Ways And Means Committee: Favorable refer to committee Rules",32,0,0,2,34
1358352,972202,2020-07-20,Assembly,"Assembly Rules Committee: Favorable",27,0,0,3,30
1358793,972305,2020-07-20,Senate,"Senate Local Government Committee Vote",7,0,0,0,7
1358793,973412,2020-07-22,Senate,"Senate Floor Vote - Final Passage",60,0,0,0,60
1358793,973413,2020-07-23,Assembly,"Assembly Floor Vote - Final Passage",134,7,0,4,145
1358793,973783,2020-07-21,Senate,"Senate Rules Committee Vote",19,0,0,0,19
1359240,972338,2020-07-20,Senate,"Senate Local Government Committee Vote",7,0,0,0,7
1359240,973516,2020-07-22,Senate,"Senate Floor Vote - Final Passage",55,5,0,0,60
1359240,973834,2020-07-21,Senate,"Senate Rules Committee Vote",19,0,0,0,19
1359286,963764,2020-06-09,Assembly,"Assembly Rules Committee: Favorable",27,0,0,4,31
1359286,963765,2020-06-09,Assembly,"Assembly Ways And Means Committee: Favorable refer to committee Rules",32,0,0,3,35
1359287,963708,2020-06-09,Assembly,"Assembly Rules Committee: Favorable",26,1,0,4,31
1359287,963709,2020-06-09,Assembly,"Assembly Ways And Means Committee: Favorable refer to committee Rules",30,2,0,3,35
1359287,965343,2020-06-10,Assembly,"Assembly Floor Vote - Final Passage",140,4,0,3,147
1359295,970872,2020-07-13,Assembly,"Assembly Banks Committee: Favorable refer to committee Codes",29,0,0,2,31
1359295,971900,2020-07-17,Assembly,"Assembly Codes Committee: Favorable refer to committee Rules",21,0,0,1,22
1359295,972759,2020-07-21,Assembly,"Assembly Rules Committee: Favorable",26,0,0,4,30
1359305,971710,2020-07-16,Assembly,"Assembly Local Governments Committee: Favorable refer to committee Ways and Means",18,1,0,1,20
1359305,971756,2020-07-17,Assembly,"Assembly Ways And Means Committee: Favorable refer to committee Rules",25,7,0,2,34
1359305,972889,2020-07-22,Assembly,"Assembly Rules Committee: Favorable",29,0,0,1,30
1359322,973167,2020-07-22,Assembly,"Assembly Floor Vote - Final Passage",94,48,0,3,145
1359322,973449,2020-07-22,Senate,"Senate Floor Vote - Final Passage",38,22,0,0,60
1359322,973819,2020-07-21,Senate,"Senate Rules Committee Vote",11,8,0,0,19
1359352,971316,2020-07-15,Assembly,"Assembly Small Business Committee: Favorable refer to committee Rules",13,0,0,3,16
1359352,972209,2020-07-20,Assembly,"Assembly Rules Committee: Favorable",27,0,0,3,30
1359370,963808,2020-06-09,Assembly,"Assembly Rules Committee: Favorable",27,0,0,4,31
1359370,963809,2020-06-09,Assembly,"Assembly Ways And Means Committee: Favorable refer to committee Rules",32,0,0,3,35
1359425,971143,2020-07-14,Assembly,"Assembly Judiciary Committee: Favorable refer to committee Rules",15,6,0,0,21
1359509,972865,2020-07-22,Assembly,"Assembly Ways And Means Committee: Favorable refer to committee Rules",31,1,0,2,34
1359509,973095,2020-07-22,Assembly,"Assembly Rules Committee: Favorable",29,0,0,1,30
1359868,964151,2020-06-09,Senate,"Senate Floor Vote - Final Passage",62,0,0,0,62
1359868,966178,2020-05-28,Senate,"Senate Rules Committee Vote",19,0,0,0,19
1359868,966179,2020-06-08,Senate,"Senate Transportation Committee Vote",15,0,0,0,15
1360045,953056,2020-03-18,Senate,"Senate Floor Vote - Final Passage",52,4,0,6,62
1360045,953057,2020-03-18,Senate,"Senate Rules Committee Vote",16,0,0,3,19
1360045,953431,2020-03-18,Assembly,"Assembly Floor Vote - Final Passage",123,12,0,12,147
1360052,972295,2020-07-20,Senate,"Senate Local Government Committee Vote",7,0,0,0,7
1360052,973611,2020-07-22,Senate,"Senate Floor Vote - Final Passage",60,0,0,0,60
1360052,973612,2020-07-23,Assembly,"Assembly Floor Vote - Final Passage",141,0,0,4,145
1360052,973961,2020-07-21,Senate,"Senate Rules Committee Vote",19,0,0,0,19
1360121,953028,2020-03-18,Assembly,"Assembly Labor Committee: Favorable refer to committee Rules",25,1,0,3,29
1360121,953054,2020-03-18,Assembly,"Assembly Rules Committee: Favorable",28,0,0,3,31
1360180,964152,2020-06-09,Senate,"Senate Floor Vote - Final Passage",60,2,0,0,62
1360180,965432,2020-06-10,Assembly,"Assembly Floor Vote - Final Passage",144,0,0,3,147
1360180,966176,2020-06-08,Senate,"Senate Local Government Committee Vote",7,0,0,0,7
1360180,966388,2020-06-08,Senate,"Senate Local Government Committee Vote",7,0,0,0,7
1360189,972787,2020-07-20,Senate,"Senate Investigations and Government Operations Committee Vote",5,1,0,0,6
1360189,973196,2020-07-22,Senate,"Senate Floor Vote - Final Passage",41,19,0,0,60
1360189,973289,2020-07-22,Senate,"Senate Rules Committee Vote",15,4,0,0,19
1360189,973407,2020-07-23,Assembly,"Assembly Floor Vote - Final Passage",106,35,0,4,145
1360259,964163,2020-06-09,Senate,"Senate Floor Vote - Final Passage",45,17,0,0,62
1360259,965438,2020-06-10,Assembly,"Assembly Floor Vote - Final Passage",114,30,0,3,147
1360259,966180,2020-05-28,Senate,"Senate Rules Committee Vote",16,3,0,0,19
1360259,966181,2020-06-08,Senate,"Senate Local Government Committee Vote",5,2,0,0,7
1360960,972298,2020-07-20,Senate,"Senate Corporations, Authorities and Commissions Committee Vote",7,0,0,0,7
1360960,973847,2020-07-21,Senate,"Senate Rules Committee Vote",19,0,0,0,19
1360960,973848,2020-07-22,Senate,"Senate Floor Vote - Final Passage",60,0,0,0,60
1360984,964137,2020-06-09,Senate,"Senate Floor Vote - Final Passage",62,0,0,0,62
1360984,966327,2020-05-28,Senate,"Senate Rules Committee Vote",19,0,0,0,19
1360984,966328,2020-06-08,Senate,"Senate Investigations and Government Operations Committee Vote",7,0,0,0,7
1361149,953042,2020-03-18,Assembly,"Assembly Rules Committee: Favorable",28,0,0,3,31
1361149,953043,2020-03-18,Assembly,"Assembly Rules Committee: Favorable",28,0,0,3,31
1361149,953044,2020-03-18,Assembly,"Assembly Labor Committee: Favorable refer to committee Rules",26,0,0,3,29
1361165,953045,2020-03-18,Senate,"Senate Floor Vote - Final Passage",50,6,0,6,62
1361165,953046,2020-03-18,Senate,"Senate Rules Committee Vote",16,0,0,3,19
1361165,953437,2020-03-18,Assembly,"Assembly Floor Vote - Final Passage",132,3,0,12,147
1361185,964087,2020-06-09,Senate,"Senate Floor Vote - Final Passage",62,0,0,0,62
1361185,966235,2020-05-28,Senate,"Senate Rules Committee Vote",19,0,0,0,19
1361185,966236,2020-06-08,Senate,"Senate Local Government Committee Vote",7,0,0,0,7
1361439,960285,2020-05-26,Senate,"Senate Local Government Committee Vote",7,0,0,0,7
1361439,960517,2020-05-26,Senate,"Senate Local Government Committee Vote",7,0,0,0,7
1361439,960930,2020-05-27,Senate,"Senate Floor Vote - Final Passage",62,0,0,0,62
1361439,961046,2020-05-27,Assembly,"Assembly Floor Vote - Final Passage",144,0,0,3,147
1361440,973194,2020-07-22,Senate,"Senate Floor Vote - Final Passage",58,2,0,0,60
1361440,973288,2020-07-22,Senate,"Senate Rules Committee Vote",19,0,0,0,19
1361440,973409,2020-07-24,Assembly,"Assembly Floor Vote - Final Passage",140,1,0,4,145
1361444,960521,2020-05-24,Senate,"Senate Rules Committee Vote",19,0,0,0,19
1361444,960522,2020-05-26,Senate,"Senate Corporations, Authorities and Commissions Committee Vote",7,0,0,0,7
1361444,960942,2020-05-27,Senate,"Senate Floor Vote - Final Passage",62,0,0,0,62
1361444,961123,2020-05-27,Assembly,"Assembly Floor Vote - Final Passage",142,2,0,3,147
1361459,960401,2020-05-24,Senate,"Senate Rules Committee Vote",19,0,0,0,19
1361459,960937,2020-05-27,Senate,"Senate Floor Vote - Final Passage",58,4,0,0,62
1361459,961461,2020-05-28,Assembly,"Assembly Floor Vote - Final Passage",111,32,0,4,147
1361459,966663,2020-05-26,Senate,"Senate Consumer Protection Committee Vote",7,0,0,0,7
1361622,972954,2020-07-20,Senate,"Senate Civil Service and Pensions Committee Vote",7,0,0,0,7
1361622,973613,2020-07-22,Senate,"Senate Floor Vote - Final Passage",60,0,0,0,60
1361622,973614,2020-07-23,Assembly,"Assembly Floor Vote - Final Passage",141,0,0,4,145
1361622,973952,2020-07-21,Senate,"Senate Rules Committee Vote",19,0,0,0,19
1361625,963791,2020-06-09,Assembly,"Assembly Rules Committee: Favorable",27,0,0,4,31
1361625,963792,2020-06-09,Assembly,"Assembly Ways And Means Committee: Favorable refer to committee Rules",32,0,0,3,35
1361633,963742,2020-06-09,Assembly,"Assembly Rules Committee: Favorable",25,2,0,4,31
1361633,963743,2020-06-09,Assembly,"Assembly Ways And Means Committee: Favorable refer to committee Rules",25,7,0,3,35
1361634,971009,2020-07-14,Assembly,"Assembly Education Committee: Favorable refer to committee Ways and Means",29,0,0,2,31
1361634,971731,2020-07-17,Assembly,"Assembly Ways And Means Committee: Favorable refer to committee Rules",32,0,0,2,34
1361634,972182,2020-07-20,Assembly,"Assembly Rules Committee: Favorable",27,0,0,3,30
1361634,972739,2020-07-21,Assembly,"Assembly Floor Vote - Final Passage",142,0,0,3,145
1361634,973670,2020-07-23,Senate,"Senate Floor Vote - Final Passage",60,0,0,0,60
1361650,964548,2020-06-10,Assembly,"Assembly Rules Committee: Favorable",28,0,0,3,31
1361650,964549,2020-06-10,Assembly,"Assembly Ways And Means Committee: Favorable refer to committee Rules",31,0,0,4,35
1361655,971196,2020-07-14,Assembly,"Assembly Correction Committee: Favorable refer to committee Rules",10,2,0,1,13
1361655,972547,2020-07-21,Assembly,"Assembly Rules Committee: Favorable",19,7,0,4,30
1361666,963756,2020-06-09,Assembly,"Assembly Rules Committee: Favorable",27,0,0,4,31
1361666,963757,2020-06-09,Assembly,"Assembly Ways And Means Committee: Favorable refer to committee Rules",32,0,0,3,35
1361666,965354,2020-06-10,Assembly,"Assembly Floor Vote - Final Passage",144,0,0,3,147
1361667,960481,2020-05-26,Assembly,"Assembly Education Committee: Favorable refer to committee Ways and Means",31,0,0,0,31
1361667,960587,2020-05-27,Assembly,"Assembly Ways And Means Committee: Favorable refer to committee Rules",33,0,0,2,35
1361667,960783,2020-05-27,Assembly,"Assembly Rules Committee: Favorable",29,0,0,2,31
1361675,963770,2020-06-09,Assembly,"Assembly Rules Committee: Favorable",27,0,0,4,31
1361675,963771,2020-06-09,Assembly,"Assembly Ways And Means Committee: Favorable refer to committee Rules",32,0,0,3,35
1361675,965356,2020-06-10,Assembly,"Assembly Floor Vote - Final Passage",144,0,0,3,147
1361675,973496,2020-07-22,Senate,"Senate Floor Vote - Final Passage",60,0,0,0,60
1361679,971451,2020-07-15,Assembly,"Assembly Veterans' Affairs Committee: Favorable refer to committee Rules",17,0,0,2,19
1361679,972559,2020-07-21,Assembly,"Assembly Floor Vote - Final Passage",142,0,0,3,145
1361679,972560,2020-07-21,Assembly,"Assembly Rules Committee: Favorable",26,0,0,4,30
1361683,970861,2020-07-13,Assembly,"Assembly Economic Development Committee: Favorable refer to committee Ways and Means",23,1,0,1,25
1361683,971838,2020-07-17,Assembly,"Assembly Ways And Means Committee: Favorable refer to committee Rules",32,0,0,2,34
1361683,972215,2020-07-20,Assembly,"Assembly Rules Committee: Favorable",27,0,0,3,30
1361683,972725,2020-07-21,Assembly,"Assembly Floor Vote - Final Passage",141,1,0,3,145
1361683,973512,2020-07-22,Senate,"Senate Floor Vote - Final Passage",60,0,0,0,60
1361690,971294,2020-07-15,Assembly,"Assembly Small Business Committee: Favorable refer to committee Ways and Means",13,0,0,3,16
1361690,971842,2020-07-17,Assembly,"Assembly Ways And Means Committee: Favorable refer to committee Rules",32,0,0,2,34
1361690,972219,2020-07-20,Assembly,"Assembly Rules Committee: Favorable",27,0,0,3,30
1361711,961201,2020-05-24,Senate,"Senate Rules Committee Vote",14,5,0,0,19
1361711,961489,2020-05-28,Senate,"Senate Floor Vote - Final Passage",39,22,0,1,62
1361711,961490,2020-05-28,Assembly,"Assembly Floor Vote - Final Passage",102,41,0,4,147
1361850,964132,2020-06-09,Senate,"Senate Floor Vote - Final Passage",60,2,0,0,62
1361850,965426,2020-06-10,Assembly,"Assembly Floor Vote - Final Passage",144,0,0,3,147
1361850,966354,2020-05-28,Senate,"Senate Rules Committee Vote",19,0,0,0,19
1361850,966355,2020-06-08,Senate,"Senate Local Government Committee Vote",7,0,0,0,7
1361922,970998,2020-07-14,Assembly,"Assembly Energy Committee: Favorable refer to committee Codes",11,4,0,0,15
1361922,971897,2020-07-17,Assembly,"Assembly Ways And Means Committee: Favorable refer to committee Rules",26,6,0,2,34
1361922,971898,2020-07-17,Assembly,"Assembly Codes Committee: Favorable refer to committee Ways and Means",18,3,0,1,22
1361922,973014,2020-07-22,Assembly,"Assembly Rules Committee: Favorable",19,6,0,5,30
1361949,960390,2020-05-24,Senate,"Senate Rules Committee Vote",19,0,0,0,19
1361949,960391,2020-05-26,Senate,"Senate Local Government Committee Vote",7,0,0,0,7
1361949,960650,2020-05-27,Senate,"Senate Floor Vote - Final Passage",62,0,0,0,62
1361949,961451,2020-05-28,Assembly,"Assembly Floor Vote - Final Passage",128,15,0,4,147
1362714,973589,2020-07-22,Senate,"Senate Floor Vote - Final Passage",56,4,0,0,60
1362714,973927,2020-07-21,Senate,"Senate Rules Committee Vote",18,1,0,0,19
1362730,960494,2020-05-26,Assembly,"Assembly Real Property Taxation Committee: Favorable refer to committee Ways and Means",10,0,0,0,10
1362730,960593,2020-05-27,Assembly,"Assembly Ways And Means Committee: Favorable refer to committee Rules",33,0,0,2,35
1362730,960765,2020-05-27,Assembly,"Assembly Rules Committee: Favorable",29,0,0,2,31
1362745,960349,2020-05-26,Assembly,"Assembly Consumer Affairs And Protection Committee: Favorable refer to committee Codes",15,0,0,1,16
1362745,960493,2020-05-26,Assembly,"Assembly Codes Committee: Favorable refer to committee Rules",21,0,0,1,22
1362745,960669,2020-05-27,Assembly,"Assembly Rules Committee: Favorable",29,0,0,2,31
1362763,972894,2020-07-22,Assembly,"Assembly Rules Committee: Favorable",29,0,0,1,30
1362763,972895,2020-07-22,Assembly,"Assembly Ways And Means Committee: Favorable refer to committee Rules",32,0,0,2,34
1362766,960407,2020-05-26,Assembly,"Assembly Real Property Taxation Committee: Favorable refer to committee Ways and Means",10,0,0,0,10
1362766,960590,2020-05-27,Assembly,"Assembly Ways And Means Committee: Favorable refer to committee Rules",33,0,0,2,35
1362766,960759,2020-05-27,Assembly,"Assembly Rules Committee: Favorable",29,0,0,2,31
1362774,973855,2020-07-21,Senate,"Senate Rules Committee Vote",13,6,0,0,19
1362810,960371,2020-05-26,Assembly,"Assembly Codes Committee: Favorable refer to committee Rules",15,6,0,1,22
1362810,960372,2020-05-26,Assembly,"Assembly Judiciary Committee: Favorable refer to committee Codes",14,7,0,0,21
1362810,960665,2020-05-27,Assembly,"Assembly Rules Committee: Favorable",23,6,0,2,31
1362946,966244,2020-06-08,Senate,"Senate Transportation Committee Vote",13,2,0,0,15
1362981,960574,2020-05-24,Senate,"Senate Rules Committee Vote",19,0,0,0,19
1362981,960654,2020-05-27,Senate,"Senate Floor Vote - Final Passage",61,1,0,0,62
1362981,961073,2020-05-27,Assembly,"Assembly Floor Vote - Final Passage",141,3,0,3,147
1362981,966679,2020-05-26,Senate,"Senate Consumer Protection Committee Vote",7,0,0,0,7
1362993,960418,2020-05-24,Senate,"Senate Rules Committee Vote",19,0,0,0,19
1362993,960419,2020-05-26,Senate,"Senate Health Committee Vote",15,0,0,0,15
1362993,960702,2020-05-27,Senate,"Senate Floor Vote - Final Passage",62,0,0,0,62
1362993,961464,2020-05-28,Assembly,"Assembly Floor Vote - Final Passage",131,12,0,4,147
1363028,960518,2020-05-24,Senate,"Senate Rules Committee Vote",15,4,0,0,19
1363028,960519,2020-05-26,Senate,"Senate Judiciary Committee Vote",12,3,0,0,15
1363028,960936,2020-05-27,Senate,"Senate Floor Vote - Final Passage",39,23,0,0,62
1363028,961047,2020-05-27,Assembly,"Assembly Floor Vote - Final Passage",94,50,0,3,147
1363048,960525,2020-05-24,Senate,"Senate Rules Committee Vote",19,0,0,0,19
1363048,960526,2020-05-26,Senate,"Senate Corporations, Authorities and Commissions Committee Vote",7,0,0,0,7
1363048,960944,2020-05-27,Senate,"Senate Floor Vote - Final Passage",62,0,0,0,62
1363048,961074,2020-05-27,Assembly,"Assembly Floor Vote - Final Passage",143,1,0,3,147
1363166,960489,2020-05-26,Assembly,"Assembly Local Governments Committee: Favorable refer to committee Ways and Means",16,0,0,2,18
1363166,960584,2020-05-27,Assembly,"Assembly Ways And Means Committee: Favorable refer to committee Rules",33,0,0,2,35
1363166,960763,2020-05-27,Assembly,"Assembly Rules Committee: Favorable",29,0,0,2,31
1363181,964133,2020-06-09,Senate,"Senate Floor Vote - Final Passage",59,3,0,0,62
1363181,965425,2020-06-10,Assembly,"Assembly Floor Vote - Final Passage",144,0,0,3,147
1363181,966252,2020-05-28,Senate,"Senate Rules Committee Vote",18,1,0,0,19
1363197,960492,2020-05-26,Assembly,"Assembly Transportation Committee: Favorable refer to committee Ways and Means",21,2,0,2,25
1363197,960599,2020-05-27,Assembly,"Assembly Rules Committee: Favorable",29,0,0,2,31
1363197,960600,2020-05-27,Assembly,"Assembly Ways And Means Committee: Favorable refer to committee Rules",33,0,0,2,35
1363460,971705,2020-07-16,Assembly,"Assembly Governmental Operations Committee: Favorable refer to committee Codes",14,0,0,0,14
1363460,971769,2020-07-17,Assembly,"Assembly Ways And Means Committee: Favorable refer to committee Rules",32,0,0,2,34
1363460,971770,2020-07-17,Assembly,"Assembly Codes Committee: Favorable refer to committee Ways and Means",21,0,0,1,22
1363460,972167,2020-07-20,Assembly,"Assembly Rules Committee: Favorable",27,0,0,3,30
1363468,971386,2020-07-16,Assembly,"Assembly Governmental Employees Committee: Favorable refer to committee Ways and Means",14,0,0,0,14
1363468,971908,2020-07-17,Assembly,"Assembly Ways And Means Committee: Favorable refer to committee Rules",31,1,0,2,34
1363468,972589,2020-07-21,Assembly,"Assembly Rules Committee: Favorable",26,0,0,4,30
1363468,973142,2020-07-22,Assembly,"Assembly Floor Vote - Final Passage",141,1,0,3,145
1363468,973712,2020-07-23,Senate,"Senate Floor Vote - Final Passage",60,0,0,0,60
1363472,963777,2020-06-09,Assembly,"Assembly Rules Committee: Favorable",27,0,0,4,31
1363472,963778,2020-06-09,Assembly,"Assembly Ways And Means Committee: Favorable refer to committee Rules",32,0,0,3,35
1363472,965344,2020-06-10,Assembly,"Assembly Floor Vote - Final Passage",144,0,0,3,147
1363472,973471,2020-07-22,Senate,"Senate Floor Vote - Final Passage",60,0,0,0,60
1363474,972684,2020-07-20,Senate,"Senate Civil Service and Pensions Committee Vote",7,0,0,0,7
1363474,972685,2020-07-21,Senate,"Senate Finance Committee Vote",23,0,0,0,23
1363474,973343,2020-07-22,Senate,"Senate Rules Committee Vote",19,0,0,0,19
1363474,973505,2020-07-22,Senate,"Senate Floor Vote - Final Passage",60,0,0,0,60
1363485,960392,2020-05-26,Assembly,"Assembly Codes Committee: Favorable refer to committee Rules",15,6,0,1,22
1363485,960393,2020-05-26,Assembly,"Assembly Labor Committee: Favorable refer to committee Codes",21,6,0,2,29
1363485,960767,2020-05-27,Assembly,"Assembly Rules Committee: Favorable",28,1,0,2,31
1363490,972663,2020-07-20,Senate,"Senate Civil Service and Pensions Committee Vote",7,0,0,0,7
1363490,972664,2020-07-21,Senate,"Senate Finance Committee Vote",23,0,0,0,23
1363490,974099,2020-07-22,Senate,"Senate Rules Committee Vote",19,0,0,0,19
1363490,974100,2020-07-23,Senate,"Senate Floor Vote - Final Passage",60,0,0,0,60
1363514,970819,2020-07-13,Assembly,"Assembly Health Committee: Favorable refer to committee Rules",24,0,0,2,26
1363514,973017,2020-07-22,Assembly,"Assembly Rules Committee: Favorable",25,0,0,5,30
1363514,973129,2020-07-22,Assembly,"Assembly Floor Vote - Final Passage",141,1,0,3,145
1363514,973702,2020-07-23,Senate,"Senate Floor Vote - Final Passage",45,15,0,0,60
1363519,972680,2020-07-20,Senate,"Senate Civil Service and Pensions Committee Vote",7,0,0,0,7
1363519,972681,2020-07-21,Senate,"Senate Finance Committee Vote",23,0,0,0,23
1363519,973280,2020-07-22,Senate,"Senate Rules Committee Vote",19,0,0,0,19
1363519,973392,2020-07-23,Assembly,"Assembly Floor Vote - Final Passage",138,3,0,4,145
1363519,973682,2020-07-23,Senate,"Senate Floor Vote - Final Passage",60,0,0,0,60
1363584,972296,2020-07-20,Senate,"Senate Local Government Committee Vote",7,0,0,0,7
1363584,972923,2020-07-21,Senate,"Senate Finance Committee Vote",23,0,0,0,23
1363584,973861,2020-07-21,Senate,"Senate Finance Committee Vote",23,0,0,0,23
1363584,973862,2020-07-22,Senate,"Senate Floor Vote - Final Passage",59,1,0,0,60
1363599,972921,2020-07-20,Senate,"Senate Health Committee Vote",14,0,0,1,15
1363599,973870,2020-07-21,Senate,"Senate Rules Committee Vote",18,1,0,0,19
1363599,973871,2020-07-22,Senate,"Senate Floor Vote - Final Passage",57,3,0,0,60
1363721,964113,2020-06-09,Senate,"Senate Floor Vote - Final Passage",61,1,0,0,62
1363721,964732,2020-06-08,Senate,"Senate Commerce, Economic Development and Small Business Committee Vote",9,0,0,0,9
1363721,966347,2020-06-08,Senate,"Senate Commerce, Economic Development and Small Business Committee Vote",9,0,0,0,9
1363721,972598,2020-07-21,Assembly,"Assembly Floor Vote - Final Passage",141,1,0,3,145
1363733,960382,2020-05-24,Senate,"Senate Rules Committee Vote",19,0,0,0,19
1363733,960383,2020-05-26,Senate,"Senate Local Government Committee Vote",7,0,0,0,7
1363733,960745,2020-05-27,Senate,"Senate Floor Vote - Final Passage",62,0,0,0,62
1363733,961044,2020-05-27,Assembly,"Assembly Floor Vote - Final Passage",143,1,0,3,147
1363738,960380,2020-05-24,Senate,"Senate Rules Committee Vote",19,0,0,0,19
1363738,960381,2020-05-26,Senate,"Senate Health Committee Vote",14,1,0,0,15
1363738,960940,2020-05-27,Senate,"Senate Floor Vote - Final Passage",59,3,0,0,62
1363738,961460,2020-05-28,Assembly,"Assembly Floor Vote - Final Passage",143,0,0,4,147
1363738,967923,2020-05-26,Senate,"Senate Finance Committee Vote",23,0,0,0,23
1363742,960394,2020-05-24,Senate,"Senate Rules Committee Vote",19,0,0,0,19
1363742,960395,2020-05-26,Senate,"Senate Local Government Committee Vote",7,0,0,0,7
1363742,960806,2020-05-27,Senate,"Senate Floor Vote - Final Passage",62,0,0,0,62
1363742,961049,2020-05-27,Assembly,"Assembly Floor Vote - Final Passage",144,0,0,3,147
1363744,972780,2020-07-21,Senate,"Senate Social Services Committee Vote",7,0,0,0,7
1363744,973171,2020-07-22,Senate,"Senate Floor Vote - Final Passage",58,2,0,0,60
1363744,973347,2020-07-22,Senate,"Senate Rules Committee Vote",19,0,0,0,19
1363744,973508,2020-07-23,Assembly,"Assembly Floor Vote - Final Passage",137,4,0,4,145
1363757,960413,2020-05-24,Senate,"Senate Rules Committee Vote",19,0,0,0,19
1363757,960414,2020-05-26,Senate,"Senate Housing, Construction and Community Development Committee Vote",10,1,0,0,11
1363757,960629,2020-05-27,Senate,"Senate Floor Vote - Final Passage",62,0,0,0,62
1363757,961068,2020-05-27,Assembly,"Assembly Floor Vote - Final Passage",111,33,0,3,147
1363852,971306,2020-07-15,Assembly,"Assembly Labor Committee: Favorable refer to committee Codes",25,0,0,3,28
1363852,971750,2020-07-17,Assembly,"Assembly Codes Committee: Favorable refer to committee Rules",20,1,0,1,22
1363852,972160,2020-07-20,Assembly,"Assembly Rules Committee: Favorable",27,0,0,3,30
1363852,972965,2020-07-21,Assembly,"Assembly Floor Vote - Final Passage",142,0,0,3,145
1363858,964594,2020-06-10,Assembly,"Assembly Rules Committee: Favorable",28,0,0,3,31
1363858,964595,2020-06-10,Assembly,"Assembly Ways And Means Committee: Favorable refer to committee Rules",31,0,0,4,35
1363862,960415,2020-05-26,Assembly,"Assembly Codes Committee: Favorable refer to committee Rules",15,6,0,1,22
1363862,960416,2020-05-26,Assembly,"Assembly Banks Committee: Favorable refer to committee Codes",25,5,0,1,31
1363862,960761,2020-05-27,Assembly,"Assembly Rules Committee: Favorable",23,6,0,2,31
1363880,972329,2020-07-20,Senate,"Senate Insurance Committee Vote",11,0,0,0,11
1363880,973172,2020-07-22,Senate,"Senate Floor Vote - Final Passage",55,5,0,0,60
1363880,973320,2020-07-22,Senate,"Senate Rules Committee Vote",17,2,0,0,19
1363886,972843,2020-07-22,Assembly,"Assembly Ways And Means Committee: Favorable refer to committee Rules",32,0,0,2,34
1363886,973002,2020-07-22,Assembly,"Assembly Rules Committee: Favorable",29,0,0,1,30
1363893,971229,2020-07-15,Assembly,"Assembly Labor Committee: Favorable refer to committee Rules",25,0,0,3,28
1363896,971950,2020-07-17,Assembly,"Assembly Codes Committee: Favorable refer to committee Rules",15,6,0,1,22
1363896,973097,2020-07-22,Assembly,"Assembly Rules Committee: Favorable",29,0,0,1,30
1363897,972950,2020-07-20,Senate,"Senate Health Committee Vote",14,0,0,1,15
1363897,973902,2020-07-21,Senate,"Senate Rules Committee Vote",19,0,0,0,19
1363897,973903,2020-07-22,Senate,"Senate Floor Vote - Final Passage",60,0,0,0,60
1363898,960495,2020-05-26,Assembly,"Assembly Labor Committee: Favorable refer to committee Ways and Means",27,0,0,2,29
1363898,960585,2020-05-26,Assembly,"Assembly Labor Committee: Favorable refer to committee Ways and Means Correction Date:05/27/2020",21,6,0,2,29
1363898,960671,2020-05-27,Assembly,"Assembly Rules Committee: Favorable",24,5,0,2,31
1363901,972274,2020-07-20,Senate,"Senate Local Government Committee Vote",7,0,0,0,7
1363901,973894,2020-07-21,Senate,"Senate Rules Committee Vote",19,0,0,0,19
1363901,973895,2020-07-22,Senate,"Senate Floor Vote - Final Passage",60,0,0,0,60
1363906,971286,2020-07-15,Assembly,"Assembly Labor Committee: Favorable refer to committee Codes",25,0,0,3,28
1363906,971748,2020-07-17,Assembly,"Assembly Codes Committee: Favorable refer to committee Rules",21,0,0,1,22
1363906,972159,2020-07-20,Assembly,"Assembly Rules Committee: Favorable",27,0,0,3,30
1363906,972723,2020-07-21,Assembly,"Assembly Floor Vote - Final Passage",142,0,0,3,145
1363907,964543,2020-06-10,Assembly,"Assembly Rules Committee: Favorable",26,2,0,3,31
1363907,964544,2020-06-10,Assembly,"Assembly Ways And Means Committee: Favorable refer to committee Rules",24,7,0,4,35
1364047,960520,2020-05-24,Senate,"Senate Rules Committee Vote",16,3,0,0,19
1364047,960832,2020-05-27,Senate,"Senate Floor Vote - Final Passage",48,14,0,0,62
1364047,961453,2020-05-28,Assembly,"Assembly Floor Vote - Final Passage",97,46,0,4,147
1364061,972706,2020-07-20,Senate,"Senate Labor Committee Vote",13,0,0,0,13
1364061,973352,2020-07-22,Senate,"Senate Rules Committee Vote",19,0,0,0,19
1364061,973514,2020-07-22,Senate,"Senate Floor Vote - Final Passage",60,0,0,0,60
1364269,964597,2020-06-10,Assembly,"Assembly Rules Committee: Favorable",28,0,0,3,31
1364269,964598,2020-06-10,Assembly,"Assembly Ways And Means Committee: Favorable refer to committee Rules",24,7,0,4,35
1364278,960505,2020-05-26,Assembly,"Assembly Codes Committee: Favorable refer to committee Rules",21,0,0,1,22
1364278,960506,2020-05-26,Assembly,"Assembly Health Committee: Favorable refer to committee Codes",25,0,0,1,26
1364278,960602,2020-05-27,Assembly,"Assembly Rules Committee: Favorable",29,0,0,2,31
1364285,960288,2020-05-26,Assembly,"Assembly Health Committee: Favorable refer to committee Rules",24,1,0,1,26
1364285,960931,2020-05-27,Assembly,"Assembly Rules Committee: Favorable",29,0,0,2,31
1364294,960488,2020-05-26,Assembly,"Assembly Local Governments Committee: Favorable refer to committee Ways and Means",16,0,0,2,18
1364294,960589,2020-05-27,Assembly,"Assembly Ways And Means Committee: Favorable refer to committee Rules",33,0,0,2,35
1364294,960962,2020-05-27,Assembly,"Assembly Rules Committee: Favorable",29,0,0,2,31
1364312,963744,2020-06-09,Assembly,"Assembly Rules Committee: Favorable",27,0,0,4,31
1364312,963745,2020-06-09,Assembly,"Assembly Ways And Means Committee: Favorable refer to committee Rules",32,0,0,3,35
1364343,964578,2020-06-10,Assembly,"Assembly Rules Committee: Favorable",28,0,0,3,31
1364343,964579,2020-06-10,Assembly,"Assembly Ways And Means Committee: Favorable refer to committee Rules",23,8,0,4,35
1364343,965277,2020-06-10,Assembly,"Assembly Floor Vote - Final Passage",132,12,0,3,147
1364343,973546,2020-07-22,Senate,"Senate Floor Vote - Final Passage",60,0,0,0,60
1364366,963740,2020-06-09,Assembly,"Assembly Rules Committee: Favorable",20,7,0,4,31
1364366,963741,2020-06-09,Assembly,"Assembly Ways And Means Committee: Favorable refer to committee Rules",24,8,0,3,35
1364407,964553,2020-06-10,Assembly,"Assembly Rules Committee: Favorable",28,0,0,3,31
1364407,964554,2020-06-10,Assembly,"Assembly Ways And Means Committee: Favorable refer to committee Rules",23,8,0,4,35
1364639,960352,2020-05-24,Senate,"Senate Rules Committee Vote",19,0,0,0,19
1364639,960353,2020-05-26,Senate,"Senate Health Committee Vote",15,0,0,0,15
1364639,960957,2020-05-27,Senate,"Senate Floor Vote - Final Passage",61,1,0,0,62
1364639,961098,2020-05-27,Assembly,"Assembly Floor Vote - Final Passage",133,11,0,3,147
1364644,972948,2020-07-20,Senate,"Senate Health Committee Vote",14,0,0,1,15
1364644,973603,2020-07-22,Senate,"Senate Floor Vote - Final Passage",60,0,0,0,60
1364644,973938,2020-07-21,Senate,"Senate Rules Committee Vote",19,0,0,0,19
1364648,964101,2020-06-09,Senate,"Senate Floor Vote - Final Passage",62,0,0,0,62
1364648,965437,2020-06-10,Assembly,"Assembly Floor Vote - Final Passage",144,0,0,3,147
1364648,966177,2020-06-08,Senate,"Senate Local Government Committee Vote",7,0,0,0,7
1364648,966389,2020-06-08,Senate,"Senate Local Government Committee Vote",7,0,0,0,7
1364942,972803,2020-07-20,Senate,"Senate Investigations and Government Operations Committee Vote",5,1,0,0,6
1364942,973160,2020-07-22,Senate,"Senate Floor Vote - Final Passage",57,3,0,0,60
1364942,973325,2020-07-22,Senate,"Senate Rules Committee Vote",18,1,0,0,19
1364942,973484,2020-07-24,Assembly,"Assembly Floor Vote - Final Passage",141,0,0,4,145
1364946,964106,2020-06-09,Senate,"Senate Floor Vote - Final Passage",62,0,0,0,62
1364946,964502,2020-06-09,Assembly,"Assembly Floor Vote - Final Passage",144,0,0,3,147
1364946,966204,2020-05-28,Senate,"Senate Rules Committee Vote",19,0,0,0,19
1364946,966205,2020-06-08,Senate,"Senate Investigations and Government Operations Committee Vote",7,0,0,0,7
1365014,972316,2020-07-20,Senate,"Senate Consumer Protection Committee Vote",6,0,0,0,6
1365014,973355,2020-07-22,Senate,"Senate Rules Committee Vote",19,0,0,0,19
1365014,973739,2020-07-23,Senate,"Senate Floor Vote - Final Passage",60,0,0,0,60
1365026,973788,2020-07-20,Senate,"Senate Judiciary Committee Vote",15,0,0,0,15
1365026,973789,2020-07-21,Senate,"Senate Rules Committee Vote",19,0,0,0,19
1365026,973790,2020-07-22,Senate,"Senate Floor Vote - Final Passage",60,0,0,0,60
1365220,963722,2020-06-09,Assembly,"Assembly Rules Committee: Favorable",26,1,0,4,31
1365220,963723,2020-06-09,Assembly,"Assembly Ways And Means Committee: Favorable refer to committee Rules",29,3,0,3,35
1365220,965353,2020-06-10,Assembly,"Assembly Floor Vote - Final Passage",117,27,0,3,147
1365220,973149,2020-07-22,Senate,"Senate Floor Vote - Final Passage",51,9,0,0,60
1365238,971913,2020-07-17,Assembly,"Assembly Ways And Means Committee: Favorable refer to committee Rules",26,6,0,2,34
1365238,972537,2020-07-21,Assembly,"Assembly Rules Committee: Favorable",26,0,0,4,30
1365238,973134,2020-07-22,Senate,"Senate Floor Vote - Final Passage",44,16,0,0,60
1365238,973135,2020-07-22,Assembly,"Assembly Floor Vote - Final Passage",109,33,0,3,145
1365246,970954,2020-07-13,Assembly,"Assembly Children And Families Committee: Favorable refer to committee Rules",15,0,0,1,16
1365246,972533,2020-07-21,Assembly,"Assembly Rules Committee: Favorable",26,0,0,4,30
1365249,960281,2020-05-26,Assembly,"Assembly Local Governments Committee: Favorable refer to committee Rules",16,0,0,2,18
1365249,960697,2020-05-27,Assembly,"Assembly Rules Committee: Favorable",29,0,0,2,31
1365289,972955,2020-07-20,Senate,"Senate Health Committee Vote",14,0,0,1,15
1365289,973910,2020-07-21,Senate,"Senate Rules Committee Vote",19,0,0,0,19
1365289,973911,2020-07-22,Senate,"Senate Floor Vote - Final Passage",59,1,0,0,60
1365312,973301,2020-07-22,Senate,"Senate Rules Committee Vote",18,1,0,0,19
1365312,973626,2020-07-23,Senate,"Senate Floor Vote - Final Passage",56,4,0,0,60
1365312,973962,2020-07-22,Senate,"Senate Rules Committee Vote",18,1,0,0,19
1365661,972701,2020-07-20,Senate,"Senate Civil Service and Pensions Committee Vote",7,0,0,0,7
1365661,974032,2020-07-22,Senate,"Senate Floor Vote - Final Passage",60,0,0,0,60
1365661,974033,2020-07-22,Senate,"Senate Rules Committee Vote",19,0,0,0,19
1365668,972946,2020-07-20,Senate,"Senate Children and Families Committee Vote",7,0,0,0,7
1365668,973605,2020-07-22,Senate,"Senate Floor Vote - Final Passage",60,0,0,0,60
1365668,973942,2020-07-21,Senate,"Senate Rules Committee Vote",19,0,0,0,19
1365684,972991,2020-07-20,Senate,"Senate Labor Committee Vote",11,2,0,0,13
1365684,973247,2020-07-22,Senate,"Senate Rules Committee Vote",14,5,0,0,19
1365684,973740,2020-07-23,Senate,"Senate Floor Vote - Final Passage",43,17,0,0,60
1365685,972763,2020-07-20,Senate,"Senate Investigations and Government Operations Committee Vote",4,2,0,0,6
1365685,974065,2020-07-22,Senate,"Senate Floor Vote - Final Passage",44,16,0,0,60
1365685,974066,2020-07-22,Senate,"Senate Rules Committee Vote",18,1,0,0,19
1366028,973826,2020-07-20,Senate,"Senate Transportation Committee Vote",15,0,0,0,15
1366032,972612,2020-07-20,Senate,"Senate Health Committee Vote",14,0,0,1,15
1366032,973348,2020-07-22,Senate,"Senate Rules Committee Vote",19,0,0,0,19
1366032,973706,2020-07-22,Senate,"Senate Floor Vote - Final Passage",60,0,0,0,60
1366037,972761,2020-07-20,Senate,"Senate Investigations and Government Operations Committee Vote",4,2,0,0,6
1366037,972762,2020-07-21,Senate,"Senate Finance Committee Vote",21,2,0,0,23
1366037,974059,2020-07-22,Senate,"Senate Floor Vote - Final Passage",51,9,0,0,60
1366037,974060,2020-07-22,Senate,"Senate Rules Committee Vote",18,1,0,0,19
1366041,964723,2020-06-10,Senate,"Senate Floor Vote - Final Passage",61,1,0,0,62
1366041,965409,2020-06-10,Assembly,"Assembly Floor Vote - Final Passage",133,11,0,3,147
1366041,966299,2020-05-28,Senate,"Senate Rules Committee Vote",19,0,0,0,19
1366041,966300,2020-06-08,Senate,"Senate Local Government Committee Vote",7,0,0,0,7
1366159,964135,2020-06-09,Senate,"Senate Floor Vote - Final Passage",60,2,0,0,62
1366159,965420,2020-06-10,Assembly,"Assembly Floor Vote - Final Passage",144,0,0,3,147
1366159,966222,2020-05-28,Senate,"Senate Rules Committee Vote",19,0,0,0,19
1366159,966223,2020-06-08,Senate,"Senate Local Government Committee Vote",7,0,0,0,7
1366167,960565,2020-05-26,Assembly,"Assembly Codes Committee: Favorable refer to committee Rules",21,0,0,1,22
1366167,960956,2020-05-27,Assembly,"Assembly Rules Committee: Favorable",29,0,0,2,31
1366171,970754,2020-07-13,Assembly,"Assembly Health Committee: Favorable refer to committee Rules",24,0,0,2,26
1366177,960277,2020-05-26,Assembly,"Assembly Health Committee: Favorable refer to committee Rules",25,0,0,1,26
1366177,960601,2020-05-27,Assembly,"Assembly Rules Committee: Favorable",28,1,0,2,31
1366181,970936,2020-07-13,Assembly,"Assembly Agriculture Committee: Favorable refer to committee Ways and Means",19,0,0,2,21
1366181,971875,2020-07-17,Assembly,"Assembly Ways And Means Committee: Favorable refer to committee Rules",32,0,0,2,34
1366181,972169,2020-07-20,Assembly,"Assembly Rules Committee: Favorable",27,0,0,3,30
1366181,972623,2020-07-21,Assembly,"Assembly Floor Vote - Final Passage",142,0,0,3,145
1366181,973472,2020-07-22,Senate,"Senate Floor Vote - Final Passage",60,0,0,0,60
1366190,963754,2020-06-09,Assembly,"Assembly Rules Committee: Favorable",27,0,0,4,31
1366190,963755,2020-06-09,Assembly,"Assembly Ways And Means Committee: Favorable refer to committee Rules",32,0,0,3,35
1366190,965347,2020-06-10,Assembly,"Assembly Floor Vote - Final Passage",144,0,0,3,147
1366190,973473,2020-07-22,Senate,"Senate Floor Vote - Final Passage",60,0,0,0,60
1366200,971166,2020-07-14,Assembly,"Assembly Judiciary Committee: Favorable refer to committee Ways and Means",21,0,0,0,21
1366203,970761,2020-07-13,Assembly,"Assembly Health Committee: Favorable refer to committee Ways and Means",24,0,0,2,26
1366203,971871,2020-07-17,Assembly,"Assembly Ways And Means Committee: Favorable refer to committee Rules",31,1,0,2,34
1366203,972534,2020-07-21,Assembly,"Assembly Rules Committee: Favorable",26,0,0,4,30
1366203,973168,2020-07-22,Assembly,"Assembly Floor Vote - Final Passage",142,0,0,3,145
1366203,973498,2020-07-22,Senate,"Senate Floor Vote - Final Passage",59,1,0,0,60
1366218,972710,2020-07-20,Senate,"Senate Health Committee Vote",14,0,0,1,15
1366218,972711,2020-07-21,Senate,"Senate Finance Committee Vote",23,0,0,0,23
1366218,973341,2020-07-22,Senate,"Senate Rules Committee Vote",19,0,0,0,19
1366218,973708,2020-07-22,Senate,"Senate Floor Vote - Final Passage",59,1,0,0,60
1366223,960402,2020-05-24,Senate,"Senate Rules Committee Vote",19,0,0,0,19
1366223,960835,2020-05-27,Senate,"Senate Floor Vote - Final Passage",62,0,0,0,62
1366223,961061,2020-05-27,Assembly,"Assembly Floor Vote - Final Passage",143,0,0,4,147
1366223,966675,2020-05-26,Senate,"Senate Finance Committee Vote",23,0,0,0,23
1366232,972687,2020-07-21,Senate,"Senate Elections Committee Vote",5,2,0,0,7
1366232,973302,2020-07-22,Senate,"Senate Rules Committee Vote",12,7,0,0,19
1366232,973425,2020-07-24,Assembly,"Assembly Floor Vote - Final Passage",103,38,0,4,145
1366232,973622,2020-07-22,Senate,"Senate Floor Vote - Final Passage",40,20,0,0,60
1366242,960378,2020-05-24,Senate,"Senate Rules Committee Vote",19,0,0,0,19
1366242,960379,2020-05-26,Senate,"Senate Health Committee Vote",14,1,0,0,15
1366242,960786,2020-05-27,Senate,"Senate Floor Vote - Final Passage",59,3,0,0,62
1366242,961051,2020-05-27,Assembly,"Assembly Floor Vote - Final Passage",132,11,0,4,147
1366338,964130,2020-06-09,Senate,"Senate Floor Vote - Final Passage",62,0,0,0,62
1366338,965429,2020-06-10,Assembly,"Assembly Floor Vote - Final Passage",143,1,0,3,147
1366338,966371,2020-05-28,Senate,"Senate Rules Committee Vote",19,0,0,0,19
1366338,966372,2020-06-08,Senate,"Senate Local Government Committee Vote",7,0,0,0,7
1366707,960373,2020-05-24,Senate,"Senate Rules Committee Vote",19,0,0,0,19
1366707,960647,2020-05-27,Senate,"Senate Floor Vote - Final Passage",59,3,0,0,62
1366707,961056,2020-05-27,Assembly,"Assembly Floor Vote - Final Passage",124,20,0,3,147
1366707,966262,2020-05-26,Senate,"Senate Finance Committee Vote",23,0,0,0,23
1366720,960397,2020-05-24,Senate,"Senate Rules Committee Vote",19,0,0,0,19
1366720,960811,2020-05-27,Senate,"Senate Floor Vote - Final Passage",61,1,0,0,62
1366720,961059,2020-05-27,Assembly,"Assembly Floor Vote - Final Passage",125,19,0,3,147
1366865,960482,2020-05-26,Assembly,"Assembly Libraries And Education Technology Committee: Favorable refer to committee Ways and Means",9,0,0,0,9
1366865,960594,2020-05-27,Assembly,"Assembly Ways And Means Committee: Favorable refer to committee Rules",33,0,0,2,35
1366865,960959,2020-05-27,Assembly,"Assembly Rules Committee: Favorable",29,0,0,2,31
1366907,973037,2020-07-20,Senate,"Senate Health Committee Vote",14,0,0,1,15
1366907,973353,2020-07-22,Senate,"Senate Rules Committee Vote",19,0,0,0,19
1366907,973709,2020-07-22,Senate,"Senate Floor Vote - Final Passage",60,0,0,0,60
1366931,960377,2020-05-26,Assembly,"Assembly Codes Committee: Favorable refer to committee Rules",20,1,0,1,22
1366931,960948,2020-05-27,Assembly,"Assembly Rules Committee: Favorable",29,0,0,2,31
1366934,960502,2020-05-26,Assembly,"Assembly Alcoholism And Drug Abuse Committee: Favorable refer to committee Rules",12,0,0,2,14
1366934,960961,2020-05-27,Assembly,"Assembly Rules Committee: Favorable",29,0,0,2,31
1366936,970744,2020-07-13,Assembly,"Assembly Health Committee: Favorable refer to committee Codes",24,0,0,2,26
1366936,971893,2020-07-17,Assembly,"Assembly Codes Committee: Favorable refer to committee Rules",21,0,0,1,22
1366936,972224,2020-07-20,Assembly,"Assembly Rules Committee: Favorable",27,0,0,3,30
1366936,972618,2020-07-21,Assembly,"Assembly Floor Vote - Final Passage",142,0,0,3,145
1366936,973729,2020-07-23,Senate,"Senate Floor Vote - Final Passage",60,0,0,0,60
1366939,960483,2020-05-26,Assembly,"Assembly Higher Education Committee: Favorable refer to committee Rules",24,0,0,1,25
1366939,960951,2020-05-27,Assembly,"Assembly Rules Committee: Favorable",29,0,0,2,31
1366942,970773,2020-07-13,Assembly,"Assembly Health Committee: Favorable refer to committee Ways and Means",24,0,0,2,26
1366942,972855,2020-07-22,Assembly,"Assembly Ways And Means Committee: Favorable refer to committee Rules",32,0,0,2,34
1366942,973046,2020-07-22,Assembly,"Assembly Rules Committee: Favorable",29,0,0,1,30
1366942,973454,2020-07-23,Assembly,"Assembly Floor Vote - Final Passage",141,0,0,4,145
1366943,970743,2020-07-13,Assembly,"Assembly Health Committee: Favorable refer to committee Rules",24,0,0,2,26
1366943,972561,2020-07-21,Assembly,"Assembly Rules Committee: Favorable",26,0,0,4,30
1366943,973131,2020-07-22,Senate,"Senate Floor Vote - Final Passage",60,0,0,0,60
1366943,973132,2020-07-22,Assembly,"Assembly Floor Vote - Final Passage",142,0,0,3,145
1366946,970951,2020-07-13,Assembly,"Assembly Children And Families Committee: Favorable refer to committee Ways and Means",12,3,0,1,16
1366946,971831,2020-07-17,Assembly,"Assembly Ways And Means Committee: Favorable refer to committee Rules",32,0,0,2,34
1366946,972204,2020-07-20,Assembly,"Assembly Rules Committee: Favorable",27,0,0,3,30
1366946,973156,2020-07-22,Assembly,"Assembly Floor Vote - Final Passage",141,1,0,3,145
1366946,973406,2020-07-22,Senate,"Senate Floor Vote - Final Passage",60,0,0,0,60
1366951,964587,2020-06-10,Assembly,"Assembly Rules Committee: Favorable",27,1,0,3,31
1366951,964588,2020-06-10,Assembly,"Assembly Ways And Means Committee: Favorable refer to committee Rules",30,1,0,4,35
1366951,965287,2020-06-10,Assembly,"Assembly Floor Vote - Final Passage",142,2,0,3,147
1366951,973537,2020-07-22,Senate,"Senate Floor Vote - Final Passage",60,0,0,0,60
1366954,960403,2020-05-24,Senate,"Senate Rules Committee Vote",19,0,0,0,19
1366954,960404,2020-05-26,Senate,"Senate Corporations, Authorities and Commissions Committee Vote",7,0,0,0,7
1366954,960830,2020-05-27,Senate,"Senate Floor Vote - Final Passage",62,0,0,0,62
1366954,961060,2020-05-27,Assembly,"Assembly Floor Vote - Final Passage",142,2,0,3,147
1366964,970782,2020-07-13,Assembly,"Assembly Mental Health Committee: Favorable refer to committee Ways and Means",13,0,0,0,13
1366964,972949,2020-07-22,Assembly,"Assembly Ways And Means Committee: Favorable refer to committee Rules",32,0,0,2,34
1366970,970885,2020-07-13,Assembly,"Assembly Health Committee: Favorable refer to committee Ways and Means",24,0,0,2,26
1366973,960512,2020-05-26,Assembly,"Assembly Corporations, Authorities And Commissions Committee: Favorable refer to committee Rules",26,0,0,0,26
1366973,960667,2020-05-27,Assembly,"Assembly Rules Committee: Favorable",29,0,0,2,31
1366978,960498,2020-05-26,Assembly,"Assembly Local Governments Committee: Favorable refer to committee Ways and Means",16,0,0,2,18
1366978,960597,2020-05-27,Assembly,"Assembly Ways And Means Committee: Favorable refer to committee Rules",30,2,1,2,35
1366978,960683,2020-05-27,Assembly,"Assembly Rules Committee: Favorable",28,1,0,2,31
1366978,961067,2020-05-27,Assembly,"Assembly Floor Vote - Final Passage",142,0,0,5,147
1366978,961342,2020-05-28,Senate,"Senate Floor Vote - Final Passage",61,0,0,1,62
1366983,971992,2020-07-17,Assembly,"Assembly Codes Committee: Favorable refer to committee Rules",15,6,0,1,22
1366983,972231,2020-07-20,Assembly,"Assembly Rules Committee: Favorable",20,7,0,3,30
1366984,971078,2020-07-13,Assembly,"Assembly Health Committee: Favorable refer to committee Ways and Means",24,0,0,2,26
1367056,964721,2020-06-10,Senate,"Senate Floor Vote - Final Passage",61,1,0,0,62
1367056,965413,2020-06-10,Assembly,"Assembly Floor Vote - Final Passage",144,0,0,3,147
1367056,966338,2020-05-28,Senate,"Senate Rules Committee Vote",19,0,0,0,19
1367062,960588,2020-05-27,Assembly,"Assembly Ways And Means Committee: Favorable refer to committee Rules",20,12,1,2,35
1367062,960934,2020-05-27,Assembly,"Assembly Rules Committee: Favorable",27,2,0,2,31
1367063,960583,2020-05-27,Assembly,"Assembly Ways And Means Committee: Favorable refer to committee Rules",31,2,0,2,35
1367063,960949,2020-05-27,Assembly,"Assembly Rules Committee: Favorable",28,1,0,2,31
1367064,960289,2020-05-26,Assembly,"Assembly Health Committee: Favorable refer to committee Rules",25,0,0,1,26
1367064,960958,2020-05-27,Assembly,"Assembly Rules Committee: Favorable",29,0,0,2,31
1367064,962488,2020-05-28,Assembly,"Assembly Floor Vote - Final Passage",44,99,0,4,147
1367065,960515,2020-05-24,Senate,"Senate Rules Committee Vote",14,5,0,0,19
1367065,960729,2020-05-27,Senate,"Senate Floor Vote - Final Passage",39,23,0,0,62
1367065,961088,2020-05-27,Assembly,"Assembly Floor Vote - Final Passage",104,40,0,3,147
1367065,966390,2020-05-26,Senate,"Senate Finance Committee Vote",16,7,0,0,23
1367066,960269,2020-05-26,Senate,"Senate Local Government Committee Vote",7,0,0,0,7
1367066,960546,2020-05-26,Senate,"Senate Local Government Committee Vote",7,0,0,0,7
1367067,972820,2020-07-22,Assembly,"Assembly Ways And Means Committee: Favorable refer to committee Rules",24,8,0,2,34
1367068,960375,2020-05-24,Senate,"Senate Rules Committee Vote",19,0,0,0,19
1367068,960780,2020-05-27,Senate,"Senate Floor Vote - Final Passage",62,0,0,0,62
1367068,961488,2020-05-28,Assembly,"Assembly Floor Vote - Final Passage",110,33,0,4,147
1367068,966401,2020-05-26,Senate,"Senate Codes Committee Vote",12,0,0,0,12
1367069,960362,2020-05-24,Senate,"Senate Rules Committee Vote",19,0,0,0,19
1367069,960363,2020-05-26,Senate,"Senate Corporations, Authorities and Commissions Committee Vote",7,0,0,0,7
1367069,960641,2020-05-27,Senate,"Senate Floor Vote - Final Passage",62,0,0,0,62
1367069,961133,2020-05-27,Assembly,"Assembly Floor Vote - Final Passage",143,0,0,4,147
1367070,960334,2020-05-26,Assembly,"Assembly Real Property Taxation Committee: Favorable refer to committee Ways and Means",10,0,0,0,10
1367070,960596,2020-05-27,Assembly,"Assembly Ways And Means Committee: Favorable refer to committee Rules",33,0,0,2,35
1367070,960705,2020-05-27,Assembly,"Assembly Rules Committee: Favorable",29,0,0,2,31
1367071,960580,2020-05-27,Assembly,"Assembly Ways And Means Committee: Favorable refer to committee Rules",23,10,0,2,35
1367071,960581,2020-05-27,Assembly,"Assembly Election Law Committee: Favorable refer to committee Ways and Means",12,4,0,0,16
1367071,960608,2020-05-27,Assembly,"Assembly Rules Committee: Favorable",22,7,0,2,31
1367072,960417,2020-05-26,Assembly,"Assembly Corporations, Authorities And Commissions Committee: Favorable refer to committee Ways and Means",20,6,0,0,26
1367072,960591,2020-05-27,Assembly,"Assembly Ways And Means Committee: Favorable refer to committee Rules",27,6,0,2,35
1367072,960712,2020-05-27,Assembly,"Assembly Rules Committee: Favorable",28,1,0,2,31
1367073,960385,2020-05-24,Senate,"Senate Rules Committee Vote",19,0,0,0,19
1367073,960795,2020-05-27,Senate,"Senate Floor Vote - Final Passage",62,0,0,0,62
1367073,961052,2020-05-27,Assembly,"Assembly Floor Vote - Final Passage",143,0,0,4,147
1367073,966650,2020-05-26,Senate,"Senate Finance Committee Vote",23,0,0,0,23
1367074,960361,2020-05-24,Senate,"Senate Rules Committee Vote",13,6,0,0,19
1367074,960757,2020-05-27,Senate,"Senate Floor Vote - Final Passage",35,27,0,0,62
1367074,961048,2020-05-27,Assembly,"Assembly Floor Vote - Final Passage",109,35,0,3,147
1367074,966259,2020-05-26,Senate,"Senate Codes Committee Vote",9,3,0,0,12
1367075,960509,2020-05-24,Senate,"Senate Rules Committee Vote",19,0,0,0,19
1367075,960510,2020-05-26,Senate,"Senate Health Committee Vote",15,0,0,0,15
1367075,960645,2020-05-27,Senate,"Senate Floor Vote - Final Passage",61,1,0,0,62
1367075,961089,2020-05-27,Assembly,"Assembly Floor Vote - Final Passage",134,10,0,3,147
1367081,960367,2020-05-24,Senate,"Senate Rules Committee Vote",19,0,0,0,19
1367081,962274,2020-05-28,Senate,"Senate Floor Vote - Final Passage",61,0,0,1,62
1367081,966950,2020-05-26,Senate,"Senate Finance Committee Vote",23,0,0,0,23
1367082,960507,2020-05-24,Senate,"Senate Rules Committee Vote",18,1,0,0,19
1367082,966316,2020-05-26,Senate,"Senate Finance Committee Vote",22,1,0,0,23
1367085,960887,2020-05-27,Assembly,"Assembly Ways And Means Committee: Favorable refer to committee Rules",29,4,0,2,35
1367086,960555,2020-05-24,Senate,"Senate Rules Committee Vote",19,0,0,0,19
1367086,966635,2020-05-26,Senate,"Senate Finance Committee Vote",23,0,0,0,23
1367087,960369,2020-05-24,Senate,"Senate Rules Committee Vote",19,0,0,0,19
1367087,960370,2020-05-26,Senate,"Senate Housing, Construction and Community Development Committee Vote",11,0,0,0,11
1367087,961481,2020-05-28,Senate,"Senate Floor Vote - Final Passage",61,0,0,1,62
1367087,961482,2020-05-28,Assembly,"Assembly Floor Vote - Final Passage",133,10,0,4,147
1367087,966431,2020-05-26,Senate,"Senate Finance Committee Vote",22,1,0,0,23
1367088,961080,2020-05-28,Assembly,"Assembly Ways And Means Committee: Favorable refer to committee Rules Correction Date:05/28/2020",31,1,0,3,35
1367088,962243,2020-05-28,Assembly,"Assembly Floor Vote - Final Passage",98,45,0,4,147
1367088,962244,2020-05-28,Assembly,"Assembly Ways And Means Committee: Favorable refer to committee Rules Correction Date:05/28/2020",31,1,0,3,35
1367089,960586,2020-05-27,Assembly,"Assembly Ways And Means Committee: Favorable refer to committee Rules",32,0,1,2,35
1367089,960954,2020-05-27,Assembly,"Assembly Rules Committee: Favorable",28,1,0,2,31
1367095,972941,2020-07-20,Senate,"Senate Children and Families Committee Vote",7,0,0,0,7
1367095,973886,2020-07-21,Senate,"Senate Rules Committee Vote",19,0,0,0,19
1367095,973887,2020-07-22,Senate,"Senate Floor Vote - Final Passage",60,0,0,0,60
1367719,961452,2020-05-29,Assembly,"Assembly Floor Vote - Final Passage",142,1,0,4,147
1367719,961665,2020-05-28,Senate,"Senate Floor Vote - Final Passage",61,0,0,1,62
1367719,966641,2020-05-28,Senate,"Senate Rules Committee Vote",19,0,0,0,19
1367723,961454,2020-05-29,Assembly,"Assembly Floor Vote - Final Passage",99,44,0,4,147
1367723,961554,2020-05-28,Senate,"Senate Floor Vote - Final Passage",57,4,0,1,62
1367723,966240,2020-05-28,Senate,"Senate Rules Committee Vote",19,0,0,0,19
1367724,961508,2020-05-29,Assembly,"Assembly Rules Committee: Favorable",26,0,0,5,31
1367724,961509,2020-05-29,Assembly,"Assembly Rules Committee: Favorable",20,6,0,5,31
1367724,961510,2020-05-29,Assembly,"Assembly Ways And Means Committee: Favorable refer to committee Rules",29,0,0,6,35
1367726,961471,2020-05-29,Assembly,"Assembly Rules Committee: Favorable",26,0,0,5,31
1367726,961472,2020-05-29,Assembly,"Assembly Rules Committee: Favorable",20,6,0,5,31
1367726,961473,2020-05-29,Assembly,"Assembly Ways And Means Committee: Favorable refer to committee Rules",28,1,0,6,35
1367727,970825,2020-07-13,Assembly,"Assembly Banks Committee: Favorable refer to committee Codes",23,6,0,2,31
1367727,971746,2020-07-17,Assembly,"Assembly Codes Committee: Favorable refer to committee Rules",21,0,0,1,22
1367727,972868,2020-07-22,Assembly,"Assembly Rules Committee: Favorable",22,7,0,1,30
1367740,963802,2020-06-09,Assembly,"Assembly Rules Committee: Favorable",27,0,0,4,31
1367740,963803,2020-06-09,Assembly,"Assembly Ways And Means Committee: Favorable refer to committee Rules",32,0,0,3,35
1367748,971385,2020-07-16,Assembly,"Assembly Governmental Employees Committee: Favorable refer to committee Ways and Means",14,0,0,0,14
1367748,971906,2020-07-17,Assembly,"Assembly Ways And Means Committee: Favorable refer to committee Rules",22,10,0,2,34
1367748,973104,2020-07-22,Assembly,"Assembly Rules Committee: Favorable",29,0,0,1,30
1367823,972299,2020-07-20,Senate,"Senate Local Government Committee Vote",5,2,0,0,7
1367823,973356,2020-07-22,Senate,"Senate Rules Committee Vote",15,4,0,0,19
1367873,973252,2020-07-22,Senate,"Senate Rules Committee Vote",13,6,0,0,19
1367873,973662,2020-07-23,Senate,"Senate Floor Vote - Final Passage",42,18,0,0,60
1367873,973663,2020-07-23,Assembly,"Assembly Floor Vote - Final Passage",90,51,0,4,145
1368186,972694,2020-07-20,Senate,"Senate Health Committee Vote",14,0,0,1,15
1368186,974082,2020-07-22,Senate,"Senate Rules Committee Vote",19,0,0,0,19
1368186,974083,2020-07-23,Senate,"Senate Floor Vote - Final Passage",60,0,0,0,60
1368196,970810,2020-07-13,Assembly,"Assembly Health Committee: Favorable refer to committee Rules",24,0,0,2,26
1368196,972541,2020-07-21,Assembly,"Assembly Rules Committee: Favorable",26,0,0,4,30
1368196,973438,2020-07-23,Assembly,"Assembly Floor Vote - Final Passage",140,2,0,3,145
1368196,973720,2020-07-23,Senate,"Senate Floor Vote - Final Passage",56,4,0,0,60
1368200,970866,2020-07-13,Assembly,"Assembly Economic Development Committee: Favorable refer to committee Ways and Means",24,0,0,1,25
1368200,971901,2020-07-17,Assembly,"Assembly Ways And Means Committee: Favorable refer to committee Rules",32,0,0,2,34
1368200,972185,2020-07-20,Assembly,"Assembly Rules Committee: Favorable",27,0,0,3,30
1368200,972721,2020-07-21,Assembly,"Assembly Floor Vote - Final Passage",142,0,0,3,145
1368209,971299,2020-07-15,Assembly,"Assembly Social Services Committee: Favorable refer to committee Ways and Means",17,0,0,0,17
1368209,971867,2020-07-17,Assembly,"Assembly Ways And Means Committee: Favorable refer to committee Rules",32,0,0,2,34
1368209,972573,2020-07-21,Assembly,"Assembly Rules Committee: Favorable",26,0,0,4,30
1368209,973183,2020-07-22,Assembly,"Assembly Floor Vote - Final Passage",142,0,0,3,145
1368209,973410,2020-07-22,Senate,"Senate Floor Vote - Final Passage",59,1,0,0,60
1368217,972315,2020-07-20,Senate,"Senate Agriculture Committee Vote",9,0,0,0,9
1368217,972933,2020-07-21,Senate,"Senate Finance Committee Vote",23,0,0,0,23
1368217,973888,2020-07-21,Senate,"Senate Finance Committee Vote",23,0,0,0,23
1368217,973889,2020-07-22,Senate,"Senate Floor Vote - Final Passage",60,0,0,0,60
1368256,972971,2020-07-20,Senate,"Senate Health Committee Vote",13,1,0,1,15
1368256,973322,2020-07-22,Senate,"Senate Rules Committee Vote",18,1,0,0,19
1368256,973615,2020-07-23,Senate,"Senate Floor Vote - Final Passage",55,5,0,0,60
1368262,972692,2020-07-21,Senate,"Senate Elections Committee Vote",6,1,0,0,7
1368262,973213,2020-07-22,Senate,"Senate Rules Committee Vote",19,0,0,0,19
1368262,973597,2020-07-22,Senate,"Senate Floor Vote - Final Passage",58,2,0,0,60
1368273,972639,2020-07-20,Senate,"Senate Children and Families Committee Vote",7,0,0,0,7
1368273,972640,2020-07-21,Senate,"Senate Finance Committee Vote",23,0,0,0,23
1368275,972930,2020-07-20,Senate,"Senate Health Committee Vote",14,0,0,1,15
1368275,973581,2020-07-22,Senate,"Senate Floor Vote - Final Passage",59,1,0,0,60
1368275,973949,2020-07-21,Senate,"Senate Rules Committee Vote",18,1,0,0,19
1368276,971703,2020-07-16,Assembly,"Assembly Local Governments Committee: Favorable refer to committee Ways and Means",18,1,0,1,20
1368276,971763,2020-07-17,Assembly,"Assembly Ways And Means Committee: Favorable refer to committee Rules",30,2,0,2,34
1368276,972871,2020-07-22,Assembly,"Assembly Rules Committee: Favorable",29,0,0,1,30
1368287,972918,2020-07-20,Senate,"Senate Investigations and Government Operations Committee Vote",6,0,0,0,6
1368287,973598,2020-07-22,Senate,"Senate Floor Vote - Final Passage",58,2,0,0,60
1368287,973929,2020-07-21,Senate,"Senate Rules Committee Vote",19,0,0,0,19
1368293,970883,2020-07-13,Assembly,"Assembly Children And Families Committee: Favorable refer to committee Codes",13,2,0,1,16
1368293,971861,2020-07-17,Assembly,"Assembly Codes Committee: Favorable refer to committee Rules",15,6,0,1,22
1368310,972430,2020-07-20,Senate,"Senate Local Government Committee Vote",7,0,0,0,7
1368423,972622,2020-07-20,Senate,"Senate Investigations and Government Operations Committee Vote",6,0,0,0,6
1368423,973271,2020-07-22,Senate,"Senate Rules Committee Vote",18,1,0,0,19
1368423,973683,2020-07-22,Senate,"Senate Floor Vote - Final Passage",56,4,0,0,60
1368426,964672,2020-06-10,Senate,"Senate Floor Vote - Final Passage",62,0,0,0,62
1368426,965339,2020-06-10,Assembly,"Assembly Floor Vote - Final Passage",132,12,0,3,147
1368426,966233,2020-06-09,Senate,"Senate Rules Committee Vote",19,0,0,0,19
1368438,964585,2020-06-10,Assembly,"Assembly Rules Committee: Favorable",28,0,0,3,31
1368438,964586,2020-06-10,Assembly,"Assembly Ways And Means Committee: Favorable refer to committee Rules",31,0,0,4,35
1368441,970884,2020-07-13,Assembly,"Assembly Children And Families Committee: Favorable refer to committee Ways and Means",12,3,0,1,16
1368441,971896,2020-07-17,Assembly,"Assembly Ways And Means Committee: Favorable refer to committee Rules",28,4,0,2,34
1368441,972734,2020-07-22,Assembly,"Assembly Rules Committee: Favorable",24,1,0,5,30
1368462,964556,2020-06-10,Assembly,"Assembly Rules Committee: Favorable",28,0,0,3,31
1368462,964557,2020-06-10,Assembly,"Assembly Ways And Means Committee: Favorable refer to committee Rules",31,0,0,4,35
1368471,964545,2020-06-10,Assembly,"Assembly Rules Committee: Favorable",28,0,0,3,31
1368471,964546,2020-06-10,Assembly,"Assembly Ways And Means Committee: Favorable refer to committee Rules",31,0,0,4,35
1368471,965285,2020-06-10,Assembly,"Assembly Floor Vote - Final Passage",144,0,0,3,147
1368471,973549,2020-07-22,Senate,"Senate Floor Vote - Final Passage",58,2,0,0,60
1368482,964541,2020-06-10,Assembly,"Assembly Rules Committee: Favorable",28,0,0,3,31
1368482,964542,2020-06-10,Assembly,"Assembly Ways And Means Committee: Favorable refer to committee Rules",31,0,0,4,35
1368558,964107,2020-06-09,Senate,"Senate Floor Vote - Final Passage",62,0,0,0,62
1368558,964729,2020-06-09,Assembly,"Assembly Floor Vote - Final Passage",143,1,0,3,147
1368558,966324,2020-05-28,Senate,"Senate Rules Committee Vote",19,0,0,0,19
1368558,966325,2020-06-08,Senate,"Senate Finance Committee Vote",23,0,0,0,23
1368558,966326,2020-06-08,Senate,"Senate Investigations and Government Operations Committee Vote",7,0,0,0,7
1368576,964084,2020-06-09,Senate,"Senate Floor Vote - Final Passage",61,1,0,0,62
1368576,964638,2020-06-08,Senate,"Senate Commerce, Economic Development and Small Business Committee Vote",9,0,0,0,9
1368576,966203,2020-06-08,Senate,"Senate Commerce, Economic Development and Small Business Committee Vote",9,0,0,0,9
1368643,964073,2020-06-09,Senate,"Senate Floor Vote - Final Passage",60,2,0,0,62
1368643,965407,2020-06-10,Assembly,"Assembly Floor Vote - Final Passage",144,0,0,3,147
1368643,966303,2020-05-28,Senate,"Senate Rules Committee Vote",19,0,0,0,19
1368643,966304,2020-06-08,Senate,"Senate Local Government Committee Vote",7,0,0,0,7
1368648,973494,2020-07-22,Senate,"Senate Floor Vote - Final Passage",60,0,0,0,60
1368648,973820,2020-07-20,Senate,"Senate Transportation Committee Vote",15,0,0,0,15
1368648,973821,2020-07-21,Senate,"Senate Rules Committee Vote",19,0,0,0,19
1368665,964176,2020-06-09,Senate,"Senate Floor Vote - Final Passage",62,0,0,0,62
1368665,966301,2020-05-28,Senate,"Senate Rules Committee Vote",18,1,0,0,19
1368665,966302,2020-06-08,Senate,"Senate Transportation Committee Vote",15,0,0,0,15
1368689,964563,2020-06-10,Assembly,"Assembly Rules Committee: Favorable",28,0,0,3,31
1368689,964564,2020-06-10,Assembly,"Assembly Ways And Means Committee: Favorable refer to committee Rules",31,0,0,4,35
1368692,972875,2020-07-22,Assembly,"Assembly Rules Committee: Favorable",27,2,0,1,30
1368692,972876,2020-07-22,Assembly,"Assembly Ways And Means Committee: Favorable refer to committee Rules",22,10,0,2,34
1368699,964612,2020-06-10,Assembly,"Assembly Rules Committee: Favorable",28,0,0,3,31
1368699,964613,2020-06-10,Assembly,"Assembly Ways And Means Committee: Favorable refer to committee Rules",30,1,0,4,35
1368699,965399,2020-06-10,Assembly,"Assembly Floor Vote - Final Passage",143,1,0,3,147
1368699,973545,2020-07-23,Senate,"Senate Floor Vote - Final Passage",60,0,0,0,60
1368718,971704,2020-07-16,Assembly,"Assembly Real Property Taxation Committee: Favorable refer to committee Ways and Means",10,0,0,0,10
1368718,971757,2020-07-17,Assembly,"Assembly Ways And Means Committee: Favorable refer to committee Rules",32,0,0,2,34
1368718,973099,2020-07-22,Assembly,"Assembly Rules Committee: Favorable",29,0,0,1,30
1368727,970855,2020-07-13,Assembly,"Assembly Agriculture Committee: Favorable refer to committee Ways and Means",19,0,0,2,21
1368727,971877,2020-07-17,Assembly,"Assembly Ways And Means Committee: Favorable refer to committee Rules",32,0,0,2,34
1368727,972210,2020-07-20,Assembly,"Assembly Rules Committee: Favorable",27,0,0,3,30
1368727,972738,2020-07-21,Assembly,"Assembly Floor Vote - Final Passage",142,0,0,3,145
1368727,973526,2020-07-22,Senate,"Senate Floor Vote - Final Passage",60,0,0,0,60
1368728,966084,2020-06-08,Senate,"Senate Floor Vote - Final Passage",56,6,0,0,62
1368728,967209,2020-05-28,Senate,"Senate Rules Committee Vote",18,1,0,0,19
1368729,963481,2020-06-08,Senate,"Senate Floor Vote - Final Passage",59,3,0,0,62
1368729,963482,2020-06-08,Assembly,"Assembly Codes Committee: Favorable refer to committee Rules",16,5,0,1,22
1368729,963483,2020-06-08,Assembly,"Assembly Rules Committee: Favorable",22,4,0,5,31
1368729,963681,2020-06-08,Assembly,"Assembly Floor Vote - Final Passage",105,39,0,3,147
1368731,963489,2020-06-08,Senate,"Senate Floor Vote - Final Passage",60,2,0,0,62
1368731,963490,2020-06-08,Assembly,"Assembly Codes Committee: Favorable refer to committee Rules",16,5,0,1,22
1368731,963491,2020-06-08,Assembly,"Assembly Rules Committee: Favorable",23,3,0,5,31
1368731,963680,2020-06-08,Assembly,"Assembly Floor Vote - Final Passage",100,44,0,3,147
1368734,964202,2020-06-09,Senate,"Senate Floor Vote - Final Passage",61,1,0,0,62
1368734,964555,2020-06-09,Assembly,"Assembly Floor Vote - Final Passage",142,2,0,3,147
1368734,966246,2020-05-28,Senate,"Senate Rules Committee Vote",19,0,0,0,19
1368734,966247,2020-06-08,Senate,"Senate Finance Committee Vote",23,0,0,0,23
1368735,972422,2020-07-20,Senate,"Senate Local Government Committee Vote",7,0,0,0,7
1368735,972627,2020-07-21,Senate,"Senate Finance Committee Vote",22,1,0,0,23
1368735,974001,2020-07-22,Senate,"Senate Floor Vote - Final Passage",56,4,0,0,60
1368735,974002,2020-07-22,Senate,"Senate Rules Committee Vote",18,1,0,0,19
1368737,964139,2020-06-09,Senate,"Senate Floor Vote - Final Passage",62,0,0,0,62
1368737,966208,2020-05-28,Senate,"Senate Rules Committee Vote",18,1,0,0,19
1368737,966539,2020-06-08,Senate,"Senate Finance Committee Vote",23,0,0,0,23
1368738,963391,2020-06-08,Assembly,"Assembly Governmental Operations Committee: Favorable refer to committee Codes",11,3,0,0,14
1368738,963475,2020-06-08,Assembly,"Assembly Codes Committee: Favorable refer to committee Rules",15,6,0,1,22
1368738,963476,2020-06-08,Assembly,"Assembly Rules Committee: Favorable",19,7,0,5,31
1368739,964235,2020-06-09,Senate,"Senate Floor Vote - Final Passage",40,22,0,0,62
1368739,964499,2020-06-09,Assembly,"Assembly Floor Vote - Final Passage",101,43,0,3,147
1368739,967011,2020-05-28,Senate,"Senate Rules Committee Vote",15,4,0,0,19
1368769,972339,2020-07-20,Senate,"Senate Local Government Committee Vote",7,0,0,0,7
1368769,973851,2020-07-21,Senate,"Senate Rules Committee Vote",19,0,0,0,19
1368769,973852,2020-07-22,Senate,"Senate Floor Vote - Final Passage",58,2,0,0,60
1368781,972698,2020-07-20,Senate,"Senate Health Committee Vote",14,0,0,1,15
1368781,974087,2020-07-22,Senate,"Senate Rules Committee Vote",19,0,0,0,19
1368781,974088,2020-07-23,Senate,"Senate Floor Vote - Final Passage",60,0,0,0,60
1368849,972347,2020-07-20,Senate,"Senate Local Government Committee Vote",7,0,0,0,7
1368849,973908,2020-07-21,Senate,"Senate Rules Committee Vote",19,0,0,0,19
1368849,973909,2020-07-22,Senate,"Senate Floor Vote - Final Passage",60,0,0,0,60
1368904,972401,2020-07-20,Senate,"Senate Local Government Committee Vote",7,0,0,0,7
1368904,974004,2020-07-22,Senate,"Senate Floor Vote - Final Passage",58,2,0,0,60
1368904,974005,2020-07-22,Senate,"Senate Rules Committee Vote",19,0,0,0,19
1368917,972424,2020-07-20,Senate,"Senate Local Government Committee Vote",7,0,0,0,7
1368917,974044,2020-07-22,Senate,"Senate Floor Vote - Final Passage",58,2,0,0,60
1368917,974045,2020-07-22,Senate,"Senate Rules Committee Vote",19,0,0,0,19
1368931,972628,2020-07-21,Senate,"Senate Finance Committee Vote",23,0,0,0,23
1368931,973319,2020-07-22,Senate,"Senate Rules Committee Vote",19,0,0,0,19
1368931,974198,2020-07-22,Senate,"Senate Rules Committee Vote",19,0,0,0,19
1368931,974199,2020-07-23,Senate,"Senate Floor Vote - Final Passage",59,1,0,0,60
1368946,972428,2020-07-20,Senate,"Senate Local Government Committee Vote",7,0,0,0,7
1368946,973278,2020-07-22,Senate,"Senate Rules Committee Vote",19,0,0,0,19
1368946,973391,2020-07-23,Assembly,"Assembly Floor Vote - Final Passage",139,2,0,4,145
1368946,973689,2020-07-22,Senate,"Senate Floor Vote - Final Passage",60,0,0,0,60
1368955,972459,2020-07-20,Senate,"Senate Local Government Committee Vote",7,0,0,0,7
1368955,974028,2020-07-22,Senate,"Senate Floor Vote - Final Passage",58,2,0,0,60
1368955,974029,2020-07-22,Senate,"Senate Rules Committee Vote",19,0,0,0,19
1369103,964897,2020-06-10,Senate,"Senate Floor Vote - Final Passage",42,20,0,0,62
1369103,965295,2020-06-10,Assembly,"Assembly Floor Vote - Final Passage",121,23,0,3,147
1369103,966254,2020-06-09,Senate,"Senate Rules Committee Vote",12,7,0,0,19
1369137,964693,2020-06-10,Assembly,"Assembly Rules Committee: Favorable",21,7,0,3,31
1369137,964694,2020-06-10,Assembly,"Assembly Rules Committee: Favorable",21,7,0,3,31
1369137,964695,2020-06-10,Assembly,"Assembly Ways And Means Committee: Favorable refer to committee Rules",22,9,0,4,35
1369144,972629,2020-07-21,Senate,"Senate Finance Committee Vote",23,0,0,0,23
1369144,974013,2020-07-22,Senate,"Senate Floor Vote - Final Passage",60,0,0,0,60
1369144,974014,2020-07-22,Senate,"Senate Rules Committee Vote",19,0,0,0,19
1369150,972630,2020-07-21,Senate,"Senate Finance Committee Vote",23,0,0,0,23
1369150,974020,2020-07-22,Senate,"Senate Floor Vote - Final Passage",60,0,0,0,60
1369150,974021,2020-07-22,Senate,"Senate Rules Committee Vote",19,0,0,0,19
1369155,972647,2020-07-21,Senate,"Senate Finance Committee Vote",22,1,0,0,23
1369155,974034,2020-07-21,Senate,"Senate Finance Committee Vote",22,1,0,0,23
1369155,974035,2020-07-22,Senate,"Senate Floor Vote - Final Passage",59,1,0,0,60
1369155,974036,2020-07-22,Senate,"Senate Rules Committee Vote",18,1,0,0,19
1369220,973328,2020-07-22,Senate,"Senate Rules Committee Vote",19,0,0,0,19
1369220,973487,2020-07-22,Senate,"Senate Floor Vote - Final Passage",59,1,0,0,60
1369220,973815,2020-07-22,Senate,"Senate Rules Committee Vote",19,0,0,0,19
1369239,972900,2020-07-22,Assembly,"Assembly Rules Committee: Favorable",22,7,0,1,30
1369239,972901,2020-07-22,Assembly,"Assembly Codes Committee: Favorable refer to committee Rules",15,6,0,1,22
1369262,971054,2020-07-14,Assembly,"Assembly Higher Education Committee: Favorable refer to committee Rules",25,0,0,0,25
1369262,972571,2020-07-21,Assembly,"Assembly Rules Committee: Favorable",26,0,0,4,30
1369262,973128,2020-07-22,Assembly,"Assembly Floor Vote - Final Passage",142,0,0,3,145
1369262,973685,2020-07-22,Senate,"Senate Floor Vote - Final Passage",60,0,0,0,60
1369268,971650,2020-07-16,Assembly,"Assembly Governmental Operations Committee: Favorable refer to committee Rules",13,1,0,0,14
1369268,972164,2020-07-20,Assembly,"Assembly Rules Committee: Favorable",27,0,0,3,30
1369268,973386,2020-07-22,Assembly,"Assembly Floor Vote - Final Passage",142,0,0,3,145
1369268,973733,2020-07-23,Senate,"Senate Floor Vote - Final Passage",60,0,0,0,60
1369270,970843,2020-07-13,Assembly,"Assembly Mental Health Committee: Favorable refer to committee Ways and Means",13,0,0,0,13
1369270,971727,2020-07-17,Assembly,"Assembly Ways And Means Committee: Favorable refer to committee Rules",31,1,0,2,34
1369270,972162,2020-07-20,Assembly,"Assembly Rules Committee: Favorable",27,0,0,3,30
1369270,972572,2020-07-21,Assembly,"Assembly Floor Vote - Final Passage",142,0,0,3,145
1369270,973641,2020-07-23,Senate,"Senate Floor Vote - Final Passage",59,1,0,0,60
1369271,971438,2020-07-16,Assembly,"Assembly Real Property Taxation Committee: Favorable refer to committee Ways and Means",10,0,0,0,10
1369271,971886,2020-07-17,Assembly,"Assembly Ways And Means Committee: Favorable refer to committee Rules",32,0,0,2,34
1369271,972874,2020-07-22,Assembly,"Assembly Rules Committee: Favorable",29,0,0,1,30
1369659,972434,2020-07-20,Senate,"Senate Local Government Committee Vote",7,0,0,0,7
1369659,974054,2020-07-22,Senate,"Senate Floor Vote - Final Passage",60,0,0,0,60
1369659,974055,2020-07-22,Senate,"Senate Rules Committee Vote",19,0,0,0,19
1369813,974015,2020-07-20,Senate,"Senate Transportation Committee Vote",15,0,0,0,15
1369813,974016,2020-07-22,Senate,"Senate Floor Vote - Final Passage",60,0,0,0,60
1369813,974017,2020-07-22,Senate,"Senate Rules Committee Vote",19,0,0,0,19
1369848,972431,2020-07-20,Senate,"Senate Local Government Committee Vote",7,0,0,0,7
1369848,973351,2020-07-22,Senate,"Senate Rules Committee Vote",19,0,0,0,19
1369848,973513,2020-07-22,Senate,"Senate Floor Vote - Final Passage",58,2,0,0,60
1370194,972328,2020-07-20,Senate,"Senate Agriculture Committee Vote",9,0,0,0,9
1370194,973975,2020-07-22,Senate,"Senate Floor Vote - Final Passage",60,0,0,0,60
1370194,973976,2020-07-22,Senate,"Senate Rules Committee Vote",19,0,0,0,19
1370200,972679,2020-07-21,Senate,"Senate Finance Committee Vote",23,0,0,0,23
1370200,973272,2020-07-22,Senate,"Senate Rules Committee Vote",19,0,0,0,19
1370200,973734,2020-07-23,Senate,"Senate Floor Vote - Final Passage",60,0,0,0,60
1370200,973988,2020-07-22,Senate,"Senate Rules Committee Vote",19,0,0,0,19
1370222,973776,2020-07-20,Senate,"Senate Judiciary Committee Vote",12,3,0,0,15
1370222,973978,2020-07-21,Senate,"Senate Rules Committee Vote",16,3,0,0,19
1370225,972668,2020-07-20,Senate,"Senate Civil Service and Pensions Committee Vote",7,0,0,0,7
1370225,972669,2020-07-21,Senate,"Senate Finance Committee Vote",23,0,0,0,23
1370225,973344,2020-07-22,Senate,"Senate Rules Committee Vote",19,0,0,0,19
1370225,973504,2020-07-22,Senate,"Senate Floor Vote - Final Passage",60,0,0,0,60
1370440,971427,2020-07-16,Assembly,"Assembly Local Governments Committee: Favorable refer to committee Ways and Means",18,1,0,1,20
1370440,971833,2020-07-17,Assembly,"Assembly Ways And Means Committee: Favorable refer to committee Rules",25,7,0,2,34
1370440,972566,2020-07-21,Assembly,"Assembly Rules Committee: Favorable",26,0,0,4,30
1370440,973137,2020-07-22,Assembly,"Assembly Floor Vote - Final Passage",126,16,0,3,145
1370440,973697,2020-07-22,Senate,"Senate Floor Vote - Final Passage",60,0,0,0,60
1370467,971432,2020-07-16,Assembly,"Assembly Transportation Committee: Favorable refer to committee Ways and Means",22,0,0,2,24
1370467,971890,2020-07-17,Assembly,"Assembly Ways And Means Committee: Favorable refer to committee Rules",32,0,0,2,34
1370467,972216,2020-07-20,Assembly,"Assembly Rules Committee: Favorable",27,0,0,3,30
1370467,972610,2020-07-21,Assembly,"Assembly Floor Vote - Final Passage",142,0,0,3,145
1370467,973694,2020-07-22,Senate,"Senate Floor Vote - Final Passage",60,0,0,0,60
1370504,974108,2020-07-20,Senate,"Senate Judiciary Committee Vote",15,0,0,0,15
1370504,974109,2020-07-22,Senate,"Senate Rules Committee Vote",19,0,0,0,19
1370504,974110,2020-07-23,Senate,"Senate Floor Vote - Final Passage",60,0,0,0,60
1370693,972442,2020-07-20,Senate,"Senate Local Government Committee Vote",7,0,0,0,7
1370693,974008,2020-07-22,Senate,"Senate Floor Vote - Final Passage",58,2,0,0,60
1370693,974009,2020-07-22,Senate,"Senate Rules Committee Vote",19,0,0,0,19
1370714,972660,2020-07-20,Senate,"Senate Health Committee Vote",14,0,0,1,15
1370714,974090,2020-07-22,Senate,"Senate Rules Committee Vote",18,1,0,0,19
1370714,974091,2020-07-23,Senate,"Senate Floor Vote - Final Passage",59,1,0,0,60
1370730,972423,2020-07-20,Senate,"Senate Local Government Committee Vote",7,0,0,0,7
1370730,974040,2020-07-22,Senate,"Senate Floor Vote - Final Passage",58,2,0,0,60
1370730,974041,2020-07-22,Senate,"Senate Rules Committee Vote",19,0,0,0,19
1370778,973360,2020-07-22,Senate,"Senate Rules Committee Vote",15,4,0,0,19
1370778,973539,2020-07-23,Senate,"Senate Floor Vote - Final Passage",60,0,0,0,60
1371077,972676,2020-07-20,Senate,"Senate Labor Committee Vote",12,1,0,0,13
1371077,972677,2020-07-21,Senate,"Senate Finance Committee Vote",22,1,0,0,23
1371077,973309,2020-07-22,Senate,"Senate Rules Committee Vote",19,0,0,0,19
1371077,973428,2020-07-24,Assembly,"Assembly Floor Vote - Final Passage",141,0,0,4,145
1371077,973623,2020-07-23,Senate,"Senate Floor Vote - Final Passage",58,2,0,0,60
1371394,973335,2020-07-22,Senate,"Senate Rules Committee Vote",19,0,0,0,19
1371394,973713,2020-07-23,Senate,"Senate Floor Vote - Final Passage",60,0,0,0,60
1371394,974003,2020-07-22,Senate,"Senate Rules Committee Vote",19,0,0,0,19
1371432,970827,2020-07-13,Assembly,"Assembly Mental Health Committee: Favorable refer to committee Ways and Means",13,0,0,0,13
1371432,972841,2020-07-22,Assembly,"Assembly Ways And Means Committee: Favorable refer to committee Rules",32,0,0,2,34
1371432,973081,2020-07-22,Assembly,"Assembly Rules Committee: Favorable",29,0,0,1,30
1371432,973610,2020-07-23,Assembly,"Assembly Floor Vote - Final Passage",141,0,0,4,145
1371471,970985,2020-07-13,Assembly,"Assembly Economic Development Committee: Favorable refer to committee Rules",24,0,0,1,25
1371496,971228,2020-07-15,Assembly,"Assembly Labor Committee: Favorable refer to committee Rules",25,0,0,3,28
1371496,972793,2020-07-21,Assembly,"Assembly Rules Committee: Favorable",26,0,0,4,30
1371496,973158,2020-07-22,Assembly,"Assembly Floor Vote - Final Passage",140,2,0,3,145
1371496,973653,2020-07-23,Senate,"Senate Floor Vote - Final Passage",59,1,0,0,60
1371500,971293,2020-07-15,Assembly,"Assembly Social Services Committee: Favorable refer to committee Ways and Means",15,2,0,0,17
1371500,971743,2020-07-17,Assembly,"Assembly Ways And Means Committee: Favorable refer to committee Rules",31,1,0,2,34
1371500,972582,2020-07-21,Assembly,"Assembly Rules Committee: Favorable",24,2,0,4,30
1371843,973327,2020-07-22,Senate,"Senate Rules Committee Vote",19,0,0,0,19
1371843,973481,2020-07-22,Senate,"Senate Floor Vote - Final Passage",60,0,0,0,60
1371843,973482,2020-07-23,Assembly,"Assembly Floor Vote - Final Passage",141,0,0,4,145
1371843,973968,2020-07-22,Senate,"Senate Rules Committee Vote",19,0,0,0,19
1371847,972377,2020-07-20,Senate,"Senate Local Government Committee Vote",7,0,0,0,7
1371847,973296,2020-07-22,Senate,"Senate Rules Committee Vote",19,0,0,0,19
1371847,973705,2020-07-22,Senate,"Senate Floor Vote - Final Passage",60,0,0,0,60
1371862,972421,2020-07-20,Senate,"Senate Higher Education Committee Vote",11,0,0,0,11
1371862,974052,2020-07-22,Senate,"Senate Floor Vote - Final Passage",60,0,0,0,60
1371862,974053,2020-07-22,Senate,"Senate Rules Committee Vote",19,0,0,0,19
1371863,972655,2020-07-20,Senate,"Senate Environmental Conservation Committee Vote",10,1,0,0,11
1371863,973275,2020-07-22,Senate,"Senate Rules Committee Vote",18,1,0,0,19
1371863,973680,2020-07-22,Senate,"Senate Floor Vote - Final Passage",55,5,0,0,60
1371864,972432,2020-07-20,Senate,"Senate Higher Education Committee Vote",11,0,0,0,11
1371864,974042,2020-07-22,Senate,"Senate Floor Vote - Final Passage",60,0,0,0,60
1371864,974043,2020-07-22,Senate,"Senate Rules Committee Vote",19,0,0,0,19
1371868,972672,2020-07-21,Senate,"Senate Social Services Committee Vote",7,0,0,0,7
1371868,973643,2020-07-22,Senate,"Senate Floor Vote - Final Passage",59,1,0,0,60
1371868,973977,2020-07-21,Senate,"Senate Rules Committee Vote",19,0,0,0,19
1371869,972331,2020-07-20,Senate,"Senate Aging Committee Vote",6,0,0,0,6
1371869,973250,2020-07-22,Senate,"Senate Rules Committee Vote",19,0,0,0,19
1371869,973633,2020-07-22,Senate,"Senate Floor Vote - Final Passage",54,6,0,0,60
1372033,972291,2020-07-20,Senate,"Senate Local Government Committee Vote",7,0,0,0,7
1372033,974006,2020-07-22,Senate,"Senate Floor Vote - Final Passage",60,0,0,0,60
1372033,974007,2020-07-22,Senate,"Senate Rules Committee Vote",19,0,0,0,19
1372207,972435,2020-07-20,Senate,"Senate Local Government Committee Vote",7,0,0,0,7
1372207,974046,2020-07-22,Senate,"Senate Floor Vote - Final Passage",60,0,0,0,60
1372207,974047,2020-07-22,Senate,"Senate Rules Committee Vote",19,0,0,0,19
1372208,972705,2020-07-21,Senate,"Senate Finance Committee Vote",23,0,0,0,23
1372208,973342,2020-07-22,Senate,"Senate Rules Committee Vote",19,0,0,0,19
1372208,973684,2020-07-22,Senate,"Senate Floor Vote - Final Passage",60,0,0,0,60
1372208,973808,2020-07-22,Senate,"Senate Rules Committee Vote",19,0,0,0,19
1372213,972454,2020-07-20,Senate,"Senate Local Government Committee Vote",5,2,0,0,7
1372213,973163,2020-07-22,Senate,"Senate Floor Vote - Final Passage",36,24,0,0,60
1372213,973337,2020-07-22,Senate,"Senate Rules Committee Vote",15,4,0,0,19
1372217,972702,2020-07-21,Senate,"Senate Finance Committee Vote",23,0,0,0,23
1372217,973331,2020-07-22,Senate,"Senate Rules Committee Vote",19,0,0,0,19
1372217,973693,2020-07-23,Senate,"Senate Floor Vote - Final Passage",60,0,0,0,60
1372217,973964,2020-07-22,Senate,"Senate Rules Committee Vote",19,0,0,0,19
1372228,972887,2020-07-22,Assembly,"Assembly Rules Committee: Favorable",29,0,0,1,30
1372228,972888,2020-07-22,Assembly,"Assembly Ways And Means Committee: Favorable refer to committee Rules",32,0,0,2,34
1372239,972636,2020-07-21,Senate,"Senate Finance Committee Vote",22,1,0,0,23
1372239,974037,2020-07-21,Senate,"Senate Finance Committee Vote",22,1,0,0,23
1372239,974038,2020-07-22,Senate,"Senate Floor Vote - Final Passage",59,1,0,0,60
1372239,974039,2020-07-22,Senate,"Senate Rules Committee Vote",18,1,0,0,19
1372257,972866,2020-07-22,Assembly,"Assembly Ways And Means Committee: Favorable refer to committee Rules",27,5,0,2,34
1372257,973113,2020-07-22,Assembly,"Assembly Rules Committee: Favorable",28,1,0,1,30
1372257,973575,2020-07-24,Assembly,"Assembly Floor Vote - Final Passage",121,20,0,4,145
1372276,972916,2020-07-22,Assembly,"Assembly Rules Committee: Favorable",29,0,0,1,30
1372276,972917,2020-07-22,Assembly,"Assembly Ways And Means Committee: Favorable refer to committee Rules",32,0,0,2,34
1372296,970916,2020-07-13,Assembly,"Assembly Economic Development Committee: Favorable refer to committee Ways and Means",23,1,0,1,25
1372296,971771,2020-07-17,Assembly,"Assembly Ways And Means Committee: Favorable refer to committee Rules",31,1,0,2,34
1372296,972203,2020-07-20,Assembly,"Assembly Rules Committee: Favorable",27,0,0,3,30
1372296,972624,2020-07-21,Assembly,"Assembly Floor Vote - Final Passage",141,1,0,3,145
1372296,973159,2020-07-22,Senate,"Senate Floor Vote - Final Passage",60,0,0,0,60
1372302,972844,2020-07-22,Assembly,"Assembly Ways And Means Committee: Favorable refer to committee Rules",28,4,0,2,34
1372302,973098,2020-07-22,Assembly,"Assembly Rules Committee: Favorable",29,0,0,1,30
1372328,972420,2020-07-20,Senate,"Senate Local Government Committee Vote",7,0,0,0,7
1372328,974011,2020-07-22,Senate,"Senate Floor Vote - Final Passage",60,0,0,0,60
1372328,974012,2020-07-22,Senate,"Senate Rules Committee Vote",19,0,0,0,19
1372430,973486,2020-07-22,Senate,"Senate Floor Vote - Final Passage",41,19,0,0,60
1372430,973979,2020-07-21,Senate,"Senate Rules Committee Vote",15,4,0,0,19
1372789,972967,2020-07-20,Senate,"Senate Labor Committee Vote",12,1,0,0,13
1372789,973357,2020-07-22,Senate,"Senate Rules Committee Vote",18,1,0,0,19
1372789,973718,2020-07-23,Senate,"Senate Floor Vote - Final Passage",54,6,0,0,60
1372791,972461,2020-07-20,Senate,"Senate Local Government Committee Vote",5,2,0,0,7
1372791,972688,2020-07-21,Senate,"Senate Finance Committee Vote",19,4,0,0,23
1372791,973330,2020-07-22,Senate,"Senate Rules Committee Vote",14,5,0,0,19
1372791,973646,2020-07-23,Senate,"Senate Floor Vote - Final Passage",39,21,0,0,60
1372799,972872,2020-07-22,Assembly,"Assembly Rules Committee: Favorable",29,0,0,1,30
1372799,972873,2020-07-22,Assembly,"Assembly Ways And Means Committee: Favorable refer to committee Rules",32,0,0,2,34
1372805,972293,2020-07-20,Senate,"Senate Local Government Committee Vote",7,0,0,0,7
1372805,974022,2020-07-22,Senate,"Senate Floor Vote - Final Passage",58,2,0,0,60
1372805,974023,2020-07-22,Senate,"Senate Rules Committee Vote",19,0,0,0,19
1372831,973442,2020-07-22,Senate,"Senate Floor Vote - Final Passage",39,21,0,0,60
1372831,973963,2020-07-21,Senate,"Senate Rules Committee Vote",18,1,0,0,19
1372839,972345,2020-07-20,Senate,"Senate Local Government Committee Vote",7,0,0,0,7
1372839,974048,2020-07-22,Senate,"Senate Floor Vote - Final Passage",58,2,0,0,60
1372839,974049,2020-07-22,Senate,"Senate Rules Committee Vote",19,0,0,0,19
1372851,971058,2020-07-14,Assembly,"Assembly Higher Education Committee: Favorable refer to committee Ways and Means",25,0,0,0,25
1372851,971868,2020-07-17,Assembly,"Assembly Ways And Means Committee: Favorable refer to committee Rules",32,0,0,2,34
1372851,972990,2020-07-21,Assembly,"Assembly Rules Committee: Favorable",26,0,0,4,30
1372851,973248,2020-07-22,Assembly,"Assembly Floor Vote - Final Passage",142,0,0,3,145
1372851,973511,2020-07-22,Senate,"Senate Floor Vote - Final Passage",60,0,0,0,60
1372865,971292,2020-07-15,Assembly,"Assembly Social Services Committee: Favorable refer to committee Ways and Means",16,1,0,0,17
1372865,971899,2020-07-17,Assembly,"Assembly Ways And Means Committee: Favorable refer to committee Rules",29,3,0,2,34
1372865,972992,2020-07-21,Assembly,"Assembly Rules Committee: Favorable",26,0,0,4,30
1372866,970828,2020-07-13,Assembly,"Assembly Corporations, Authorities And Commissions Committee: Favorable refer to committee Codes",26,0,0,0,26
1372866,971844,2020-07-17,Assembly,"Assembly Codes Committee: Favorable refer to committee Rules",20,1,0,1,22
1372983,972829,2020-07-20,Senate,"Senate Civil Service and Pensions Committee Vote",7,0,0,0,7
1372983,972830,2020-07-21,Senate,"Senate Finance Committee Vote",23,0,0,0,23
1372983,973207,2020-07-22,Senate,"Senate Floor Vote - Final Passage",60,0,0,0,60
1372983,973312,2020-07-22,Senate,"Senate Rules Committee Vote",19,0,0,0,19
1372983,973443,2020-07-23,Assembly,"Assembly Floor Vote - Final Passage",134,7,0,4,145
1372984,971240,2020-07-15,Assembly,"Assembly Small Business Committee: Favorable refer to committee Rules",13,0,0,3,16
1372984,972212,2020-07-20,Assembly,"Assembly Rules Committee: Favorable",27,0,0,3,30
1372991,971084,2020-07-14,Assembly,"Assembly Environmental Conservation Committee: Favorable refer to committee Ways and Means",26,1,0,1,28
1372991,972849,2020-07-22,Assembly,"Assembly Ways And Means Committee: Favorable refer to committee Rules",32,0,0,2,34
1372991,973025,2020-07-22,Assembly,"Assembly Rules Committee: Favorable",29,0,0,1,30
1372991,973490,2020-07-24,Assembly,"Assembly Floor Vote - Final Passage",139,2,0,4,145
1373003,970870,2020-07-13,Assembly,"Assembly Cities Committee: Favorable refer to committee Ways and Means",14,0,0,0,14
1373003,971878,2020-07-17,Assembly,"Assembly Ways And Means Committee: Favorable refer to committee Rules",32,0,0,2,34
1373003,972570,2020-07-21,Assembly,"Assembly Rules Committee: Favorable",26,0,0,4,30
1373003,973138,2020-07-22,Assembly,"Assembly Floor Vote - Final Passage",141,1,0,3,145
1373003,973699,2020-07-22,Senate,"Senate Floor Vote - Final Passage",60,0,0,0,60
1373010,972670,2020-07-21,Senate,"Senate Banks Committee Vote",9,2,0,0,11
1373010,974092,2020-07-22,Senate,"Senate Rules Committee Vote",17,2,0,0,19
1373010,974093,2020-07-23,Senate,"Senate Floor Vote - Final Passage",48,12,0,0,60
1373014,971409,2020-07-16,Assembly,"Assembly Governmental Operations Committee: Favorable refer to committee Rules",14,0,0,0,14
1373014,972184,2020-07-20,Assembly,"Assembly Rules Committee: Favorable",27,0,0,3,30
1373014,972727,2020-07-21,Assembly,"Assembly Floor Vote - Final Passage",142,0,0,3,145
1373014,973521,2020-07-22,Senate,"Senate Floor Vote - Final Passage",60,0,0,0,60
1373016,974111,2020-07-22,Senate,"Senate Rules Committee Vote",18,1,0,0,19
1373016,974112,2020-07-23,Senate,"Senate Floor Vote - Final Passage",57,3,0,0,60
1373026,971392,2020-07-16,Assembly,"Assembly Local Governments Committee: Favorable refer to committee Rules",19,0,0,1,20
1373026,972994,2020-07-21,Assembly,"Assembly Rules Committee: Favorable",26,0,0,4,30
1373026,973384,2020-07-23,Assembly,"Assembly Floor Vote - Final Passage",141,0,0,4,145
1373026,973678,2020-07-23,Senate,"Senate Floor Vote - Final Passage",47,13,0,0,60
1373030,972715,2020-07-20,Senate,"Senate Health Committee Vote",14,0,0,1,15
1373030,974103,2020-07-22,Senate,"Senate Rules Committee Vote",19,0,0,0,19
1373030,974104,2020-07-23,Senate,"Senate Floor Vote - Final Passage",60,0,0,0,60
1373032,971297,2020-07-15,Assembly,"Assembly Veterans' Affairs Committee: Favorable refer to committee Ways and Means",17,0,0,2,19
1373032,971850,2020-07-17,Assembly,"Assembly Ways And Means Committee: Favorable refer to committee Rules",32,0,0,2,34
1373032,973261,2020-07-23,Assembly,"Assembly Rules Committee: Favorable",28,0,0,2,30
1373041,972666,2020-07-21,Senate,"Senate Banks Committee Vote",8,3,0,0,11
1373041,973276,2020-07-22,Senate,"Senate Rules Committee Vote",13,6,0,0,19
1373041,973648,2020-07-23,Senate,"Senate Floor Vote - Final Passage",40,20,0,0,60
1373054,971059,2020-07-14,Assembly,"Assembly Higher Education Committee: Favorable refer to committee Ways and Means",25,0,0,0,25
1373054,971843,2020-07-17,Assembly,"Assembly Ways And Means Committee: Favorable refer to committee Rules",32,0,0,2,34
1373054,972997,2020-07-21,Assembly,"Assembly Rules Committee: Favorable",26,0,0,4,30
1373054,973253,2020-07-22,Senate,"Senate Floor Vote - Final Passage",59,1,0,0,60
1373054,973254,2020-07-22,Assembly,"Assembly Floor Vote - Final Passage",141,1,0,3,145
1373061,970741,2020-07-13,Assembly,"Assembly Health Committee: Favorable refer to committee Codes",24,0,0,2,26
1373061,971858,2020-07-17,Assembly,"Assembly Codes Committee: Favorable refer to committee Rules",21,0,0,1,22
1373061,973259,2020-07-23,Assembly,"Assembly Rules Committee: Favorable",28,0,0,2,30
1373063,971088,2020-07-14,Assembly,"Assembly Election Law Committee: Favorable refer to committee Rules",16,0,0,0,16
1373065,971428,2020-07-16,Assembly,"Assembly Governmental Employees Committee: Favorable refer to committee Ways and Means",14,0,0,0,14
1373065,971829,2020-07-17,Assembly,"Assembly Ways And Means Committee: Favorable refer to committee Rules",31,1,0,2,34
1373065,972579,2020-07-21,Assembly,"Assembly Rules Committee: Favorable",26,0,0,4,30
1373065,973139,2020-07-22,Senate,"Senate Floor Vote - Final Passage",60,0,0,0,60
1373065,973140,2020-07-22,Assembly,"Assembly Floor Vote - Final Passage",136,6,0,3,145
1373072,972287,2020-07-20,Senate,"Senate Local Government Committee Vote",7,0,0,0,7
1373072,973277,2020-07-22,Senate,"Senate Rules Committee Vote",19,0,0,0,19
1373072,973397,2020-07-24,Assembly,"Assembly Floor Vote - Final Passage",134,7,0,4,145
1373072,973687,2020-07-23,Senate,"Senate Floor Vote - Final Passage",60,0,0,0,60
1373073,970959,2020-07-13,Assembly,"Assembly Consumer Affairs And Protection Committee: Favorable refer to committee Rules",15,0,0,1,16
1373073,972163,2020-07-20,Assembly,"Assembly Rules Committee: Favorable",27,0,0,3,30
1373076,971032,2020-07-14,Assembly,"Assembly Environmental Conservation Committee: Favorable refer to committee Codes",27,0,0,1,28
1373076,971879,2020-07-17,Assembly,"Assembly Codes Committee: Favorable refer to committee Rules",21,0,0,1,22
1373076,973010,2020-07-22,Assembly,"Assembly Rules Committee: Favorable",25,0,0,5,30
1373076,973419,2020-07-23,Assembly,"Assembly Floor Vote - Final Passage",141,0,0,4,145
1373076,973701,2020-07-23,Senate,"Senate Floor Vote - Final Passage",57,3,0,0,60
1373077,971435,2020-07-16,Assembly,"Assembly Local Governments Committee: Favorable refer to committee Ways and Means",18,1,0,1,20
1373077,971860,2020-07-17,Assembly,"Assembly Ways And Means Committee: Favorable refer to committee Rules",25,7,0,2,34
1373077,973114,2020-07-22,Assembly,"Assembly Rules Committee: Favorable",29,0,0,1,30
1373153,973358,2020-07-22,Senate,"Senate Rules Committee Vote",15,4,0,0,19
1373153,973716,2020-07-23,Senate,"Senate Floor Vote - Final Passage",46,14,0,0,60
1373160,972637,2020-07-21,Senate,"Senate Social Services Committee Vote",7,0,0,0,7
1373160,974101,2020-07-22,Senate,"Senate Rules Committee Vote",19,0,0,0,19
1373160,974102,2020-07-23,Senate,"Senate Floor Vote - Final Passage",60,0,0,0,60
1373180,972818,2020-07-21,Senate,"Senate Social Services Committee Vote",7,0,0,0,7
1373180,973162,2020-07-22,Senate,"Senate Floor Vote - Final Passage",49,11,0,0,60
1373180,973318,2020-07-22,Senate,"Senate Rules Committee Vote",16,3,0,0,19
1373183,972651,2020-07-20,Senate,"Senate Investigations and Government Operations Committee Vote",5,1,0,0,6
1373183,974056,2020-07-22,Senate,"Senate Floor Vote - Final Passage",60,0,0,0,60
1373183,974057,2020-07-22,Senate,"Senate Rules Committee Vote",19,0,0,0,19
1373235,971446,2020-07-16,Assembly,"Assembly Governmental Employees Committee: Favorable refer to committee Ways and Means",14,0,0,0,14
1373235,971892,2020-07-17,Assembly,"Assembly Ways And Means Committee: Favorable refer to committee Rules",22,10,0,2,34
1373235,972890,2020-07-22,Assembly,"Assembly Rules Committee: Favorable",29,0,0,1,30
1373236,972699,2020-07-20,Senate,"Senate Labor Committee Vote",13,0,0,0,13
1373236,973365,2020-07-22,Senate,"Senate Rules Committee Vote",19,0,0,0,19
1373236,973724,2020-07-23,Senate,"Senate Floor Vote - Final Passage",59,1,0,0,60
1373298,972656,2020-07-20,Senate,"Senate Environmental Conservation Committee Vote",10,1,0,0,11
1373298,974085,2020-07-22,Senate,"Senate Rules Committee Vote",17,2,0,0,19
1373298,974086,2020-07-23,Senate,"Senate Floor Vote - Final Passage",51,9,0,0,60
1373300,972674,2020-07-20,Senate,"Senate Civil Service and Pensions Committee Vote",7,0,0,0,7
1373300,972675,2020-07-21,Senate,"Senate Finance Committee Vote",23,0,0,0,23
1373300,973164,2020-07-22,Senate,"Senate Floor Vote - Final Passage",60,0,0,0,60
1373300,973279,2020-07-22,Senate,"Senate Rules Committee Vote",19,0,0,0,19
1373300,973394,2020-07-24,Assembly,"Assembly Floor Vote - Final Passage",134,7,0,4,145
1373305,972286,2020-07-20,Senate,"Senate Local Government Committee Vote",6,1,0,0,7
1373305,974094,2020-07-22,Senate,"Senate Rules Committee Vote",14,5,0,0,19
1373305,974095,2020-07-23,Senate,"Senate Floor Vote - Final Passage",47,13,0,0,60
1373307,972411,2020-07-20,Senate,"Senate Corporations, Authorities and Commissions Committee Vote",7,0,0,0,7
1373307,973333,2020-07-22,Senate,"Senate Rules Committee Vote",19,0,0,0,19
1373307,973664,2020-07-23,Senate,"Senate Floor Vote - Final Passage",60,0,0,0,60
1373309,973062,2020-07-21,Senate,"Senate Banks Committee Vote",7,4,0,0,11
1373309,973286,2020-07-22,Senate,"Senate Rules Committee Vote",13,6,0,0,19
1373309,973671,2020-07-23,Senate,"Senate Floor Vote - Final Passage",40,20,0,0,60
1373369,972693,2020-07-21,Senate,"Senate Elections Committee Vote",5,2,0,0,7
1373369,974026,2020-07-22,Senate,"Senate Floor Vote - Final Passage",41,19,0,0,60
1373369,974027,2020-07-22,Senate,"Senate Rules Committee Vote",13,6,0,0,19
1373370,972436,2020-07-20,Senate,"Senate Corporations, Authorities and Commissions Committee Vote",7,0,0,0,7
1373370,973346,2020-07-22,Senate,"Senate Rules Committee Vote",19,0,0,0,19
1373370,973714,2020-07-23,Senate,"Senate Floor Vote - Final Passage",60,0,0,0,60
1373371,972650,2020-07-21,Senate,"Senate Elections Committee Vote",6,1,0,0,7
1373371,973274,2020-07-22,Senate,"Senate Rules Committee Vote",13,6,0,0,19
1373371,973393,2020-07-23,Assembly,"Assembly Floor Vote - Final Passage",100,41,0,4,145
1373371,973681,2020-07-22,Senate,"Senate Floor Vote - Final Passage",43,17,0,0,60
1373376,972409,2020-07-20,Senate,"Senate Consumer Protection Committee Vote",6,0,0,0,6
1373376,973246,2020-07-22,Senate,"Senate Rules Committee Vote",19,0,0,0,19
1373376,973659,2020-07-23,Senate,"Senate Floor Vote - Final Passage",59,1,0,0,60
1373380,971747,2020-07-17,Assembly,"Assembly Codes Committee: Favorable refer to committee Rules",15,6,0,1,22
1373380,973008,2020-07-22,Assembly,"Assembly Rules Committee: Favorable",19,6,0,5,30
1373381,971905,2020-07-17,Assembly,"Assembly Codes Committee: Favorable refer to committee Rules",21,0,0,1,22
1373396,972854,2020-07-22,Assembly,"Assembly Ways And Means Committee: Favorable refer to committee Rules",22,10,0,2,34
1373396,973106,2020-07-22,Assembly,"Assembly Rules Committee: Favorable",22,7,0,1,30
1373411,972665,2020-07-20,Senate,"Senate Health Committee Vote",13,1,0,1,15
1373411,973349,2020-07-22,Senate,"Senate Rules Committee Vote",15,4,0,0,19
1373411,973737,2020-07-23,Senate,"Senate Floor Vote - Final Passage",43,17,0,0,60
1373412,971889,2020-07-17,Assembly,"Assembly Codes Committee: Favorable refer to committee Rules",21,0,0,1,22
1373412,972161,2020-07-20,Assembly,"Assembly Rules Committee: Favorable",27,0,0,3,30
1373412,972993,2020-07-21,Assembly,"Assembly Floor Vote - Final Passage",141,1,0,3,145
1373412,973677,2020-07-22,Senate,"Senate Floor Vote - Final Passage",41,19,0,0,60
1373427,972400,2020-07-20,Senate,"Senate Local Government Committee Vote",5,2,0,0,7
1373427,973178,2020-07-22,Senate,"Senate Floor Vote - Final Passage",42,18,0,0,60
1373427,973361,2020-07-22,Senate,"Senate Rules Committee Vote",13,6,0,0,19
1373434,973236,2020-07-22,Senate,"Senate Floor Vote - Final Passage",60,0,0,0,60
1373434,973237,2020-07-22,Senate,"Senate Rules Committee Vote",19,0,0,0,19
1373434,973630,2020-07-23,Assembly,"Assembly Floor Vote - Final Passage",141,0,0,4,145
1373440,972659,2020-07-21,Senate,"Senate Finance Committee Vote",20,3,0,0,23
1373440,973317,2020-07-22,Senate,"Senate Rules Committee Vote",15,4,0,0,19
1373440,973455,2020-07-23,Assembly,"Assembly Floor Vote - Final Passage",141,0,0,4,145
1373440,973723,2020-07-23,Senate,"Senate Floor Vote - Final Passage",60,0,0,0,60
1373448,972642,2020-07-21,Senate,"Senate Elections Committee Vote",7,0,0,0,7
1373448,973281,2020-07-22,Senate,"Senate Rules Committee Vote",19,0,0,0,19
1373448,973398,2020-07-24,Assembly,"Assembly Floor Vote - Final Passage",141,0,0,4,145
1373448,973690,2020-07-22,Senate,"Senate Floor Vote - Final Passage",59,1,0,0,60
1373464,972661,2020-07-21,Senate,"Senate Finance Committee Vote",23,0,0,0,23
1373464,973326,2020-07-22,Senate,"Senate Rules Committee Vote",19,0,0,0,19
1373464,973732,2020-07-23,Senate,"Senate Floor Vote - Final Passage",60,0,0,0,60
1373464,973816,2020-07-22,Senate,"Senate Rules Committee Vote",19,0,0,0,19
1373486,972671,2020-07-21,Senate,"Senate Elections Committee Vote",5,2,0,0,7
1373486,973285,2020-07-22,Senate,"Senate Rules Committee Vote",12,7,0,0,19
1373486,973404,2020-07-24,Assembly,"Assembly Floor Vote - Final Passage",101,40,0,4,145
1373486,973691,2020-07-22,Senate,"Senate Floor Vote - Final Passage",40,20,0,0,60
1373608,972884,2020-07-22,Assembly,"Assembly Rules Committee: Favorable",22,7,0,1,30
1373608,972885,2020-07-22,Assembly,"Assembly Ways And Means Committee: Favorable refer to committee Rules",22,10,0,2,34
1373621,972869,2020-07-22,Assembly,"Assembly Rules Committee: Favorable",29,0,0,1,30
1373621,972870,2020-07-22,Assembly,"Assembly Ways And Means Committee: Favorable refer to committee Rules",32,0,0,2,34
1373640,972712,2020-07-21,Senate,"Senate Elections Committee Vote",5,2,0,0,7
1373640,973359,2020-07-22,Senate,"Senate Rules Committee Vote",12,7,0,0,19
1373640,973400,2020-07-23,Assembly,"Assembly Floor Vote - Final Passage",86,55,0,4,145
1373640,973578,2020-07-22,Senate,"Senate Floor Vote - Final Passage",40,20,0,0,60
1373643,972882,2020-07-22,Assembly,"Assembly Rules Committee: Favorable",29,0,0,1,30
1373643,972883,2020-07-22,Assembly,"Assembly Ways And Means Committee: Favorable refer to committee Rules",32,0,0,2,34
1373645,972852,2020-07-22,Assembly,"Assembly Ways And Means Committee: Favorable refer to committee Rules",27,5,0,2,34
1373645,973094,2020-07-22,Assembly,"Assembly Rules Committee: Favorable",22,7,0,1,30
1373652,972892,2020-07-22,Assembly,"Assembly Rules Committee: Favorable",29,0,0,1,30
1373652,972893,2020-07-22,Assembly,"Assembly Ways And Means Committee: Favorable refer to committee Rules",32,0,0,2,34
1373653,973323,2020-07-22,Senate,"Senate Rules Committee Vote",17,2,0,0,19
1373653,973696,2020-07-23,Senate,"Senate Floor Vote - Final Passage",42,18,0,0,60
1373790,972815,2020-07-22,Assembly,"Assembly Codes Committee: Favorable refer to committee Rules",17,4,0,1,22
1373790,972897,2020-07-22,Assembly,"Assembly Rules Committee: Favorable",28,1,0,1,30
1373801,973256,2020-07-22,Senate,"Senate Rules Committee Vote",16,3,0,0,19
1373801,973460,2020-07-23,Assembly,"Assembly Floor Vote - Final Passage",129,12,0,4,145
1373801,973595,2020-07-23,Senate,"Senate Floor Vote - Final Passage",45,15,0,0,60
1373812,973260,2020-07-22,Senate,"Senate Rules Committee Vote",12,7,0,0,19
1373812,973382,2020-07-23,Assembly,"Assembly Floor Vote - Final Passage",91,50,0,4,145
1373812,973735,2020-07-23,Senate,"Senate Floor Vote - Final Passage",40,20,0,0,60
1373824,973311,2020-07-22,Senate,"Senate Rules Committee Vote",14,5,0,0,19
1373824,973479,2020-07-23,Assembly,"Assembly Floor Vote - Final Passage",100,41,0,4,145
1373824,973695,2020-07-23,Senate,"Senate Floor Vote - Final Passage",43,17,0,0,60
1373829,972851,2020-07-22,Assembly,"Assembly Judiciary Committee: Favorable refer to committee Rules",13,6,0,2,21
1373829,973100,2020-07-22,Assembly,"Assembly Rules Committee: Favorable",22,7,0,1,30
1373835,973466,2020-07-22,Senate,"Senate Rules Committee Vote",18,1,0,0,19
1373835,973467,2020-07-23,Assembly,"Assembly Floor Vote - Final Passage",141,0,0,4,145
1373835,973727,2020-07-23,Senate,"Senate Floor Vote - Final Passage",57,3,0,0,60
1373837,973306,2020-07-22,Senate,"Senate Rules Committee Vote",19,0,0,0,19
1373837,973550,2020-07-23,Senate,"Senate Floor Vote - Final Passage",57,3,0,0,60
1373837,973551,2020-07-23,Assembly,"Assembly Floor Vote - Final Passage",115,26,0,4,145
1373838,973239,2020-07-22,Senate,"Senate Rules Committee Vote",19,0,0,0,19
1373838,973470,2020-07-24,Assembly,"Assembly Floor Vote - Final Passage",102,39,0,4,145
1373838,973642,2020-07-23,Senate,"Senate Floor Vote - Final Passage",60,0,0,0,60
